Verb,NP_len,PP_len,Len_diff,Len,Arg_status,Pronominality,Order
uvádět,6,4,2,1,-1,0,1
odvrátit,2,3,-1,-1,-1,0,1
mít,7,2,5,1,-1,1,1
užít,19,2,17,1,-1,0,1
překážet,3,2,1,1,-1,0,1
vyhazovat,1,2,1,1,1,0,1
vyhazovat,1,2,1,1,1,0,1
zadržet,2,3,-1,-1,-1,0,1
vyřadit,1,2,1,1,1,0,1
chránit,1,2,-1,-1,-1,0,1
užívat,4,2,2,1,-1,0,1
udržovat,1,4,3,1,1,0,1
užívat,3,2,1,1,-1,0,1
užívat,3,2,1,1,-1,0,1
upravovat,17,13,-4,-1,1,0,1
užít,9,2,7,1,-1,0,1
používat,8,13,-5,-1,-1,0,1
zavádět,12,6,-6,-1,1,0,1
odevzdat,5,6,1,1,1,0,1
udržovat,4,3,-1,-1,1,0,1
provádět,9,5,-4,-1,1,0,1
zřizovat,4,2,-2,-1,1,0,1
provádět,8,6,-2,-1,1,0,1
provést,5,6,1,1,1,0,1
provádět,5,3,2,1,-1,0,1
zajišťovat,20,3,17,1,-1,0,1
uhradit,3,5,2,1,1,0,1
zajišťovat,3,3,0,0,1,0,1
mít,1,2,1,1,1,0,1
mít,1,2,1,1,1,0,1
ukládat,4,2,2,1,-1,1,1
odhazovat,1,2,-1,-1,-1,1,1
vyklepávat,2,2,0,0,-1,1,1
udržovat,6,4,-2,-1,1,0,1
zajistit,3,8,5,1,1,0,1
uvést,1,3,2,1,1,1,1
umístit,45,4,41,1,-1,0,1
umístit,26,3,23,1,-1,0,1
odevzdat,8,2,-6,-1,1,0,1
zamezit,5,3,-2,-1,1,0,1
stanovit,1,5,4,1,1,0,1
odevzdat,1,2,-1,-1,-1,0,1
zaručovat,2,5,3,1,1,0,1
sjednat,2,7,5,1,1,0,1
vyplnit,5,4,1,1,-1,0,1
předložit,3,7,4,1,1,0,1
moci,2,24,22,1,1,0,1
konat,1,3,2,1,1,0,1
konat,2,3,1,1,1,0,1
mít,19,2,17,1,-1,0,1
znamenat,2,2,0,0,-1,0,1
uzavřít,7,20,13,1,1,0,1
udělit,7,108,101,1,1,0,1
odpovídat,8,12,4,1,1,0,1
převyšovat,2,3,-1,-1,-1,0,1
konat,1,5,4,1,1,0,1
přerušit,4,12,8,1,1,0,1
nastoupit,1,2,1,1,1,0,1
zařadit,1,6,5,1,1,1,1
zařadit,1,5,4,1,1,1,1
vzniknout,5,10,5,1,1,0,1
mít,1,5,4,1,1,0,1
změnit,1,9,8,1,1,0,1
sjednat,2,6,4,1,1,0,1
vykonávat,3,5,2,1,1,0,1
pobírat,2,3,1,1,1,0,1
moci,14,13,-1,-1,1,0,1
uzavřít,6,4,2,1,-1,0,1
odpracovat,5,3,2,1,-1,0,1
odpracovat,3,3,0,0,-1,0,1
dostat,2,4,2,1,1,0,1
odpracovat,4,3,-1,-1,1,0,1
posoudit,4,6,2,1,1,0,1
odpovídat,3,4,1,1,1,0,1
potvrzovat,2,9,7,1,1,0,1
vyplnit,1,3,2,1,1,0,1
projednat,1,3,2,1,1,0,1
zasílat,1,3,-2,-1,-1,0,1
předvolat,6,4,-2,-1,1,0,1
vyhodnotit,12,3,9,1,-1,0,1
zpracovávat,10,3,-7,-1,1,0,1
předvolat,5,3,2,1,-1,0,1
zpřesňovat,5,5,0,0,1,0,1
organizovat,4,3,-1,-1,1,0,1
docílit,2,5,3,1,1,0,1
provádět,4,4,0,0,1,0,1
upevňovat,9,2,7,1,-1,0,1
zajistit,4,5,1,1,1,0,1
umožnit,6,6,0,0,-1,0,1
rozšířit,5,8,3,1,1,0,1
zavést,7,4,3,1,-1,0,1
dosáhnout,3,3,0,0,-1,0,1
rozvázat,2,3,1,1,1,0,1
skončit,2,3,-1,-1,-1,0,1
zameškat,1,7,6,1,1,0,1
obdržet,7,3,4,1,-1,0,1
ukládat,26,8,18,1,-1,0,1
podat,6,3,3,1,-1,0,1
vydat,2,27,25,1,1,0,1
termínovat,11,12,1,1,1,0,1
zajistit,5,5,0,0,1,0,1
dodávat,4,4,0,0,-1,0,1
pomáhat,2,2,0,0,1,0,1
převést,28,5,23,1,-1,0,1
přijmout,25,7,18,1,-1,0,1
kontrolovat,10,3,7,1,-1,0,1
usměrnit,3,12,9,1,1,0,1
vytvořit,4,5,-1,-1,-1,0,1
předložit,15,5,10,1,-1,0,1
udržovat,6,5,-1,-1,1,0,1
vyslat,3,3,0,0,-1,0,1
ustavit,4,9,-5,-1,-1,0,1
obdržet,19,3,16,1,-1,0,1
konkretizovat,2,6,4,1,1,0,1
vypracovat,19,8,-11,-1,1,0,1
učinit,36,5,31,1,-1,0,1
představovat,2,13,11,1,1,0,1
poskytovat,3,3,0,0,-1,0,1
posílat,13,2,11,1,-1,0,1
nakoupit,6,3,3,1,-1,0,1
oznámit,2,2,0,0,-1,0,1
stanovit,3,3,0,0,1,0,1
plnit,2,9,7,1,1,0,1
zařadit,1,6,5,1,1,1,1
zařadit,1,10,9,1,1,1,1
splnit,7,2,5,1,-1,0,1
dosáhnout,2,4,2,1,1,0,1
vypůjčit,1,4,3,1,1,0,1
přát,17,3,14,1,-1,0,1
přijímat,17,2,15,1,-1,0,1
posílat,2,2,0,0,-1,0,1
zahrnout,4,2,2,1,-1,1,1
splnit,11,2,9,1,-1,0,1
vracet,3,2,1,1,-1,0,1
vracet,14,2,12,1,-1,0,1
nabídnout,8,3,5,1,-1,0,1
dodat,7,2,5,1,-1,0,1
odeslat,3,3,0,0,-1,0,1
uhrazovat,2,3,1,1,1,0,1
ponechat,11,2,9,1,-1,0,1
převzít,2,2,0,0,1,0,1
poslat,2,3,-1,-1,-1,0,1
zajistit,5,3,2,1,-1,0,1
zúčastnit,1,3,2,1,1,0,1
pozvat,2,4,2,1,1,0,1
najít,8,4,4,1,-1,0,1
vypracovat,3,11,8,1,1,0,1
srovnat,1,4,3,1,1,0,1
zajistit,3,3,0,0,-1,0,1
předat,6,3,3,1,-1,0,1
vyřešit,2,3,1,1,1,0,1
připravit,5,3,2,1,-1,0,1
objednat,3,3,0,0,-1,0,1
zajistit,9,19,10,1,1,0,1
zajistit,4,6,2,1,1,0,1
zajistit,10,7,3,1,-1,0,1
projednat,7,3,4,1,-1,0,1
prověřit,13,3,10,1,-1,0,1
podat,11,4,7,1,-1,0,1
odstranit,1,5,4,1,1,0,1
evidovat,3,4,1,1,1,0,1
obdržet,4,8,-4,-1,-1,0,1
odevzdat,1,3,2,1,1,1,1
předávat,1,6,-5,-1,-1,0,1
zajistit,4,3,-1,-1,1,0,1
přesahovat,3,3,0,0,1,0,1
mít,2,2,0,0,-1,1,1
přivést,2,2,0,0,-1,0,1
mít,2,3,1,1,1,0,1
předávat,1,2,1,1,1,0,1
zabezpečit,1,5,4,1,1,1,1
vypínat,3,3,0,0,-1,0,1
používat,4,8,4,1,1,0,1
uložit,1,7,6,1,1,1,1
mít,9,2,7,1,-1,0,1
ovládat,1,3,2,1,1,0,1
zastavit,1,5,4,1,1,0,1
vložit,4,2,2,1,-1,0,1
mít,1,3,2,1,1,0,1
brát,2,2,0,0,-1,0,1
postavit,4,2,-2,-1,1,0,1
zasunout,2,4,2,1,1,0,1
navlhčit,1,3,2,1,1,0,1
vytřít,1,2,1,1,1,1,1
zasílat,3,8,5,1,1,0,1
zavádět,4,3,1,1,-1,0,1
uvádět,4,7,-3,-1,-1,0,1
uvádět,2,10,-8,-1,-1,0,1
poskytovat,2,25,23,1,1,0,1
vyčlenit,1,5,-4,-1,-1,0,1
stanovit,8,3,5,1,-1,0,1
převzít,2,3,1,1,1,0,1
poskytovat,6,3,3,1,-1,0,1
stanovit,6,6,0,0,-1,0,1
rozdělit,2,4,2,1,1,0,1
předložit,5,2,-3,-1,1,0,1
připravovat,8,5,3,1,-1,0,1
začlenit,11,6,5,1,-1,0,1
odevzdat,9,3,6,1,-1,0,1
zvýšit,6,4,2,1,-1,0,1
přitahovat,5,2,3,1,-1,1,1
vést,1,5,4,1,1,0,1
ponechat,1,4,3,1,1,0,1
ukončit,13,3,10,1,-1,0,1
přednést,5,12,7,1,1,0,1
vnést,6,2,4,1,-1,1,1
zahrnout,6,5,-1,-1,1,0,1
zabývat,3,3,0,0,1,0,1
zdůraznit,8,16,8,1,1,0,1
zúčastnit,3,6,3,1,1,0,1
natočit,13,3,10,1,-1,0,1
propůjčit,3,12,9,1,1,0,1
přiložit,1,2,1,1,1,0,1
přiložit,1,3,2,1,1,0,1
soustředit,5,18,13,1,1,0,1
zaručit,5,3,2,1,-1,0,1
dát,5,2,3,1,-1,0,1
zůstávat,1,2,1,1,1,0,1
prosadit,5,2,3,1,-1,0,1
hostit,2,3,-1,-1,-1,0,1
dostat,1,2,1,1,1,1,1
nechat,1,5,4,1,1,1,1
mít,8,2,6,1,-1,0,1
pozvednout,3,3,0,0,1,0,1
přiložit,1,2,1,1,1,0,1
přepočítat,3,2,1,1,-1,0,1
mít,4,3,1,1,-1,0,1
tahat,1,2,1,1,1,0,1
předložit,1,3,2,1,1,0,1
mít,2,2,0,0,-1,0,1
mít,3,2,-1,-1,1,0,1
propracovat,8,7,1,1,-1,0,1
používat,1,5,4,1,1,0,1
vytavit,2,9,7,1,1,0,1
vítat,2,5,3,1,1,0,1
překročit,3,3,0,0,1,0,1
účtovat,2,7,-5,-1,-1,0,1
odhalit,14,17,3,1,1,0,1
uplatnit,3,4,1,1,1,0,1
dojednávat,2,21,19,1,1,0,1
zobecnit,3,6,3,1,1,0,1
uvádět,1,2,1,1,1,1,1
dovést,1,7,6,1,1,0,1
ukazovat,28,2,26,1,-1,0,1
sloužit,2,8,6,1,1,0,1
snížit,2,3,1,1,1,0,1
ušetřit,2,3,-1,-1,-1,0,1
mít,3,9,-6,-1,-1,0,1
zaměřovat,2,4,2,1,1,0,1
připravit,12,4,8,1,-1,0,1
prospět,4,4,0,0,1,0,1
mít,2,2,0,0,-1,1,1
převzít,4,2,-2,-1,1,0,1
dostat,2,2,0,0,1,0,1
zůstat,2,3,-1,-1,-1,0,1
ohrožovat,1,7,6,1,1,0,1
naplnit,4,3,1,1,-1,0,1
dosáhnout,3,3,0,0,-1,0,1
mít,10,2,8,1,-1,0,1
zostřit,1,8,7,1,1,0,1
mít,2,2,0,0,-1,0,1
mít,1,2,1,1,1,0,1
uplatňovat,2,3,1,1,1,0,1
povzbuzovat,5,2,3,1,-1,0,1
psát,1,2,1,1,1,0,1
užívat,2,2,0,0,-1,0,1
převracet,1,4,3,1,1,0,1
číst,1,5,4,1,1,0,1
užívat,1,3,2,1,1,1,1
udržet,3,3,0,0,1,0,1
stát,3,3,0,0,-1,0,1
mít,15,2,13,1,-1,0,1
slyšet,6,3,3,1,-1,0,1
spolknout,2,4,2,1,1,0,1
mít,2,3,1,1,1,0,1
doznat,2,3,-1,-1,-1,0,1
napsat,11,3,8,1,-1,0,1
šířit,5,2,3,1,-1,1,1
chystat,1,3,2,1,1,0,1
dát,1,2,1,1,1,0,1
dát,1,2,1,1,1,0,1
vyřvávat,5,3,2,1,-1,0,1
zaručovat,3,3,0,0,-1,0,1
zdvihat,1,5,4,1,1,0,1
dávat,4,4,0,0,1,0,1
obrátit,2,3,1,1,1,0,1
mít,13,3,10,1,-1,0,1
mít,1,3,2,1,1,0,1
držet,1,2,1,1,1,0,1
mít,14,2,12,1,-1,0,1
zavést,2,6,4,1,1,0,1
odnášet,1,2,1,1,1,0,1
zalamovat,2,7,5,1,1,0,1
mít,15,2,13,1,-1,0,1
mít,7,2,5,1,-1,0,1
sehrát,5,2,3,1,-1,0,1
rovnat,3,3,0,0,1,0,1
získat,3,5,2,1,1,0,1
mít,10,2,8,1,-1,0,1
dělat,4,4,0,0,1,0,1
předstihnout,7,4,-3,-1,1,0,1
mít,8,3,5,1,-1,0,1
hledat,6,2,4,1,-1,1,1
položit,1,10,9,1,1,0,1
očekávat,2,3,-1,-1,-1,0,1
připravit,6,20,14,1,1,0,1
uzavřít,1,5,-4,-1,-1,0,1
dělat,1,9,8,1,1,1,1
odložit,5,2,3,1,-1,0,1
nosit,1,2,-1,-1,-1,0,1
zbavit,2,3,-1,-1,-1,0,1
najít,2,6,4,1,1,0,1
získat,1,7,6,1,1,0,1
vidět,2,2,0,0,1,0,1
škrábat,3,2,1,1,-1,0,1
ukázat,22,3,19,1,-1,0,1
vyrvat,1,3,2,1,1,0,1
vytýčit,11,4,7,1,-1,0,1
vzít,2,2,0,0,1,0,1
vychovávat,1,3,2,1,1,1,1
dávat,1,2,1,1,1,1,1
vést,1,7,6,1,1,1,1
vychovávat,1,4,3,1,1,0,1
pěstovat,13,2,11,1,-1,1,1
spojit,4,5,1,1,1,0,1
vyjádřit,2,7,5,1,1,0,1
mít,2,7,5,1,1,1,1
mít,9,2,7,1,-1,0,1
brát,8,2,6,1,-1,0,1
ukázat,1,2,1,1,1,0,1
stát,1,5,4,1,1,0,1
přijmout,19,4,15,1,-1,0,1
mít,9,2,7,1,-1,0,1
mít,2,4,-2,-1,-1,0,1
uspořádat,24,2,22,1,-1,0,1
naměřit,10,2,8,1,-1,0,1
uspořádat,1,10,9,1,1,1,1
mít,1,9,8,1,1,0,1
činit,2,3,-1,-1,-1,0,1
zvětšit,3,5,2,1,1,0,1
mít,1,2,1,1,1,0,1
prohlásit,1,5,4,1,1,0,1
dosáhnout,3,3,0,0,-1,0,1
předčit,7,5,-2,-1,1,0,1
hrát,2,5,3,1,1,0,1
mít,3,2,1,1,-1,1,1
mít,3,2,1,1,-1,0,1
vytasit,1,2,-1,-1,-1,1,1
přijmout,4,3,-1,-1,1,0,1
předložit,12,3,9,1,-1,0,1
ocitovat,5,6,-1,-1,-1,0,1
vzít,1,2,1,1,1,1,1
mít,2,5,-3,-1,-1,0,1
najít,5,6,1,1,1,0,1
dostat,1,3,2,1,1,1,1
spláchnout,3,2,1,1,-1,0,1
vytrhnout,1,2,1,1,1,1,1
zastavit,1,3,2,1,1,0,1
uvítat,4,4,0,0,1,0,1
věštit,4,5,1,1,1,0,1
položit,2,4,-2,-1,-1,0,1
rozebrat,9,15,6,1,1,0,1
mít,2,18,16,1,1,0,1
mít,9,3,6,1,-1,0,1
dovést,1,3,2,1,1,0,1
mít,4,16,12,1,1,0,1
mít,27,2,25,1,-1,0,1
vést,3,2,1,1,-1,1,1
dosáhnout,3,6,3,1,1,0,1
rozšířit,2,3,1,1,1,0,1
organizovat,2,4,-2,-1,-1,0,1
připustit,8,2,6,1,-1,0,1
vytáhnout,2,2,0,0,1,0,1
povést,1,8,7,1,1,1,1
navštěvovat,1,3,2,1,1,0,1
odstranit,4,4,0,0,-1,0,1
předávat,1,2,1,1,1,0,1
mívat,6,2,4,1,-1,0,1
obrátit,1,37,36,1,1,0,1
mít,7,2,5,1,-1,0,1
vytvářet,3,3,0,0,-1,0,1
zabezpečit,2,3,1,1,1,0,1
udržovat,3,3,0,0,1,0,1
změnit,4,2,2,1,-1,0,1
změnit,3,3,0,0,-1,0,1
zvýšit,1,3,2,1,1,0,1
plnit,1,3,2,1,1,0,1
vytvořit,9,3,6,1,-1,0,1
činit,3,4,-1,-1,-1,0,1
vybrat,1,3,2,1,1,0,1
mít,7,3,-4,-1,1,0,1
mít,3,3,0,0,1,0,1
vyvážet,10,6,-4,-1,1,0,1
mít,12,2,10,1,-1,1,1
uzavírat,2,3,-1,-1,-1,0,1
dosahovat,3,4,1,1,1,0,1
přinést,7,4,3,1,-1,0,1
využít,6,8,2,1,1,0,1
převzít,5,7,-2,-1,-1,0,1
hledat,4,2,2,1,-1,0,1
mít,16,2,14,1,-1,1,1
přemístit,1,3,2,1,1,1,1
mít,3,4,-1,-1,-1,1,1
najít,4,5,1,1,1,0,1
přivádět,15,2,13,1,-1,0,1
vyrábět,4,7,3,1,1,0,1
dosáhnout,2,6,-4,-1,-1,0,1
zadržovat,1,3,-2,-1,-1,0,1
zajišťovat,1,7,6,1,1,0,1
zaznamenat,2,11,9,1,1,0,1
zřizovat,1,4,3,1,1,0,1
mít,1,2,-1,-1,-1,0,1
mít,6,2,4,1,-1,1,1
karikovat,1,3,2,1,1,0,1
schovat,2,2,0,0,1,0,1
předvést,3,6,-3,-1,-1,0,1
obrátit,1,17,16,1,1,0,1
uvést,7,2,5,1,-1,0,1
vyvinout,4,7,-3,-1,-1,0,1
mít,2,3,-1,-1,-1,0,1
mít,1,6,-5,-1,-1,0,1
uvést,5,2,3,1,-1,0,1
snižovat,2,4,2,1,1,0,1
zřídit,3,5,-2,-1,-1,0,1
odcizit,4,5,-1,-1,-1,0,1
ukrýt,1,3,2,1,1,1,1
mít,3,2,1,1,-1,0,1
sloužit,1,6,5,1,1,0,1
dodávat,1,4,3,1,1,0,1
mít,2,3,1,1,1,0,1
vyjádřit,8,2,6,1,-1,1,1
uspořádat,15,6,9,1,-1,0,1
ušetřit,2,2,0,0,1,0,1
stát,1,3,-2,-1,-1,0,1
zanechávat,2,4,-2,-1,-1,0,1
umožnit,1,2,1,1,1,0,1
překročit,1,4,3,1,1,0,1
účastnit,7,3,4,1,-1,0,1
pronajmout,2,3,-1,-1,-1,0,1
zachycovat,5,3,-2,-1,1,0,1
mít,10,4,6,1,-1,0,1
namíchat,5,3,2,1,-1,0,1
splnit,6,3,-3,-1,1,0,1
připravovat,11,5,6,1,-1,0,1
vybírat,1,5,4,1,1,0,1
vybudovat,3,5,2,1,1,0,1
zahájit,12,4,8,1,-1,0,1
zajistit,3,4,-1,-1,-1,0,1
vykazovat,2,5,-3,-1,-1,0,1
odpracovat,3,10,7,1,1,0,1
odpracovat,2,3,-1,-1,-1,0,1
vykazovat,2,11,9,1,1,0,1
vykazovat,2,12,10,1,1,0,1
vykazovat,2,12,10,1,1,0,1
vykazovat,2,9,7,1,1,0,1
mít,12,2,10,1,-1,0,1
odpracovat,2,3,1,1,1,0,1
mít,2,10,8,1,1,0,1
činit,2,4,2,1,1,0,1
činit,2,4,2,1,1,0,1
vykazovat,6,2,4,1,-1,0,1
česat,2,2,0,0,-1,0,1
pomáhat,2,3,1,1,1,0,1
posílat,3,2,-1,-1,1,0,1
potřebovat,3,2,1,1,-1,0,1
odnést,1,3,2,1,1,1,1
mít,9,2,7,1,-1,1,1
splnit,4,2,2,1,-1,0,1
měnit,1,31,30,1,1,1,1
dopouštět,7,3,4,1,-1,0,1
přivlastňovat,1,3,2,1,1,0,1
mít,8,2,6,1,-1,0,1
mít,2,4,-2,-1,-1,0,1
zaslat,23,4,19,1,-1,0,1
přivést,8,5,3,1,-1,0,1
připravit,12,11,-1,-1,1,0,1
dosáhnout,2,3,-1,-1,-1,0,1
využívat,4,6,2,1,1,0,1
převzít,6,5,1,1,-1,0,1
obsahovat,36,3,33,1,-1,0,1
vzpomenout,2,4,2,1,1,0,1
mít,18,2,16,1,-1,0,1
školit,4,4,0,0,-1,0,1
zapojovat,3,11,-8,-1,-1,0,1
koordinovat,5,8,3,1,1,0,1
mít,2,6,4,1,1,0,1
pomáhat,1,2,1,1,1,1,1
přinést,1,4,3,1,1,0,1
najít,11,8,3,1,-1,0,1
dostat,11,4,7,1,-1,0,1
převzít,3,3,0,0,-1,0,1
udržovat,1,2,-1,-1,-1,0,1
zavřít,1,2,-1,-1,-1,0,1
cítit,1,2,1,1,1,-1,1
držet,1,2,-1,-1,-1,0,1
oklepávat,1,2,1,1,1,0,1
přispět,1,4,3,1,1,0,1
plánovat,2,7,5,1,1,0,1
zpracovávat,3,5,2,1,1,0,1
postavit,1,5,4,1,1,0,1
povolit,5,5,0,0,1,0,1
překládat,1,5,4,1,1,1,1
kapat,1,3,2,1,1,0,1
potřebovat,5,2,3,1,-1,0,1
prosadit,5,3,2,1,-1,0,1
dožívat,2,16,14,1,1,0,1
připevnit,1,2,-1,-1,-1,0,1
nechávat,2,2,0,0,1,0,1
posílat,4,2,2,1,-1,0,1
přenášet,3,2,1,1,-1,0,1
vyžadovat,5,5,0,0,-1,1,1
posadit,1,2,1,1,1,0,1
zabírat,3,3,0,0,-1,0,1
mít,1,6,5,1,1,0,1
mít,3,2,1,1,-1,1,1
vést,3,12,9,1,1,0,1
podporovat,2,5,-3,-1,-1,0,1
uplatňovat,4,8,4,1,1,0,1
vytvořit,3,3,0,0,1,0,1
vyhrát,1,6,5,1,1,0,1
získat,1,8,7,1,1,0,1
dopouštět,3,5,-2,-1,-1,0,1
chovat,1,2,1,1,1,1,1
kazit,2,6,4,1,1,0,1
mít,2,2,0,0,-1,0,1
užívat,2,2,0,0,-1,0,1
měnit,1,2,-1,-1,-1,0,1
získávat,1,6,5,1,1,0,1
zajistit,6,5,-1,-1,1,0,1
přiložit,6,2,4,1,-1,0,1
zajistit,3,4,-1,-1,-1,0,1
poskytnout,2,3,1,1,1,0,1
převádět,6,3,-3,-1,1,0,1
uplatňovat,9,3,6,1,-1,0,1
mít,3,2,1,1,-1,0,1
přijmout,30,3,27,1,-1,0,1
dosahovat,3,4,-1,-1,-1,0,1
provádět,2,10,8,1,1,0,1
položit,4,3,1,1,-1,0,1
položit,1,5,4,1,1,0,1
plnit,1,3,2,1,1,0,1
oceňovat,1,10,9,1,1,0,1
zahájit,10,4,6,1,-1,0,1
klást,3,2,1,1,-1,0,1
zařadit,10,3,7,1,-1,0,1
plnit,3,4,1,1,1,0,1
mít,2,4,-2,-1,-1,0,1
změřit,2,10,8,1,1,0,1
mít,2,3,-1,-1,-1,0,1
mít,2,2,0,0,1,0,1
najít,4,5,-1,-1,-1,0,1
poskytovat,1,3,2,1,1,0,1
dát,7,2,5,1,-1,0,1
uskutečnit,3,2,1,1,-1,0,1
sklízet,1,4,3,1,1,0,1
dosáhnout,3,7,4,1,1,0,1
dostávat,3,2,1,1,-1,0,1
uvádět,6,2,4,1,-1,0,1
odvádět,5,2,3,1,-1,0,1
snížit,1,3,2,1,1,1,1
umístit,1,3,2,1,1,1,1
postihnout,2,5,3,1,1,0,1
stát,1,3,-2,-1,-1,0,1
dosahovat,2,8,6,1,1,0,1
přijmout,2,13,11,1,1,0,1
sdělovat,1,4,3,1,1,0,1
mít,7,2,5,1,-1,0,1
mít,2,2,0,0,-1,0,1
uspořádat,2,3,1,1,1,0,1
učinit,9,5,-4,-1,1,0,1
dávat,2,4,-2,-1,-1,0,1
mít,4,2,2,1,-1,0,1
naložit,1,2,1,1,1,0,1
povznášet,5,3,-2,-1,1,0,1
vytvářet,2,3,1,1,1,0,1
mít,1,2,-1,-1,-1,0,1
zajistit,3,4,-1,-1,-1,0,1
hodnotit,13,3,10,1,-1,0,1
udělat,1,18,17,1,1,1,1
dokazovat,2,4,-2,-1,-1,0,1
mít,2,3,-1,-1,-1,0,1
provést,1,3,2,1,1,0,1
znamenat,1,5,-4,-1,-1,0,1
dát,3,2,1,1,-1,0,1
založit,2,2,0,0,1,0,1
mít,11,2,9,1,-1,0,1
vést,3,14,11,1,1,0,1
odcizit,3,3,0,0,-1,0,1
poškodit,3,5,2,1,1,0,1
věnovat,1,3,2,1,1,0,1
mít,2,4,2,1,1,0,1
dostat,3,3,0,0,-1,0,1
mít,3,3,0,0,1,0,1
popřát,5,3,2,1,-1,0,1
dostat,15,3,12,1,-1,0,1
oznámit,2,2,0,0,1,0,1
vyhledat,2,2,0,0,1,0,1
mít,3,2,1,1,-1,1,1
natáčet,7,4,3,1,-1,0,1
hledat,7,3,4,1,-1,0,1
podat,9,3,6,1,-1,0,1
zhodnotit,1,15,14,1,1,0,1
najít,1,3,-2,-1,-1,0,1
vyvolat,2,5,3,1,1,0,1
uspořit,4,3,1,1,-1,0,1
přinést,2,3,1,1,1,0,1
psát,4,2,2,1,-1,0,1
mít,2,2,0,0,-1,0,1
připravovat,1,5,4,1,1,0,1
hrát,1,7,6,1,1,0,1
čeřit,2,5,3,1,1,0,1
mít,3,2,1,1,-1,0,1
mít,3,2,1,1,-1,0,1
mít,1,4,3,1,1,0,1
mít,2,3,1,1,1,0,1
odnést,3,2,1,1,-1,0,1
mít,6,8,-2,-1,-1,0,1
najít,23,3,20,1,-1,0,1
brát,1,3,-2,-1,-1,0,1
vytvořit,3,5,2,1,1,0,1
vycucat,1,2,1,1,1,0,1
poznat,2,3,1,1,1,0,1
vybrat,2,8,6,1,1,0,1
mít,2,2,0,0,-1,0,1
najít,2,5,3,1,1,0,1
propůjčit,2,3,-1,-1,-1,0,1
uvádět,23,2,21,1,-1,0,1
čerpat,1,10,9,1,1,0,1
dostat,10,2,8,1,-1,0,1
postavit,3,2,1,1,-1,0,1
vytvořit,3,2,1,1,-1,1,1
podat,17,3,14,1,-1,0,1
vytvářet,2,3,1,1,1,0,1
mít,4,3,1,1,-1,0,1
dosáhnout,2,10,8,1,1,0,1
hledat,2,3,-1,-1,-1,0,1
vnést,2,3,-1,-1,-1,-1,1
ovlivnit,1,4,3,1,1,1,1
vidět,1,8,7,1,1,1,1
zpívat,3,7,4,1,1,0,1
vzít,4,2,-2,-1,1,0,1
mít,3,2,1,1,-1,1,1
nechávat,2,3,-1,-1,-1,0,1
mívat,4,2,2,1,-1,0,1
přidat,4,3,1,1,-1,0,1
mít,6,2,4,1,-1,1,1
zařadit,1,2,1,1,1,0,1
vystavovat,2,2,0,0,1,0,1
ověřit,2,4,2,1,1,0,1
dávat,2,2,0,0,-1,0,1
dosáhnout,5,4,-1,-1,1,0,1
řezat,3,3,0,0,1,0,1
uspokojovat,1,7,6,1,1,1,1
zapustit,1,6,5,1,1,1,1
přenést,1,9,8,1,1,0,1
snížit,3,3,0,0,1,0,1
odcizit,2,3,-1,-1,-1,0,1
krást,2,3,-1,-1,-1,0,1
podpořit,7,41,34,1,1,0,1
předložit,3,2,1,1,-1,0,1
dostat,3,2,1,1,-1,0,1
vydat,16,5,11,1,-1,0,1
vzít,1,7,6,1,1,0,1
zakoupit,4,2,2,1,-1,0,1
zakoupit,8,4,4,1,-1,0,1
kritizovat,11,11,0,0,1,0,1
zabezpečit,3,4,1,1,1,0,1
přinést,3,2,1,1,-1,0,1
doprovázet,2,6,4,1,1,0,1
získat,6,4,-2,-1,1,0,1
získat,1,11,10,1,1,0,1
schválit,11,3,8,1,-1,0,1
soustředit,5,12,7,1,1,0,1
mít,16,2,14,1,-1,0,1
mít,6,6,0,0,-1,0,1
působit,1,4,3,1,1,0,1
posílat,4,8,-4,-1,-1,0,1
udělat,1,3,-2,-1,-1,0,1
mít,2,2,0,0,-1,0,1
najít,2,4,2,1,1,0,1
rozvíjet,21,2,19,1,-1,1,1
překonat,4,6,2,1,1,0,1
odpracovat,2,6,-4,-1,-1,0,1
věnovat,2,3,-1,-1,-1,0,1
činit,3,3,0,0,-1,0,1
brát,1,2,1,1,1,1,1
používat,5,3,-2,-1,1,0,1
najít,10,2,8,1,-1,1,1
dopravovat,4,3,1,1,-1,0,1
mít,1,3,-2,-1,-1,0,1
mít,2,3,-1,-1,-1,0,1
přepočíst,9,12,3,1,1,0,1
volat,1,16,15,1,1,0,1
dovést,6,3,-3,-1,1,0,1
organizovat,2,4,2,1,1,0,1
hlídat,2,13,11,1,1,0,1
mít,10,2,8,1,-1,1,1
mít,1,2,-1,-1,-1,0,1
vyzvednout,3,2,1,1,-1,0,1
pomoci,4,3,1,1,-1,0,1
informovat,2,35,33,1,1,0,1
mít,2,2,0,0,-1,0,1
věnovat,8,4,-4,-1,1,0,1
projednat,6,2,4,1,-1,0,1
nechat,3,3,0,0,1,0,1
vycházet,1,3,2,1,1,1,1
vyjádřit,34,2,32,1,-1,1,1
zhodnotit,6,3,3,1,-1,0,1
rozvíjet,21,3,18,1,-1,0,1
vidět,20,10,10,1,-1,0,1
získávat,1,4,3,1,1,0,1
vložit,5,2,3,1,-1,0,1
prožívat,5,2,-3,-1,1,0,1
volat,2,4,2,1,1,1,1
čekat,1,7,6,1,1,0,1
vyměnit,2,18,16,1,1,0,1
najít,5,4,1,1,-1,0,1
rozpracovat,7,5,2,1,-1,0,1
vypracovat,15,5,10,1,-1,0,1
zařadit,10,3,7,1,-1,0,1
připravovat,6,2,4,1,-1,0,1
hrát,2,2,0,0,-1,0,1
nacvičovat,2,3,-1,-1,-1,0,1
hodnotit,6,2,4,1,-1,0,1
zaměřit,1,13,12,1,1,0,1
činit,2,3,1,1,1,0,1
plánovat,8,2,6,1,-1,0,1
připravovat,19,4,15,1,-1,0,1
hodnotit,7,3,4,1,-1,0,1
žít,1,4,3,1,1,0,1
obohacovat,1,3,2,1,1,1,1
vytvořit,2,4,2,1,1,0,1
stavět,8,2,6,1,-1,1,1
reprezentovat,4,2,-2,-1,1,0,1
podkládat,1,2,1,1,1,0,1
naleznout,2,2,0,0,1,0,1
vystavovat,5,3,-2,-1,1,0,1
převzít,1,3,2,1,1,0,1
vyřešit,5,6,1,1,1,0,1
dokázat,1,13,12,1,1,0,1
dělat,1,3,2,1,1,0,1
nacházet,4,3,1,1,-1,0,1
vytvářet,3,2,1,1,-1,0,1
zavést,15,4,11,1,-1,0,1
vést,1,3,2,1,1,0,1
přijmout,9,2,7,1,-1,0,1
stanovit,2,3,-1,-1,-1,0,1
znamenat,2,2,0,0,-1,0,1
uveřejnit,2,15,13,1,1,0,1
použít,7,3,4,1,-1,0,1
zachraňovat,1,3,2,1,1,0,1
dělat,2,2,0,0,1,0,1
upozorňovat,2,7,5,1,1,0,1
mít,3,3,0,0,-1,0,1
rozpracovat,2,5,3,1,1,0,1
přijímat,20,4,16,1,-1,0,1
konkretizovat,4,3,-1,-1,1,0,1
zaměřit,2,9,7,1,1,0,1
doporučovat,4,6,-2,-1,-1,0,1
věstit,2,17,15,1,1,1,1
mít,6,3,3,1,-1,0,1
nastupovat,11,7,4,1,-1,0,1
vyvolat,4,2,2,1,-1,0,1
vzít,4,2,2,1,-1,0,1
mít,3,3,0,0,-1,0,1
podceňovat,1,2,1,1,1,1,1
doléčovat,1,2,1,1,1,0,1
drtit,1,2,1,1,1,0,1
zajišťovat,9,3,6,1,-1,0,1
dopřávat,3,3,0,0,-1,0,1
zakotvovat,3,3,0,0,-1,0,1
spojovat,5,6,1,1,1,0,1
budovat,1,2,1,1,1,-1,1
dokumentovat,3,3,0,0,-1,0,1
stát,7,3,4,1,-1,0,1
ujít,2,2,0,0,-1,0,1
vidět,17,2,15,1,-1,0,1
nacupitat,3,3,0,0,-1,0,1
vtáhnout,1,2,-1,-1,-1,0,1
dostat,1,2,1,1,1,0,1
dát,8,2,6,1,-1,-1,1
přinést,18,7,11,1,-1,0,1
chránit,2,4,2,1,1,0,1
zdokonalovat,4,3,1,1,-1,0,1
připravovat,1,3,2,1,1,0,1
připočíst,3,2,1,1,-1,0,1
mít,2,2,0,0,-1,0,1
slyšet,3,3,0,0,-1,0,1
povznést,1,5,4,1,1,0,1
mít,30,2,28,1,-1,1,1
smočit,1,2,1,1,1,0,1
pozorovat,1,4,3,1,1,0,1
dělat,2,3,-1,-1,-1,0,1
uvést,4,2,2,1,-1,0,1
přidat,3,2,1,1,-1,0,1
vykonat,3,2,-1,-1,1,0,1
vzpomenout,3,10,7,1,1,0,1
napsat,9,2,7,1,-1,0,1
potřebovat,2,8,-6,-1,-1,0,1
dosáhnout,2,3,1,1,1,0,1
představovat,5,3,2,1,-1,0,1
opravovat,2,2,0,0,-1,0,1
dát,1,2,1,1,1,0,1
vybírat,1,2,-1,-1,-1,0,1
dát,2,2,0,0,1,0,1
naťukat,2,2,0,0,-1,0,1
odvysílat,2,3,1,1,1,0,1
mít,5,2,3,1,-1,1,1
mít,2,2,0,0,-1,1,1
slibovat,2,2,0,0,-1,-1,1
vyplétat,1,5,4,1,1,1,1
mít,3,2,1,1,-1,0,1
vzít,1,2,-1,-1,-1,0,1
opouštět,1,7,6,1,1,0,1
vytáhnout,7,3,4,1,-1,0,1
uvítat,26,2,24,1,-1,0,1
obdržet,4,7,-3,-1,-1,0,1
navštívit,2,3,1,1,1,0,1
vynést,8,3,5,1,-1,0,1
rozebírat,4,16,12,1,1,0,1
zastupovat,2,7,5,1,1,0,1
mít,6,3,3,1,-1,0,1
nechávat,11,2,9,1,-1,0,1
zvolit,9,3,6,1,-1,0,1
přijmout,9,4,5,1,-1,0,1
najít,1,4,3,1,1,0,1
provázet,1,3,2,1,1,1,1
využít,1,5,4,1,1,1,1
vytvářet,2,4,2,1,1,0,1
patřit,1,2,1,1,1,1,1
nechávat,3,3,0,0,1,0,1
vzít,3,2,1,1,-1,0,1
vrazit,1,2,1,1,1,0,1
zaslat,1,11,10,1,1,0,1
zorganizovat,16,2,14,1,-1,1,1
řešit,3,8,5,1,1,0,1
řadit,3,4,1,1,1,0,1
zaujímat,4,3,1,1,-1,0,1
mít,2,2,0,0,-1,1,1
mít,14,2,12,1,-1,0,1
posilovat,1,18,17,1,1,1,1
vytvářet,7,2,5,1,-1,0,1
stávat,2,7,5,1,1,-1,1
dělat,1,3,2,1,1,0,1
umýt,2,3,1,1,1,0,1
vylít,1,8,7,1,1,1,1
využít,2,10,8,1,1,0,1
vzdát,2,4,2,1,1,0,1
uložit,4,2,2,1,-1,0,1
množit,1,2,1,1,1,0,1
pěstovat,1,4,3,1,1,0,1
hledat,1,2,1,1,1,0,1
mít,2,28,26,1,1,0,1
zastoupit,2,3,1,1,1,0,1
sledovat,2,3,-1,-1,-1,0,1
přinášet,2,15,-13,-1,-1,0,1
poznat,1,4,3,1,1,0,1
vnést,8,3,5,1,-1,0,1
hrát,2,4,-2,-1,-1,0,1
mít,23,2,21,1,-1,1,1
mít,2,3,-1,-1,-1,0,1
vysílat,34,4,30,1,-1,0,1
tradovat,1,3,-2,-1,-1,0,1
vládnout,1,3,2,1,1,0,1
vidět,5,2,3,1,-1,1,1
odvézt,1,2,1,1,1,1,1
mít,2,2,0,0,1,0,1
točit,2,3,1,1,1,0,1
vytáhnout,1,2,1,1,1,0,1
nechávat,3,2,-1,-1,1,-1,1
odpovídat,2,7,5,1,1,0,1
schovat,1,2,1,1,1,1,1
říkat,2,5,3,1,1,0,1
dát,7,2,5,1,-1,0,1
přivést,1,7,-6,-1,-1,0,1
povyšovat,4,4,0,0,-1,0,1
zastavit,1,2,-1,-1,-1,0,1
ujít,2,3,1,1,1,0,1
sbírat,2,3,-1,-1,-1,0,1
chybět,1,2,1,1,1,0,1
mít,9,3,6,1,-1,0,1
mít,5,3,2,1,-1,0,1
hledat,1,3,-2,-1,-1,0,1
mít,2,3,-1,-1,-1,0,1
mít,2,2,0,0,-1,0,1
volat,2,2,0,0,1,0,1
porazit,2,2,0,0,-1,0,1
slavit,2,4,-2,-1,-1,0,1
řešit,5,4,-1,-1,1,0,1
sledovat,1,2,1,1,1,0,1
zabořit,2,3,1,1,1,0,1
odehnat,4,4,0,0,1,0,1
znamenat,3,3,0,0,-1,0,1
udělat,12,3,9,1,-1,0,1
škrtnout,5,2,3,1,-1,0,1
napsat,4,2,2,1,-1,0,1
znát,11,2,9,1,-1,0,1
využít,4,3,-1,-1,1,0,1
získat,2,2,0,0,-1,1,1
řídit,6,3,3,1,-1,0,1
hodit,1,2,1,1,1,0,1
držet,1,2,1,1,1,0,1
dostat,3,3,0,0,-1,0,1
dobývat,2,3,-1,-1,-1,0,1
mít,5,3,-2,-1,1,0,1
uzavřít,1,3,2,1,1,0,1
přivádět,1,6,5,1,1,0,1
prodloužit,1,3,2,1,1,0,1
patřit,7,3,4,1,-1,0,1
vytvořit,2,3,-1,-1,-1,0,1
vysadit,7,4,-3,-1,1,0,1
vytvořit,5,3,2,1,-1,0,1
vyhradit,2,2,0,0,-1,1,1
dávat,1,2,1,1,1,1,1
vidět,6,3,3,1,-1,0,1
myslit,1,2,1,1,1,-1,1
zdůraznit,10,9,1,1,-1,0,1
přerušit,1,5,4,1,1,0,1
obdivovat,6,2,4,1,-1,1,1
projezdit,2,7,5,1,1,0,1
mít,1,5,4,1,1,0,1
měnit,2,2,0,0,1,-1,1
mít,1,3,-2,-1,-1,0,1
nést,1,3,2,1,1,0,1
uspořádat,11,2,9,1,-1,0,1
získat,2,4,2,1,1,0,1
mít,4,2,2,1,-1,0,1
vyrábět,6,3,3,1,-1,0,1
postavit,3,2,1,1,-1,0,1
zatlačit,18,2,16,1,-1,0,1
převzít,2,2,0,0,-1,0,1
vařit,2,8,6,1,1,0,1
používat,10,2,8,1,-1,1,1
vybrat,31,3,28,1,-1,0,1
způsobovat,3,2,1,1,-1,0,1
odpočítat,3,2,1,1,-1,0,1
pořídit,12,2,10,1,-1,0,1
vyžadovat,3,4,1,1,1,0,1
získat,6,3,3,1,-1,0,1
představovat,4,3,1,1,-1,0,1
kupovat,3,4,1,1,1,0,1
vytvářet,4,9,5,1,1,0,1
vylučovat,2,3,-1,-1,-1,0,1
orientovat,2,8,6,1,1,0,1
shánět,5,3,-2,-1,1,0,1
mít,12,2,10,1,-1,0,1
doporučit,3,19,16,1,1,0,1
vyrábět,2,3,1,1,1,0,1
dokončit,13,2,11,1,-1,0,1
připravovat,8,3,5,1,-1,0,1
najít,3,17,14,1,1,0,1
vysvětlovat,2,6,4,1,1,0,1
vzít,5,2,3,1,-1,0,1
předurčovat,2,6,4,1,1,0,1
dávat,1,4,-3,-1,-1,0,1
jmenovat,33,3,30,1,-1,0,1
mít,3,2,-1,-1,1,0,1
mít,1,3,2,1,1,0,1
mít,1,3,2,1,1,0,1
šetřit,6,2,4,1,-1,1,1
znamenat,1,3,-2,-1,-1,0,1
vytvořit,16,3,13,1,-1,0,1
předvést,13,5,8,1,-1,0,1
tvořit,2,3,-1,-1,-1,0,1
shromáždit,20,3,17,1,-1,0,1
požadovat,1,5,4,1,1,0,1
odvádět,3,4,1,1,1,0,1
pořádat,2,2,0,0,-1,1,1
mít,1,4,-3,-1,-1,0,1
získat,1,6,5,1,1,1,1
mít,6,2,4,1,-1,0,1
podávat,5,2,3,1,-1,0,1
přinést,3,2,-1,-1,1,0,1
vytáhnout,4,2,2,1,-1,0,1
odpovídat,2,8,6,1,1,0,1
dostat,2,3,1,1,1,0,1
podávat,2,11,9,1,1,0,1
požírat,4,6,2,1,1,0,1
stát,3,2,1,1,-1,0,1
slepit,2,2,0,0,1,0,1
mít,7,2,5,1,-1,0,1
pozorovat,7,7,0,0,1,0,1
mít,3,3,0,0,-1,0,1
mít,2,2,0,0,-1,1,1
vědět,19,2,17,1,-1,0,1
páchat,2,6,4,1,1,0,1
plnit,3,5,2,1,1,0,1
zatahovat,1,5,4,1,1,0,1
ochuzovat,2,3,-1,-1,-1,0,1
vypouštět,3,2,1,1,-1,0,1
vyvinout,5,3,-2,-1,1,0,1
zkoušet,1,3,2,1,1,1,1
vytvářet,2,2,0,0,-1,0,1
mít,1,2,-1,-1,-1,0,1
vyřezat,1,3,2,1,1,0,1
napsat,3,3,0,0,-1,0,1
mít,2,2,0,0,-1,0,1
hlídat,2,3,1,1,1,0,1
prosedět,2,3,1,1,1,0,1
najít,3,5,-2,-1,-1,0,1
najít,3,2,1,1,-1,0,1
postavit,2,5,3,1,1,0,1
mít,12,2,10,1,-1,0,1
vidět,1,3,2,1,1,1,1
pořídit,19,3,16,1,-1,0,1
přimět,8,3,5,1,-1,0,1
vidět,1,3,2,1,1,1,1
mít,12,2,10,1,-1,0,1
vidět,2,3,1,1,1,0,1
vidět,16,3,13,1,-1,0,1
gratulovat,2,3,1,1,1,0,1
tvořit,1,2,1,1,1,0,1
slyšet,13,2,11,1,-1,0,1
prodělat,2,5,-3,-1,-1,0,1
vymoci,9,3,6,1,-1,0,1
měřit,2,3,1,1,1,0,1
vypadat,1,3,2,1,1,0,1
rozlišovat,1,2,1,1,1,0,1
podepsat,1,3,2,1,1,0,1
dostat,2,3,1,1,1,0,1
mít,3,2,1,1,-1,1,1
sdílet,18,3,15,1,-1,0,1
budovat,3,7,4,1,1,0,1
stát,5,3,2,1,-1,0,1
vydat,10,3,7,1,-1,0,1
uvést,14,4,10,1,-1,0,1
omezit,8,3,5,1,-1,0,1
nalézt,2,8,6,1,1,0,1
dokumentovat,5,4,-1,-1,1,0,1
shlédnout,1,3,2,1,1,1,1
demonstrovat,3,4,1,1,1,0,1
zahájit,2,2,0,0,-1,0,1
otevřít,3,3,0,0,1,0,1
dobývat,2,15,13,1,1,0,1
získat,1,7,6,1,1,0,1
řídit,6,2,4,1,-1,0,1
uvítat,57,3,54,1,-1,0,1
mít,27,9,-18,-1,1,0,1
mít,2,9,-7,-1,-1,0,1
vydat,5,3,2,1,-1,0,1
vést,1,5,4,1,1,0,1
vést,2,12,10,1,1,0,1
mít,8,2,6,1,-1,0,1
dostávat,5,29,24,1,1,0,1
rozpoznat,1,20,19,1,1,1,1
rozlišovat,4,17,13,1,1,0,1
předpokládat,3,2,1,1,-1,1,1
uvádět,1,2,1,1,1,0,1
uvést,1,8,7,1,1,0,1
udávat,3,3,0,0,-1,0,1
brát,19,2,17,1,-1,0,1
poznat,2,5,3,1,1,0,1
vzdělávat,1,10,9,1,1,0,1
navštěvovat,1,5,4,1,1,0,1
končit,4,11,7,1,1,0,1
nacházet,3,2,1,1,-1,-1,1
ověřovat,3,2,1,1,-1,0,1
produkovat,7,4,3,1,-1,0,1
prodloužit,4,3,-1,-1,1,0,1
zapustit,3,3,0,0,-1,0,1
rozvinout,2,3,1,1,1,0,1
nalézat,1,9,8,1,1,0,1
položit,11,2,9,1,-1,0,1
končit,2,7,5,1,1,0,1
přistřihávat,1,3,2,1,1,1,1
opouštět,2,4,2,1,1,0,1
zavírat,1,3,2,1,1,0,1
věnovat,2,2,0,0,-1,0,1
dosahovat,3,4,1,1,1,0,1
prodloužit,3,4,1,1,1,0,1
soustředit,3,6,3,1,1,0,1
obohacovat,6,7,1,1,1,0,1
vychovávat,1,3,2,1,1,0,1
změnit,1,4,3,1,1,0,1
poznat,3,2,1,1,-1,0,1
chovat,1,2,1,1,1,1,1
uvádět,1,11,10,1,1,1,1
způsobit,5,3,2,1,-1,0,1
zůstávat,1,2,-1,-1,-1,0,1
mít,6,2,4,1,-1,1,1
ponechat,1,12,11,1,1,0,1
mít,5,4,1,1,-1,0,1
vypsat,15,2,13,1,-1,0,1
najít,6,2,-4,-1,1,0,1
uvádět,2,31,29,1,1,0,1
vyjadřovat,4,2,2,1,-1,0,1
opomenout,10,2,8,1,-1,0,1
mít,3,3,0,0,-1,0,1
vytvořit,1,4,-3,-1,-1,0,1
vytvořit,7,3,4,1,-1,0,1
objet,1,3,2,1,1,0,1
mít,2,3,1,1,1,0,1
mít,1,3,-2,-1,-1,0,1
dovážet,1,3,2,1,1,0,1
vylámat,8,5,-3,-1,1,0,1
dokončit,1,4,3,1,1,1,1
rozvádět,1,9,8,1,1,0,1
dostat,5,6,1,1,1,0,1
získávat,2,6,4,1,1,0,1
rozvážet,2,2,0,0,1,0,1
postavit,14,2,12,1,-1,1,1
využívat,3,3,0,0,1,0,1
dát,1,2,1,1,1,1,1
sloužit,2,5,3,1,1,0,1
postavit,1,7,6,1,1,0,1
udržovat,3,3,0,0,-1,0,1
udržovat,2,2,0,0,1,1,1
vytlačovat,1,4,3,1,1,0,1
mít,10,2,8,1,-1,0,1
tlačit,1,4,3,1,1,0,1
zbudovat,5,7,2,1,1,0,1
počítat,6,2,4,1,-1,0,1
mít,2,2,0,0,-1,0,1
ukázat,7,5,-2,-1,1,0,1
dostoupit,1,7,6,1,1,0,1
pomíjet,13,4,9,1,-1,0,1
měřit,3,3,0,0,1,0,1
předstihnout,1,3,-2,-1,-1,0,1
vytvořit,1,16,15,1,1,0,1
přijmout,4,10,-6,-1,-1,0,1
přijmout,13,2,11,1,-1,0,1
přiřazovat,5,2,3,1,-1,1,1
přiřadit,10,2,8,1,-1,1,1
probírat,11,3,-8,-1,1,0,1
rozdělit,4,20,16,1,1,0,1
označovat,1,7,6,1,1,1,1
dostat,15,3,12,1,-1,0,1
rozšiřovat,3,16,13,1,1,0,1
stanovit,2,2,0,0,-1,0,1
dávat,3,3,0,0,-1,0,1
vzbudit,6,10,4,1,1,0,1
patentovat,10,9,1,1,-1,0,1
navrhnout,12,6,6,1,-1,0,1
vykonávat,2,9,7,1,1,0,1
vysílat,2,3,-1,-1,-1,0,1
používat,1,3,-2,-1,-1,0,1
připojit,2,2,0,0,-1,0,1
mít,20,5,15,1,-1,0,1
přitahovat,1,3,-2,-1,-1,0,1
dobývat,2,5,3,1,1,0,1
kreslit,9,3,6,1,-1,0,1
mít,3,2,-1,-1,1,0,1
přenášet,2,5,3,1,1,0,1
značit,2,3,1,1,1,0,1
připoutat,6,2,4,1,-1,1,1
vytvořit,4,2,2,1,-1,0,1
mít,2,4,2,1,1,0,1
psát,1,7,6,1,1,0,1
sčítat,4,5,1,1,1,0,1
zanechávat,7,2,5,1,-1,1,1
najít,5,3,-2,-1,1,0,1
najít,6,3,-3,-1,1,0,1
sledovat,1,4,3,1,1,0,1
zapojit,8,3,5,1,-1,0,1
přivést,2,2,0,0,-1,0,1
měnit,1,4,3,1,1,0,1
mít,2,6,4,1,1,0,1
předpovídat,2,5,3,1,1,0,1
zajistit,2,6,4,1,1,0,1
mít,1,2,-1,-1,-1,0,1
mít,6,2,-4,-1,1,0,1
vyzařovat,8,6,-2,-1,1,0,1
udržovat,1,3,2,1,1,1,1
začlenit,1,7,6,1,1,0,1
nacházet,1,7,6,1,1,0,1
nakládat,4,4,0,0,-1,0,1
zkrátit,5,21,16,1,1,0,1
odhalit,3,4,-1,-1,-1,0,1
nabízet,6,2,4,1,-1,-1,1
stát,4,6,2,1,1,0,1
připadnout,2,13,11,1,1,0,1
uspokojovat,3,5,2,1,1,0,1
uspokojovat,1,4,3,1,1,0,1
dávat,1,3,2,1,1,0,1
mít,2,3,-1,-1,-1,0,1
najít,6,3,3,1,-1,0,1
komplikovat,2,5,3,1,1,0,1
vyhnout,2,5,3,1,1,0,1
pozorovat,7,8,-1,-1,-1,0,1
vtěsnat,2,5,3,1,1,0,1
tvořit,4,2,2,1,-1,1,1
odštěpovat,3,2,-1,-1,1,0,1
izolovat,1,4,-3,-1,-1,0,1
vidět,2,3,-1,-1,-1,0,1
vyvíjet,2,2,0,0,-1,1,1
dávat,3,4,-1,-1,-1,0,1
mít,1,23,22,1,1,0,1
analyzovat,4,4,0,0,1,0,1
udržovat,3,7,4,1,1,0,1
vyrovnávat,5,17,12,1,1,0,1
rozumět,14,2,12,1,-1,0,1
mít,3,3,0,0,-1,0,1
preformovat,2,3,1,1,1,0,1
mít,11,2,9,1,-1,0,1
začít,3,2,1,1,-1,1,1
vyrovnat,1,3,2,1,1,0,1
změnit,1,3,2,1,1,1,1
označovat,2,2,0,0,-1,0,1
získat,6,3,-3,-1,1,0,1
přivést,11,2,9,1,-1,0,1
vyvolávat,3,2,1,1,-1,0,1
vyvolávat,4,2,2,1,-1,0,1
vyvolávat,12,2,10,1,-1,0,1
vidět,1,11,10,1,1,0,1
mít,2,2,0,0,-1,0,1
srovnat,4,3,1,1,-1,0,1
přinášet,2,7,5,1,1,1,1
zajímat,1,18,17,1,1,0,1
zdůrazňovat,3,4,-1,-1,-1,0,1
zabývat,2,6,4,1,1,0,1
mít,20,4,16,1,-1,0,1
vypočítat,3,8,5,1,1,0,1
zařazovat,1,13,12,1,1,0,1
být,1,3,2,1,1,0,1
hodnotit,1,4,3,1,1,0,1
měřit,2,4,-2,-1,-1,0,1
vidět,2,8,6,1,1,0,1
mít,2,4,-2,-1,-1,0,1
tvořit,2,2,0,0,-1,0,1
vyvodit,2,3,-1,-1,-1,0,1
stát,1,3,2,1,1,0,1
věnovat,2,3,1,1,1,0,1
trpět,7,2,5,1,-1,0,1
přinášet,5,2,3,1,-1,1,1
stát,2,3,-1,-1,-1,0,1
jevit,2,3,-1,-1,-1,0,1
věnovat,8,4,-4,-1,1,0,1
věnovat,2,3,-1,-1,-1,0,1
dosáhnout,2,4,-2,-1,-1,0,1
mít,21,4,17,1,-1,0,1
charakterizovat,2,4,2,1,1,0,1
mít,18,2,16,1,-1,0,1
stavět,4,3,-1,-1,1,0,1
klást,4,2,2,1,-1,1,1
odhalit,13,9,4,1,-1,0,1
všimnout,2,6,4,1,1,0,1
spatřovat,5,3,-2,-1,1,0,1
chápat,1,10,9,1,1,0,1
vyjadřovat,4,4,0,0,1,0,1
vydělovat,9,3,6,1,-1,0,1
mít,8,2,6,1,-1,0,1
stávat,2,12,10,1,1,0,1
mít,2,2,0,0,-1,0,1
zařadit,2,4,2,1,1,0,1
odkrývat,2,2,0,0,-1,1,1
naplňovat,35,3,32,1,-1,0,1
poznávat,1,4,3,1,1,0,1
rozevřít,1,2,1,1,1,1,1
chápat,1,7,6,1,1,0,1
mít,5,2,3,1,-1,0,1
mít,2,2,0,0,-1,0,1
vidět,19,3,16,1,-1,0,1
publikovat,5,4,-1,-1,1,0,1
chápat,1,3,2,1,1,0,1
začlenit,1,3,2,1,1,0,1
podtrhovat,8,4,4,1,-1,0,1
interpretovat,4,7,3,1,1,0,1
stávat,3,10,7,1,1,0,1
vidět,1,2,-1,-1,-1,0,1
vidět,1,8,7,1,1,1,1
nacházet,6,2,4,1,-1,0,1
položit,8,4,4,1,-1,0,1
spatřit,2,6,4,1,1,0,1
začlenit,3,3,0,0,1,0,1
zavádět,1,5,4,1,1,0,1
připravit,4,3,1,1,-1,0,1
vzít,34,3,31,1,-1,0,1
stávat,11,2,9,1,-1,0,1
najít,3,3,0,0,-1,0,1
přiřazovat,2,3,1,1,1,0,1
zařadit,2,2,0,0,-1,1,1
plnit,3,2,1,1,-1,1,1
ukazovat,2,5,3,1,1,0,1
stávat,5,5,0,0,-1,0,1
vytvářet,3,3,0,0,-1,0,1
uchovávat,2,4,-2,-1,-1,0,1
podržovat,5,5,0,0,-1,0,1
ukázat,2,3,-1,-1,-1,0,1
vytlačovat,3,2,-1,-1,1,0,1
vnášet,7,3,4,1,-1,0,1
představovat,33,4,29,1,-1,0,1
studovat,4,12,8,1,1,0,1
přinést,13,4,9,1,-1,0,1
zůstat,2,5,-3,-1,-1,0,1
předpokládat,2,7,-5,-1,-1,0,1
zachytit,13,4,9,1,-1,0,1
znát,9,3,6,1,-1,0,1
jevit,23,3,20,1,-1,0,1
zůstat,3,27,24,1,1,0,1
dokládat,1,3,2,1,1,1,1
mít,2,4,2,1,1,0,1
mít,3,3,0,0,-1,0,1
odkrýt,15,11,4,1,-1,0,1
položit,4,11,7,1,1,0,1
spatřovat,12,2,10,1,-1,1,1
obsáhnout,6,3,3,1,-1,0,1
přinést,3,4,1,1,1,0,1
představovat,4,4,0,0,-1,0,1
vytvořit,7,8,-1,-1,-1,0,1
zůstávat,3,2,1,1,-1,1,1
mít,7,2,5,1,-1,0,1
mít,3,3,0,0,-1,0,1
vykazovat,3,6,3,1,1,0,1
ilustrovat,2,7,5,1,1,0,1
stávat,3,8,5,1,1,0,1
tvořit,5,3,2,1,-1,0,1
zachytit,3,2,1,1,-1,0,1
najít,5,62,57,1,1,0,1
spatřovat,6,2,4,1,-1,0,1
postihnout,4,3,-1,-1,1,0,1
týkat,4,3,1,1,-1,0,1
zjišťovat,2,28,26,1,1,0,1
soustředit,3,2,1,1,-1,1,1
mít,14,5,9,1,-1,0,1
vyžádat,1,4,3,1,1,1,1
uzavřít,4,2,-2,-1,1,0,1
přijmout,2,5,3,1,1,0,1
zapustit,2,5,3,1,1,0,1
založit,12,3,9,1,-1,0,1
posvětit,3,4,1,1,1,0,1
mít,2,3,-1,-1,-1,0,1
mít,6,3,3,1,-1,0,1
mít,4,4,0,0,-1,0,1
zaměřit,2,3,1,1,1,0,1
přehodit,1,3,2,1,1,0,1
vyhazovat,1,3,2,1,1,0,1
mít,37,3,34,1,-1,0,1
nalézt,22,2,20,1,-1,1,1
uskutečnit,6,3,3,1,-1,0,1
spatřovat,13,2,11,1,-1,0,1
přehodnocovat,4,3,-1,-1,1,0,1
opřít,1,2,1,1,1,0,1
svádět,1,2,1,1,1,1,1
soustřeďovat,9,2,7,1,-1,1,1
sjednocovat,1,16,15,1,1,1,1
odolat,4,3,1,1,-1,0,1
vyhánět,1,7,6,1,1,1,1
nasadit,2,3,-1,-1,-1,0,1
překročit,4,4,0,0,-1,0,1
stahovat,8,3,-5,-1,1,0,1
vést,5,2,3,1,-1,0,1
nabýt,2,3,-1,-1,-1,0,1
překročit,3,3,0,0,-1,0,1
plnit,7,7,0,0,-1,0,1
tvořit,5,5,0,0,1,0,1
mít,3,2,1,1,-1,1,1
odolávat,4,4,0,0,1,0,1
uveřejnit,13,6,7,1,-1,0,1
zahrnovat,22,2,20,1,-1,0,1
vypouštět,1,3,-2,-1,-1,0,1
zajistit,11,8,-3,-1,1,0,1
požadovat,15,2,13,1,-1,0,1
přizvat,9,4,5,1,-1,0,1
mít,2,3,1,1,1,0,1
jmenovat,45,8,37,1,-1,0,1
vytvořit,8,4,-4,-1,1,0,1
zabránit,3,9,6,1,1,0,1
rozepsat,1,6,5,1,1,0,1
rozepsat,1,3,2,1,1,0,1
mít,2,4,2,1,1,0,1
mít,2,10,8,1,1,0,1
projednávat,10,3,-7,-1,1,0,1
předložit,1,2,1,1,1,0,1
stát,6,4,-2,-1,1,0,1
uskutečnit,45,4,41,1,-1,0,1
zajistit,5,9,4,1,1,0,1
mít,10,3,7,1,-1,0,1
opustit,1,3,2,1,1,0,1
přesáhnout,3,4,-1,-1,-1,0,1
stát,4,12,8,1,1,0,1
stát,4,15,11,1,1,0,1
získat,3,8,5,1,1,0,1
zařazovat,6,3,-3,-1,1,0,1
uvolnit,2,3,-1,-1,-1,0,1
předpokládat,5,16,11,1,1,0,1
mít,2,6,4,1,1,0,1
uzavřít,5,9,4,1,1,0,1
potřebovat,7,13,6,1,1,0,1
převzít,5,3,2,1,-1,0,1
akceptovat,2,9,7,1,1,0,1
uzavřít,2,5,3,1,1,0,1
získat,5,2,3,1,-1,0,1
mít,7,2,5,1,-1,0,1
přenést,2,2,0,0,-1,0,1
zajistit,7,4,-3,-1,1,0,1
tvořit,3,9,-6,-1,-1,0,1
najít,1,11,10,1,1,0,1
vymanit,1,3,2,1,1,0,1
provázet,2,3,1,1,1,0,1
založit,2,4,2,1,1,0,1
vybudovat,4,5,-1,-1,-1,0,1
zabezpečit,6,8,2,1,1,0,1
mít,5,2,3,1,-1,0,1
mít,7,3,4,1,-1,0,1
zahrnovat,3,3,0,0,-1,0,1
mít,3,4,-1,-1,-1,0,1
zaujímat,2,3,-1,-1,-1,0,1
představovat,16,4,12,1,-1,0,1
obsahovat,11,3,8,1,-1,0,1
zahlédnout,1,2,1,1,1,1,1
mít,8,2,6,1,-1,0,1
ocenit,2,6,4,1,1,0,1
osvojit,2,3,-1,-1,-1,0,1
osvojovat,2,4,2,1,1,0,1
rozšiřovat,2,20,18,1,1,0,1
osvojovat,1,19,18,1,1,0,1
reprodukovat,1,5,4,1,1,0,1
nabývat,3,2,1,1,-1,0,1
mít,2,2,0,0,-1,1,1
vysvětlovat,3,25,22,1,1,0,1
naznačit,2,8,6,1,1,0,1
prokázat,4,5,1,1,1,0,1
přenášet,3,2,1,1,-1,0,1
mít,2,9,7,1,1,0,1
zkoumat,3,5,2,1,1,0,1
zůstávat,1,2,-1,-1,-1,1,1
předvídat,2,3,-1,-1,-1,0,1
zajistit,8,3,5,1,-1,0,1
mít,3,2,1,1,-1,0,1
mít,11,2,9,1,-1,0,1
posouvat,6,2,4,1,-1,0,1
poutat,5,2,3,1,-1,1,1
zkoumat,1,4,3,1,1,1,1
mít,18,2,16,1,-1,0,1
začleňovat,1,3,2,1,1,0,1
mít,2,5,-3,-1,-1,0,1
mít,2,15,13,1,1,0,1
postihnout,3,5,2,1,1,0,1
představovat,2,3,-1,-1,-1,0,1
mít,4,2,2,1,-1,0,1
formovat,2,13,11,1,1,0,1
mít,2,11,-9,-1,-1,0,1
hrát,2,3,-1,-1,-1,0,1
vzít,17,2,15,1,-1,0,1
zaujímat,9,3,6,1,-1,0,1
nabývat,3,5,2,1,1,0,1
vyvolávat,2,3,-1,-1,-1,0,1
mít,2,4,-2,-1,-1,0,1
integrovat,1,6,5,1,1,0,1
mít,2,2,0,0,-1,0,1
mít,2,9,7,1,1,0,1
řešit,2,13,11,1,1,0,1
objasnit,6,3,3,1,-1,0,1
přijmout,5,3,2,1,-1,0,1
nacházet,1,10,9,1,1,0,1
poznat,5,8,3,1,1,0,1
zastavit,4,15,11,1,1,0,1
sledovat,2,24,22,1,1,0,1
provázet,1,9,8,1,1,0,1
tvořit,2,13,11,1,1,0,1
zaujímat,16,2,14,1,-1,1,1
zobrazit,6,3,-3,-1,1,0,1
podmiňovat,10,4,6,1,-1,0,1
mít,4,2,2,1,-1,0,1
hrát,3,4,-1,-1,-1,0,1
vtahovat,1,7,6,1,1,0,1
probouzet,12,4,8,1,-1,0,1
spojovat,2,2,0,0,1,-1,1
nabývat,2,30,28,1,1,0,1
včlenit,5,3,2,1,-1,0,1
stavět,14,3,11,1,-1,0,1
mít,7,6,1,1,-1,0,1
hledat,1,4,3,1,1,0,1
popsat,1,4,3,1,1,0,1
vypracovat,3,10,7,1,1,0,1
zasloužit,1,6,5,1,1,0,1
užívat,14,5,9,1,-1,0,1
podat,3,3,0,0,1,0,1
zjistit,4,29,25,1,1,0,1
mít,7,2,5,1,-1,0,1
vytvářet,6,6,0,0,-1,0,1
vidět,18,2,16,1,-1,1,1
mít,3,3,0,0,-1,0,1
nalézt,3,20,17,1,1,0,1
viz,11,3,8,1,-1,0,1
nacházet,2,16,14,1,1,0,1
mít,3,3,0,0,-1,1,1
využívat,5,8,-3,-1,-1,0,1
vytvářet,11,16,5,1,1,0,1
ztrácet,2,6,4,1,1,0,1
zavádět,4,5,-1,-1,-1,0,1
představovat,5,4,1,1,-1,0,1
uvádět,82,12,70,1,-1,0,1
zaujímat,13,2,11,1,-1,0,1
stávat,1,3,-2,-1,-1,0,1
připočíst,17,2,15,1,-1,0,1
zpřístupnit,13,5,8,1,-1,0,1
vrhat,2,61,59,1,1,0,1
uvádět,7,8,1,1,1,0,1
provádět,2,8,6,1,1,0,1
překládat,6,2,4,1,-1,0,1
uznávat,2,2,0,0,-1,0,1
ukázat,10,3,7,1,-1,0,1
postavit,8,2,6,1,-1,1,1
žádat,3,2,1,1,-1,0,1
převádět,3,2,1,1,-1,0,1
udržet,1,3,2,1,1,0,1
vystavět,1,4,3,1,1,1,1
mít,2,2,0,0,-1,0,1
vykonávat,2,4,2,1,1,0,1
využít,1,7,6,1,1,0,1
vyvolávat,7,2,5,1,-1,0,1
zaujímat,2,5,3,1,1,0,1
hrát,2,5,3,1,1,0,1
zhodnotit,6,4,-2,-1,1,0,1
obrážet,1,7,6,1,1,0,1
představovat,6,15,9,1,1,0,1
pochopit,2,2,0,0,1,0,1
mít,6,6,0,0,-1,0,1
vytyčovat,6,7,-1,-1,-1,0,1
dosáhnout,1,2,1,1,1,0,1
stavět,2,7,5,1,1,0,1
představovat,3,5,-2,-1,-1,0,1
představovat,2,9,7,1,1,0,1
psát,5,3,-2,-1,1,0,1
odvodit,3,2,1,1,-1,1,1
přepsat,5,3,-2,-1,1,0,1
odpovídat,3,3,0,0,-1,0,1
uvést,1,3,2,1,1,0,1
sloučit,2,3,1,1,1,0,1
redukovat,5,4,-1,-1,1,0,1
využít,8,4,-4,-1,1,0,1
dostat,14,2,12,1,-1,0,1
využít,8,4,-4,-1,1,0,1
mít,4,5,-1,-1,-1,0,1
mít,3,3,0,0,-1,0,1
provést,3,8,5,1,1,0,1
odpovídat,11,22,11,1,1,0,1
připustit,4,11,7,1,1,0,1
vyjadřovat,2,3,1,1,1,0,1
odvodit,2,3,1,1,1,0,1
posuzovat,2,14,12,1,1,0,1
nabývat,3,4,-1,-1,-1,0,1
nabývat,3,5,-2,-1,-1,0,1
přepsat,4,3,-1,-1,1,0,1
zaručovat,2,14,12,1,1,0,1
zaručovat,5,8,-3,-1,-1,0,1
mít,15,4,11,1,-1,0,1
minimalizovat,2,6,4,1,1,0,1
použít,1,5,4,1,1,0,1
mít,1,27,26,1,1,0,1
použít,2,10,8,1,1,0,1
obdržet,32,2,30,1,-1,0,1
vyžadovat,12,10,2,1,-1,0,1
promyslet,4,11,7,1,1,0,1
indikovat,9,8,-1,-1,1,0,1
týkat,5,6,1,1,1,0,1
dobudovat,5,11,6,1,1,0,1
pokládat,12,3,9,1,-1,0,1
charakterizovat,3,3,0,0,1,0,1
představovat,12,3,9,1,-1,0,1
vykazovat,13,4,9,1,-1,0,1
představovat,6,5,1,1,-1,0,1
vykonávat,1,8,7,1,1,0,1
vykonávat,1,3,2,1,1,0,1
vyvolat,6,5,-1,-1,1,0,1
popsat,10,4,6,1,-1,0,1
vysvětlovat,9,6,3,1,-1,0,1
včleňovat,1,3,2,1,1,1,1
uvést,5,7,2,1,1,0,1
mít,3,7,-4,-1,-1,0,1
uznávat,1,2,1,1,1,-1,1
odpovídat,8,3,5,1,-1,0,1
stát,3,2,1,1,-1,0,1
stanovit,5,13,8,1,1,0,1
ovlivňovat,2,3,-1,-1,-1,0,1
stát,2,2,0,0,-1,0,1
mít,3,4,-1,-1,-1,0,1
ztrácet,2,3,1,1,1,0,1
nést,4,3,-1,-1,1,0,1
vyrážet,1,6,5,1,1,0,1
způsobit,2,4,2,1,1,0,1
nést,8,2,6,1,-1,1,1
odpovídat,3,3,0,0,-1,0,1
vyhovět,2,4,2,1,1,0,1
zajišťovat,7,7,0,0,1,0,1
zajišťovat,3,5,-2,-1,-1,0,1
zpracovávat,4,2,-2,-1,1,0,1
zvládnout,4,3,-1,-1,1,0,1
mít,10,2,8,1,-1,0,1
hodnotit,9,7,-2,-1,1,0,1
prověřovat,3,3,0,0,-1,0,1
odeslat,2,3,-1,-1,-1,0,1
uplatňovat,7,2,5,1,-1,0,1
dodržovat,2,4,-2,-1,-1,0,1
uskladňovat,10,2,8,1,-1,1,1
zarovnávat,2,3,1,1,1,0,1
hrát,2,4,-2,-1,-1,0,1
provádět,1,5,-4,-1,-1,0,1
vylučovat,9,2,7,1,-1,0,1
rozeznávat,16,2,14,1,-1,0,1
mít,3,3,0,0,1,0,1
mít,9,3,6,1,-1,0,1
mít,4,3,1,1,-1,0,1
působit,7,8,1,1,1,0,1
mít,14,3,11,1,-1,0,1
naměřit,3,2,1,1,-1,1,1
utínat,5,3,2,1,-1,0,1
vyměřovat,3,7,4,1,1,0,1
vyměřovat,6,3,3,1,-1,0,1
doporučovat,2,3,1,1,1,0,1
zahrnovat,2,3,1,1,1,0,1
mít,2,3,-1,-1,-1,0,1
vyložit,5,5,0,0,1,0,1
jevit,1,6,5,1,1,0,1
ukazovat,19,5,14,1,-1,0,1
mít,1,5,4,1,1,0,1
zabraňovat,2,3,-1,-1,-1,0,1
tvořit,10,2,8,1,-1,0,1
mít,2,2,0,0,-1,0,1
mít,2,40,38,1,1,0,1
uchopit,1,3,2,1,1,0,1
používat,4,2,2,1,-1,0,1
tvořit,3,3,0,0,-1,0,1
mít,3,2,1,1,-1,1,1
vyzkoušet,3,3,0,0,1,0,1
přivést,2,5,3,1,1,0,1
dopracovat,1,2,1,1,1,0,1
pořádat,54,4,50,1,-1,0,1
zkrátit,3,3,0,0,1,0,1
dostat,1,3,-2,-1,-1,0,1
vyjadřovat,4,34,30,1,1,0,1
projet,6,3,-3,-1,1,0,1
znamenat,5,3,2,1,-1,0,1
instalovat,4,3,1,1,-1,0,1
vyžádat,2,3,-1,-1,-1,0,1
zabývat,3,10,7,1,1,0,1
hradit,2,6,4,1,1,0,1
mít,1,2,-1,-1,-1,0,1
mít,6,3,3,1,-1,0,1
mít,4,21,17,1,1,0,1
ušetřit,3,5,2,1,1,0,1
mít,3,4,1,1,1,0,1
přinést,2,20,18,1,1,0,1
podat,9,8,-1,-1,1,0,1
použít,2,3,-1,-1,-1,0,1
dopravovat,1,4,3,1,1,0,1
dodávat,4,4,0,0,-1,0,1
mít,2,3,-1,-1,-1,0,1
řešit,3,3,0,0,1,0,1
využít,6,3,3,1,-1,0,1
nabývat,9,3,6,1,-1,0,1
formulovat,11,2,9,1,-1,0,1
převracet,2,14,12,1,1,0,1
postavit,1,4,3,1,1,1,1
určit,9,3,6,1,-1,0,1
realizovat,2,5,3,1,1,0,1
napomáhat,2,4,2,1,1,0,1
klást,5,3,2,1,-1,0,1
ohlašovat,11,3,8,1,-1,0,1
zachovat,3,2,1,1,-1,0,1
mít,14,2,12,1,-1,0,1
připravit,3,7,4,1,1,0,1
mít,2,2,0,0,-1,1,1
poznat,1,6,5,1,1,1,1
překonat,2,4,2,1,1,0,1
obsahovat,2,3,-1,-1,-1,0,1
používat,1,6,5,1,1,1,1
vytvořit,2,13,11,1,1,0,1
mít,2,2,0,0,-1,0,1
odpovídat,6,4,-2,-1,1,0,1
vykazovat,8,3,5,1,-1,0,1
potřebovat,3,2,1,1,-1,0,1
vyvíjet,1,2,-1,-1,-1,0,1
používat,1,15,14,1,1,1,1
využít,1,3,2,1,1,0,1
postavit,1,3,2,1,1,1,1
nést,4,2,2,1,-1,1,1
opatřit,4,3,-1,-1,1,0,1
připravit,4,5,1,1,1,0,1
uvést,1,2,1,1,1,1,1
dosáhnout,3,3,0,0,1,0,1
spojit,2,2,0,0,1,0,1
zasunout,1,2,1,1,1,0,1
vyprostit,2,3,1,1,1,0,1
odhadnout,1,13,12,1,1,0,1
vtlačit,4,3,-1,-1,1,0,1
udržovat,1,10,9,1,1,1,1
dělat,6,2,-4,-1,1,0,1
mít,7,2,5,1,-1,0,1
mít,6,4,2,1,-1,0,1
uvést,1,2,1,1,1,0,1
zkoušet,1,2,1,1,1,0,1
vidět,2,6,4,1,1,0,1
kupovat,13,8,-5,-1,1,0,1
nařezat,1,3,2,1,1,1,1
používat,1,6,5,1,1,1,1
vybírat,1,3,2,1,1,0,1
přitáhnout,1,5,4,1,1,0,1
obrousit,1,4,3,1,1,0,1
volit,1,6,5,1,1,1,1
zatloukat,1,3,2,1,1,0,1
mít,2,2,0,0,-1,0,1
vynakládat,6,2,4,1,-1,0,1
ohoblovat,3,3,0,0,1,0,1
pokládat,1,2,1,1,1,1,1
vložit,1,7,6,1,1,1,1
vybírat,1,3,2,1,1,1,1
zatloukat,1,3,2,1,1,1,1
uchopit,2,3,1,1,1,0,1
přiložit,1,2,1,1,1,1,1
zaujímat,12,2,10,1,-1,0,1
kupovat,2,2,0,0,-1,0,1
utvořit,7,3,4,1,-1,0,1
snášet,1,3,2,1,1,0,1
vydat,3,3,0,0,-1,0,1
číst,1,6,5,1,1,0,1
mít,2,2,0,0,-1,1,1
zajistit,4,4,0,0,1,0,1
zasadit,1,9,8,1,1,1,1
odebrat,3,2,1,1,-1,1,1
dostat,3,3,0,0,-1,0,1
tvořit,17,2,15,1,-1,0,1
odebírat,2,3,1,1,1,0,1
spotřebovat,2,2,0,0,-1,0,1
položit,1,10,9,1,1,1,1
rozpouštět,2,2,0,0,-1,0,1
zasypat,1,3,2,1,1,1,1
sázet,1,2,1,1,1,0,1
upoutávat,1,3,2,1,1,1,1
mít,11,2,9,1,-1,0,1
mít,3,3,0,0,-1,0,1
mít,6,3,3,1,-1,0,1
přitahovat,1,2,-1,-1,-1,0,1
přenášet,1,3,2,1,1,0,1
rozpoznávat,1,2,1,1,1,0,1
namíchat,4,3,1,1,-1,0,1
připevnit,1,2,-1,-1,-1,0,1
míchat,1,5,4,1,1,0,1
vyrobit,1,3,2,1,1,0,1
mít,6,4,2,1,-1,0,1
mít,6,3,3,1,-1,0,1
potřebovat,9,2,7,1,-1,0,1
mít,2,2,0,0,-1,0,1
ohýbat,3,2,1,1,-1,1,1
mít,5,2,3,1,-1,0,1
vkládat,6,2,4,1,-1,0,1
prosvítit,2,2,0,0,1,0,1
vzít,1,5,4,1,1,0,1
připevnit,1,6,5,1,1,1,1
mít,5,5,0,0,-1,0,1
probrat,2,7,5,1,1,0,1
vyříznout,1,2,-1,-1,-1,1,1
napsat,1,2,1,1,1,1,1
vyvrtat,5,3,2,1,-1,0,1
volit,5,8,-3,-1,-1,0,1
narovnat,1,3,2,1,1,0,1
upnout,16,2,14,1,-1,0,1
vyvrtat,3,2,1,1,-1,1,1
vytahovat,1,3,2,1,1,0,1
zjistit,2,9,7,1,1,0,1
odnášet,2,2,0,0,-1,1,1
obohacovat,2,7,5,1,1,0,1
zaujmout,2,3,1,1,1,0,1
dosáhnout,2,3,-1,-1,-1,0,1
mít,13,3,10,1,-1,0,1
mít,10,3,7,1,-1,0,1
zaujmout,3,5,2,1,1,0,1
použít,2,5,3,1,1,0,1
měnit,1,2,1,1,1,0,1
zvolit,7,4,3,1,-1,0,1
zvolit,6,3,3,1,-1,0,1
položit,5,9,4,1,1,0,1
provést,1,20,19,1,1,0,1
mít,2,7,5,1,1,0,1
zastihovat,2,3,1,1,1,0,1
budovat,3,2,-1,-1,1,0,1
mít,1,7,-6,-1,-1,0,1
přednášet,3,3,0,0,1,0,1
stát,9,5,-4,-1,1,-1,1
dosáhnout,3,5,2,1,1,0,1
zahájit,2,3,1,1,1,0,1
použít,2,3,1,1,1,0,1
mít,2,5,3,1,1,0,1
mít,5,3,2,1,-1,0,1
stanovit,4,4,0,0,1,0,1
nalézt,1,2,-1,-1,-1,1,1
zabývat,2,4,2,1,1,0,1
hledat,1,3,2,1,1,0,1
nalézt,5,4,-1,-1,1,0,1
zkoumat,2,3,1,1,1,0,1
odnést,1,2,1,1,1,-1,1
chytit,1,7,6,1,1,0,1
hledat,6,12,6,1,1,0,1
zmenšit,3,3,0,0,1,0,1
určit,3,2,1,1,-1,0,1
vysvětlit,5,5,0,0,1,0,1
studovat,3,11,8,1,1,0,1
vykazovat,4,4,0,0,-1,0,1
dosáhnout,3,3,0,0,-1,0,1
posuzovat,1,13,12,1,1,1,1
vzrušovat,2,3,1,1,1,0,1
odtrhávat,1,2,-1,-1,-1,0,1
vzbuzovat,11,2,9,1,-1,0,1
upravit,1,3,2,1,1,0,1
mít,2,19,17,1,1,0,1
stanovit,2,4,2,1,1,0,1
mít,9,3,6,1,-1,0,1
tvořit,3,4,1,1,1,0,1
mít,3,3,0,0,-1,0,1
tvořit,4,5,1,1,1,0,1
použít,4,11,7,1,1,0,1
vést,4,2,-2,-1,1,0,1
sestavovat,1,7,6,1,1,0,1
obsahovat,1,5,4,1,1,0,1
obsahovat,49,8,41,1,-1,0,1
obsahovat,54,5,49,1,-1,0,1
držet,1,2,1,1,1,1,1
provádět,2,2,0,0,-1,1,1
prokázat,8,4,4,1,-1,0,1
obsahovat,12,4,8,1,-1,0,1
obsahovat,11,7,-4,-1,1,0,1
obsahovat,15,4,11,1,-1,0,1
obsahovat,34,4,30,1,-1,0,1
obsahovat,5,6,-1,-1,-1,0,1
obsahovat,5,6,-1,-1,-1,0,1
obsahovat,18,6,12,1,-1,0,1
vykázat,2,3,1,1,1,0,1
popsat,2,5,3,1,1,0,1
obsahovat,29,6,23,1,-1,0,1
dosahovat,4,6,2,1,1,0,1
držet,1,2,1,1,1,1,1
obsahovat,22,3,19,1,-1,0,1
obsahovat,9,2,-7,-1,1,0,1
popsat,3,5,2,1,1,0,1
vytvářit,2,15,13,1,1,0,1
uvést,2,12,10,1,1,0,1
obsahovat,14,4,10,1,-1,0,1
obsahovat,19,4,15,1,-1,0,1
obsahovat,31,4,27,1,-1,0,1
obsahovat,18,4,14,1,-1,0,1
obsahovat,14,10,4,1,-1,0,1
uvést,8,3,-5,-1,1,0,1
uvést,18,7,-11,-1,1,0,1
zakládat,2,12,10,1,1,0,1
uvést,21,4,-17,-1,1,0,1
uvést,14,2,-12,-1,1,0,1
překročit,10,10,0,0,-1,0,1
uvést,14,19,5,1,1,0,1
uvést,10,9,-1,-1,1,0,1
překročit,10,10,0,0,-1,0,1
uvést,2,5,-3,-1,-1,0,1
uvést,21,2,19,1,-1,0,1
prokázat,8,13,5,1,1,0,1
moci,3,4,1,1,1,0,1
přerozdělovat,6,2,4,1,-1,0,1
stanovit,12,3,9,1,-1,0,1
uvést,9,3,6,1,-1,0,1
dosahovat,4,3,-1,-1,1,0,1
vést,1,6,5,1,1,0,1
zaúčtovat,2,7,5,1,1,0,1
mít,1,3,2,1,1,0,1
mít,1,3,2,1,1,0,1
vést,1,6,5,1,1,0,1
provádět,1,5,4,1,1,0,1
nabýt,2,7,5,1,1,0,1
provést,5,3,2,1,-1,0,1
odpisovat,1,9,8,1,1,1,1
sestavovat,2,3,1,1,1,0,1
zajistit,18,3,15,1,-1,0,1
splňovat,5,2,-3,-1,1,0,1
stát,2,2,0,0,1,0,1
zjistit,14,4,10,1,-1,0,1
sestavit,2,2,0,0,1,0,1
činit,3,4,-1,-1,-1,0,1
získat,7,3,-4,-1,1,0,1
uvést,451,6,445,1,-1,0,1
použít,8,14,6,1,1,0,1
obsahovat,12,7,-5,-1,1,0,1
použít,6,5,-1,-1,1,0,1
uvádět,8,25,17,1,1,0,1
stanovit,17,6,11,1,-1,0,1
mít,1,4,3,1,1,0,1
provozovat,2,4,2,1,1,0,1
vést,1,4,3,1,1,0,1
uplatnit,2,6,4,1,1,0,1
vést,1,4,3,1,1,0,1
vést,1,14,13,1,1,0,1
vést,1,4,3,1,1,0,1
vést,1,4,3,1,1,0,1
vést,1,4,3,1,1,0,1
dodržovat,35,3,32,1,-1,0,1
vést,2,5,3,1,1,0,1
vést,1,5,4,1,1,0,1
vést,1,3,2,1,1,0,1
inventarizovat,3,2,-1,-1,1,0,1
předávat,2,6,4,1,1,0,1
přebírat,2,6,4,1,1,0,1
přebírat,6,20,14,1,1,0,1
zveřejnit,1,2,1,1,1,0,1
vést,1,3,2,1,1,0,1
vést,1,3,2,1,1,0,1
použít,2,3,1,1,1,0,1
použít,8,10,2,1,1,0,1
sestavovat,2,12,10,1,1,0,1
vést,4,3,-1,-1,1,0,1
otevírat,2,5,3,1,1,0,1
uzavírat,2,10,8,1,1,0,1
otevírat,2,5,-3,-1,-1,0,1
uzavírat,2,3,1,1,1,0,1
uzavírat,2,7,5,1,1,0,1
otevírat,2,5,3,1,1,0,1
sestavovat,2,5,-3,-1,-1,0,1
vykonávat,3,3,0,0,1,0,1
sestavovat,2,10,8,1,1,0,1
provádět,1,7,6,1,1,0,1
sestavovat,8,5,3,1,-1,0,1
uvést,44,5,39,1,-1,0,1
použít,10,6,4,1,-1,0,1
použít,3,10,-7,-1,-1,0,1
mít,6,2,4,1,-1,0,1
položit,1,2,1,1,1,1,1
mít,2,2,0,0,-1,1,1
položit,7,2,5,1,-1,0,1
chtít,2,3,1,1,1,-1,1
dávat,1,2,1,1,1,1,1
vidět,1,3,2,1,1,0,1
podařit,1,3,2,1,1,1,1
vzít,1,2,1,1,1,0,1
dát,2,2,0,0,1,0,1
dát,1,16,15,1,1,0,1
hodit,1,2,-1,-1,-1,0,1
hodit,2,2,0,0,-1,0,1
stáhnout,2,2,0,0,-1,0,1
položit,1,2,-1,-1,-1,0,1
mít,2,3,-1,-1,-1,0,1
pozvat,1,2,1,1,1,1,1
zanechat,3,2,1,1,-1,1,1
položit,1,2,1,1,1,0,1
zvednout,1,2,1,1,1,0,1
dělat,2,2,0,0,-1,0,1
uvádět,1,10,9,1,1,0,1
rozeznávat,3,3,0,0,-1,0,1
nést,5,2,3,1,-1,1,1
hodit,1,2,1,1,1,0,1
přenést,1,8,7,1,1,1,1
dávat,3,2,1,1,-1,0,1
objednat,5,2,3,1,-1,1,1
přijímat,3,3,0,0,1,0,1
dosadit,2,3,1,1,1,0,1
cítit,3,2,1,1,-1,0,1
slýchat,8,2,6,1,-1,0,1
vést,2,2,0,0,1,0,1
udělat,1,17,16,1,1,0,1
podat,1,2,-1,-1,-1,0,1
chovat,1,2,1,1,1,0,1
vzít,2,3,1,1,1,0,1
mít,1,2,-1,-1,-1,0,1
vidět,4,4,0,0,1,0,1
přejíždět,8,4,4,1,-1,0,1
znát,1,3,2,1,1,0,1
mít,7,2,5,1,-1,1,1
vypustit,2,2,0,0,1,0,1
vzít,1,2,1,1,1,1,1
dostat,2,2,0,0,-1,0,1
mít,23,2,21,1,-1,1,1
nést,9,2,7,1,-1,0,1
přinést,1,2,-1,-1,-1,0,1
vytahovat,1,2,1,1,1,0,1
mít,1,3,-2,-1,-1,0,1
vědět,4,7,3,1,1,0,1
pít,1,4,3,1,1,0,1
brát,11,2,9,1,-1,0,1
dát,1,6,5,1,1,0,1
vzít,1,2,1,1,1,1,1
rovnat,2,2,0,0,-1,0,1
najít,2,2,0,0,-1,0,1
přemísťovat,1,3,2,1,1,0,1
nasbírat,2,3,1,1,1,0,1
sypat,1,2,1,1,1,0,1
uvítat,1,2,1,1,1,1,1
dát,1,4,3,1,1,1,1
dělat,1,16,15,1,1,0,1
vzít,2,3,1,1,1,0,1
položit,3,3,0,0,1,0,1
srovnat,2,2,0,0,-1,1,1
schovávat,1,3,2,1,1,1,1
mít,2,3,-1,-1,-1,-1,1
vydechovat,13,2,11,1,-1,1,1
objevit,4,3,1,1,-1,0,1
uskutečňovat,15,3,12,1,-1,0,1
držet,3,2,1,1,-1,0,1
popadnout,2,2,0,0,-1,0,1
psát,1,2,1,1,1,1,1
nést,1,2,1,1,1,0,1
uniknout,1,2,1,1,1,0,1
položit,1,2,1,1,1,0,1
číst,4,2,2,1,-1,0,1
cítit,2,4,-2,-1,-1,-1,1
pálit,1,2,1,1,1,0,1
zužitkovat,1,5,4,1,1,1,1
posuzovat,1,12,11,1,1,1,1
uvědomovat,1,2,1,1,1,0,1
brát,1,2,1,1,1,0,1
vzít,1,4,-3,-1,-1,0,1
opustit,2,2,0,0,-1,0,1
přivést,1,2,-1,-1,-1,1,1
nazvat,1,2,1,1,1,0,1
ptát,1,4,3,1,1,0,1
zaplatit,1,3,2,1,1,-1,1
mít,10,2,8,1,-1,0,1
nechat,2,10,-8,-1,-1,0,1
připsat,3,2,1,1,-1,0,1
přinést,3,2,1,1,-1,0,1
přerušit,1,5,4,1,1,0,1
slíbit,3,3,0,0,-1,0,1
utrácet,2,5,3,1,1,0,1
cítit,2,3,1,1,1,0,1
otáčet,7,2,5,1,-1,0,1
rozbalit,1,2,1,1,1,0,1
vidět,17,2,15,1,-1,1,1
vrátit,1,2,1,1,1,1,1
přepsat,1,2,1,1,1,0,1
pomáhat,1,2,-1,-1,-1,-1,1
dělat,1,9,8,1,1,1,1
dávat,2,2,0,0,1,0,1
pozvednout,1,3,2,1,1,0,1
zvát,1,2,1,1,1,-1,1
vložit,1,2,-1,-1,-1,0,1
mít,5,2,3,1,-1,0,1
vynášet,3,4,-1,-1,-1,0,1
protlačit,18,2,16,1,-1,0,1
uslyšet,2,4,-2,-1,-1,0,1
vyhradit,2,3,-1,-1,-1,0,1
vypůjčit,4,2,2,1,-1,0,1
zavést,1,12,11,1,1,1,1
zabodnout,1,4,3,1,1,1,1
vytáhnout,1,2,1,1,1,0,1
valit,1,3,2,1,1,-1,1
vytáhnout,2,3,-1,-1,-1,0,1
svírat,1,2,-1,-1,-1,0,1
hodit,1,2,1,1,1,-1,1
trávit,2,2,0,0,-1,0,1
přivést,12,2,10,1,-1,0,1
vytřít,3,2,-1,-1,1,0,1
přivolat,1,2,1,1,1,0,1
vrhat,2,2,0,0,-1,0,1
vrážet,1,2,1,1,1,0,1
bít,1,2,1,1,1,1,1
mít,3,2,1,1,-1,0,1
podávat,12,3,9,1,-1,0,1
stlačovat,1,2,1,1,1,0,1
zabouchnout,1,2,1,1,1,0,1
svolat,4,18,14,1,1,0,1
vnořit,1,2,1,1,1,0,1
snášet,3,12,9,1,1,0,1
lít,1,2,-1,-1,-1,0,1
najít,1,2,-1,-1,-1,0,1
strávit,1,4,3,1,1,0,1
vzít,1,3,2,1,1,0,1
přehodit,1,2,-1,-1,-1,0,1
táhnout,1,3,2,1,1,1,1
dát,1,2,1,1,1,1,1
srazit,1,2,1,1,1,0,1
mávat,1,2,1,1,1,0,1
vyřvávat,4,3,1,1,-1,0,1
mít,8,2,6,1,-1,0,1
spáchat,1,4,-3,-1,-1,0,1
sevřít,1,2,1,1,1,1,1
přečkat,10,2,8,1,-1,0,1
mít,1,2,1,1,1,-1,1
zatknout,2,2,0,0,-1,0,1
zastrčit,2,4,-2,-1,-1,0,1
potlačit,5,2,3,1,-1,0,1
nechat,2,2,0,0,-1,0,1
vyhazovat,3,2,1,1,-1,0,1
najít,15,2,13,1,-1,0,1
posílat,1,2,1,1,1,0,1
dohánět,1,3,2,1,1,0,1
mít,3,2,1,1,-1,1,1
nakládat,6,2,4,1,-1,1,1
obrousit,1,2,1,1,1,0,1
trávit,1,2,1,1,1,0,1
bafnout,1,2,1,1,1,0,1
zatáhnout,1,2,1,1,1,1,1
zaslechnout,7,2,5,1,-1,0,1
předcházet,1,11,10,1,1,0,1
otírat,2,4,2,1,1,0,1
doplňovat,1,2,1,1,1,0,1
vážit,2,3,1,1,1,0,1
omatlat,1,10,9,1,1,1,1
obsahovat,2,2,0,0,-1,1,1
plesknout,1,2,1,1,1,0,1
dát,5,2,3,1,-1,0,1
nahřát,1,6,5,1,1,1,1
dát,3,2,1,1,-1,0,1
vzít,1,2,1,1,1,1,1
dostat,1,2,1,1,1,0,1
svléknout,1,2,1,1,1,1,1
nastrkat,1,3,2,1,1,0,1
mít,13,2,11,1,-1,0,1
smést,3,2,1,1,-1,0,1
protlačit,3,2,1,1,-1,0,1
udržet,1,2,1,1,1,0,1
odžít,1,2,-1,-1,-1,0,1
dotknout,2,2,0,0,-1,0,1
porazit,3,2,1,1,-1,0,1
posunout,1,2,-1,-1,-1,0,1
utřít,1,2,1,1,1,0,1
prožít,1,2,1,1,1,0,1
otipnout,1,3,2,1,1,0,1
spouštět,1,4,3,1,1,0,1
skopnout,1,2,1,1,1,1,1
přehodit,1,2,1,1,1,0,1
nasadit,1,2,-1,-1,-1,0,1
postavit,1,2,1,1,1,0,1
sundat,1,4,3,1,1,1,1
uložit,1,3,2,1,1,1,1
dávat,5,2,3,1,-1,-1,1
klepat,1,3,2,1,1,0,1
nadělat,3,3,0,0,-1,0,1
prodávat,1,3,2,1,1,0,1
objevit,16,5,11,1,-1,0,1
vydat,1,2,1,1,1,0,1
vzít,1,2,1,1,1,1,1
pohladit,1,2,1,1,1,1,1
mít,2,2,0,0,-1,0,1
vrátit,1,7,6,1,1,1,1
kousat,1,2,1,1,1,1,1
ukrýt,1,2,1,1,1,0,1
dostat,1,2,1,1,1,0,1
svírat,15,2,13,1,-1,0,1
přirazit,1,2,1,1,1,1,1
rozpoznat,11,2,9,1,-1,1,1
dělat,2,2,0,0,-1,0,1
zahalovat,1,19,18,1,1,1,1
získat,1,3,-2,-1,-1,0,1
prásknout,1,2,-1,-1,-1,1,1
strávit,1,3,-2,-1,-1,0,1
vyvěsit,1,2,-1,-1,-1,0,1
vykřesat,2,4,2,1,1,0,1
položit,1,2,1,1,1,0,1
žádat,4,3,1,1,-1,0,1
mít,3,3,0,0,-1,0,1
vytáhnout,2,4,-2,-1,-1,0,1
vrátit,1,2,1,1,1,1,1
podat,3,3,0,0,-1,0,1
spouštět,1,2,-1,-1,-1,1,1
vyslat,2,2,0,0,-1,0,1
zatnout,1,3,2,1,1,0,1
předznamenat,3,4,1,1,1,0,1
mít,1,13,12,1,1,0,1
postavit,1,2,1,1,1,1,1
navrhnout,9,3,6,1,-1,0,1
přijmout,3,3,0,0,1,0,1
mít,3,3,0,0,1,0,1
vystřídat,2,2,0,0,-1,0,1
schroupat,3,2,1,1,-1,1,1
mít,5,2,3,1,-1,1,1
režírovat,2,2,0,0,1,0,1
vzít,5,2,3,1,-1,1,1
roubovat,6,3,-3,-1,1,-1,1
mít,4,2,2,1,-1,1,1
vyrvat,1,2,1,1,1,0,1
zavolat,1,2,1,1,1,0,1
mít,8,2,6,1,-1,1,1
dělat,1,5,4,1,1,1,1
dávat,1,2,1,1,1,0,1
utužit,1,3,2,1,1,0,1
tisknout,2,3,1,1,1,0,1
mít,2,2,0,0,1,0,1
hledat,5,2,3,1,-1,0,1
dařit,1,7,6,1,1,1,1
poznat,1,10,9,1,1,1,1
mít,3,2,1,1,-1,0,1
lepit,2,4,2,1,1,0,1
vysadit,3,2,1,1,-1,0,1
promnout,2,2,0,0,1,0,1
vytlačovat,1,3,-2,-1,-1,0,1
položit,1,3,2,1,1,0,1
vzít,2,2,0,0,-1,0,1
vsunout,1,2,1,1,1,0,1
pozdravit,3,3,0,0,-1,0,1
natáhnout,1,3,2,1,1,0,1
zvednout,1,3,2,1,1,0,1
posadit,1,2,1,1,1,1,1
říci,1,3,2,1,1,0,1
chytnout,1,2,1,1,1,1,1
vypínat,4,4,0,0,-1,0,1
chápat,1,2,1,1,1,-1,1
shodit,1,2,1,1,1,0,1
zamluvit,3,4,1,1,1,0,1
ukázat,1,3,-2,-1,-1,0,1
říkat,1,2,1,1,1,0,1
volit,3,2,1,1,-1,0,1
najít,3,3,0,0,-1,0,1
mít,2,2,0,0,-1,1,1
hledat,2,4,2,1,1,0,1
mít,2,2,0,0,-1,0,1
najít,2,3,-1,-1,-1,0,1
uvést,1,3,2,1,1,1,1
překračovat,3,3,0,0,-1,0,1
stačit,1,2,1,1,1,1,1
stisknout,1,5,4,1,1,0,1
shodit,2,2,0,0,-1,1,1
svěřovat,3,2,1,1,-1,0,1
přisunout,1,2,1,1,1,0,1
nazvat,1,2,1,1,1,1,1
vidět,9,2,7,1,-1,1,1
říci,1,2,1,1,1,0,1
hledat,4,2,2,1,-1,0,1
najít,2,12,10,1,1,1,1
vidět,1,2,1,1,1,0,1
přivolávat,1,2,-1,-1,-1,0,1
položit,1,2,-1,-1,-1,0,1
cítit,1,2,-1,-1,-1,0,1
dát,1,2,1,1,1,1,1
nést,17,2,15,1,-1,0,1
uslyšet,7,3,4,1,-1,0,1
vymyslit,4,2,2,1,-1,1,1
dostat,5,2,3,1,-1,0,1
vrhnout,1,2,1,1,1,0,1
ironizovat,12,3,9,1,-1,0,1
pohladit,1,2,1,1,1,1,1
odhazovat,2,3,1,1,1,0,1
postavit,3,2,-1,-1,1,0,1
vidět,1,3,2,1,1,1,1
klást,1,2,1,1,1,0,1
pustit,1,2,1,1,1,0,1
přiložit,1,2,1,1,1,0,1
mít,4,2,2,1,-1,1,1
přiložit,1,2,1,1,1,0,1
držet,1,2,1,1,1,1,1
mít,2,2,0,0,-1,1,1
spatřit,1,3,-2,-1,-1,0,1
brávat,5,2,3,1,-1,0,1
postavit,4,2,-2,-1,1,0,1
pocítit,4,2,2,1,-1,0,1
cítit,3,2,1,1,-1,1,1
prohlížet,2,2,0,0,-1,0,1
sledovat,3,2,1,1,-1,1,1
vyhnat,1,2,1,1,1,1,1
zradit,1,3,2,1,1,0,1
zapsat,1,2,1,1,1,0,1
spouštět,3,2,1,1,-1,1,1
vytáhnout,1,3,-2,-1,-1,0,1
mít,2,2,0,0,-1,1,1
píchat,1,3,2,1,1,0,1
pozorovat,1,3,2,1,1,1,1
mít,2,3,-1,-1,-1,0,1
vyčerpávat,3,11,8,1,1,0,1
kroužit,1,5,4,1,1,0,1
vydat,2,2,0,0,-1,1,1
zakroužit,1,2,1,1,1,0,1
nechat,1,2,1,1,1,0,1
vidět,15,2,13,1,-1,1,1
obsahovat,4,2,2,1,-1,1,1
říci,1,2,1,1,1,1,1
zanechat,1,2,1,1,1,1,1
dojít,1,3,2,1,1,1,1
vodit,1,2,1,1,1,0,1
vodit,1,2,1,1,1,0,1
mít,1,2,-1,-1,-1,0,1
vidět,2,3,-1,-1,-1,0,1
poručit,4,2,-2,-1,1,0,1
donést,4,2,2,1,-1,0,1
postavit,1,2,1,1,1,0,1
pustit,2,2,0,0,-1,0,1
držet,1,2,1,1,1,1,1
udělat,1,2,-1,-1,-1,1,1
dát,1,2,1,1,1,0,1
kupovat,1,3,2,1,1,-1,1
vzít,8,2,6,1,-1,0,1
zamávat,2,2,0,0,-1,0,1
odhrnout,1,2,1,1,1,0,1
přitisknout,1,2,1,1,1,0,1
trhat,1,3,2,1,1,0,1
nainstalovat,1,2,1,1,1,0,1
nechat,1,2,1,1,1,1,1
vyndat,12,2,10,1,-1,1,1
přečíst,2,2,0,0,-1,0,1
vyřešit,1,2,1,1,1,-1,1
nechat,1,2,1,1,1,0,1
mít,6,2,4,1,-1,1,1
vykoupat,1,3,2,1,1,1,1
nasadit,10,2,8,1,-1,0,1
držet,1,2,1,1,1,0,1
mít,10,2,8,1,-1,1,1
mít,5,2,3,1,-1,1,1
vylovit,4,2,2,1,-1,0,1
přidržet,1,4,3,1,1,1,1
udělat,1,2,1,1,1,-1,1
zabalit,1,3,2,1,1,1,1
přenést,1,2,1,1,1,1,1
odvolat,1,3,2,1,1,1,1
vyhrabat,5,2,3,1,-1,0,1
říci,1,2,1,1,1,0,1
spatřit,1,12,11,1,1,0,1
poškrábat,1,2,1,1,1,1,1
přišoupnout,2,2,0,0,1,-1,1
brát,1,3,2,1,1,0,1
propustit,1,4,3,1,1,0,1
léčit,1,2,-1,-1,-1,1,1
vyloupnout,2,2,0,0,1,0,1
nalít,2,10,8,1,1,0,1
otáčet,1,2,1,1,1,0,1
vzít,4,2,2,1,-1,0,1
vhodit,6,2,4,1,-1,1,1
brát,1,2,1,1,1,0,1
pomoci,1,3,2,1,1,1,1
postavit,4,4,0,0,-1,0,1
zvednout,2,2,0,0,1,0,1
svírat,10,2,8,1,-1,0,1
koupit,3,2,1,1,-1,0,1
chtít,1,2,-1,-1,-1,1,1
tisknout,9,2,7,1,-1,1,1
mít,1,2,1,1,1,0,1
svléknout,1,2,1,1,1,1,1
vysypat,2,2,0,0,1,0,1
zvednout,1,2,1,1,1,1,1
sevřít,1,2,1,1,1,1,1
hodit,1,2,1,1,1,0,1
shodit,5,2,3,1,-1,1,1
koupit,1,3,2,1,1,1,1
vézt,1,2,-1,-1,-1,1,1
hodit,5,2,3,1,-1,1,1
lechtat,1,2,1,1,1,1,1
vrazit,1,2,1,1,1,0,1
nalít,1,6,5,1,1,0,1
dát,1,2,1,1,1,0,1
píchat,1,2,1,1,1,0,1
pustit,1,2,1,1,1,1,1
chytnout,1,3,2,1,1,1,1
vyndat,3,7,-4,-1,-1,0,1
vložit,1,2,1,1,1,0,1
vzít,2,2,0,0,-1,0,1
vzít,10,2,8,1,-1,0,1
otevřít,1,2,-1,-1,-1,0,1
zaujmout,2,3,1,1,1,0,1
zdědit,1,3,2,1,1,1,1
nalít,1,5,4,1,1,0,1
kopnout,1,2,1,1,1,0,1
vzít,1,2,-1,-1,-1,0,1
mít,3,2,1,1,-1,0,1
opékat,3,2,1,1,-1,0,1
držet,1,2,1,1,1,0,1
kývnout,1,13,12,1,1,0,1
prohlížet,1,3,2,1,1,0,1
držet,11,2,9,1,-1,0,1
mít,2,2,0,0,1,0,1
vložit,6,2,4,1,-1,1,1
objednat,1,2,-1,-1,-1,1,1
lechtat,1,2,1,1,1,0,1
spustit,1,2,1,1,1,0,1
sevřít,1,2,1,1,1,1,1
zvednout,1,2,1,1,1,0,1
nahmatat,4,3,1,1,-1,0,1
vyndat,1,2,-1,-1,-1,0,1
vzít,3,2,1,1,-1,0,1
mít,13,2,11,1,-1,1,1
schovat,1,2,1,1,1,0,1
položit,1,2,1,1,1,0,1
vrazit,1,2,1,1,1,0,1
posadit,1,2,-1,-1,-1,0,1
stočit,1,2,-1,-1,-1,1,1
položit,9,2,7,1,-1,0,1
vzít,1,2,1,1,1,0,1
zařídit,1,2,1,1,1,0,1
strčit,3,4,1,1,1,0,1
mít,1,2,-1,-1,-1,0,1
plácnout,1,3,2,1,1,0,1
říkat,1,2,1,1,1,0,1
položit,4,3,-1,-1,1,0,1
přežít,1,2,1,1,1,0,1
zatnout,1,2,1,1,1,0,1
hodit,3,2,1,1,-1,1,1
oddělovat,3,2,-1,-1,1,0,1
vysypat,2,2,0,0,1,0,1
položit,2,2,0,0,-1,0,1
shrnout,1,4,3,1,1,1,1
mít,6,3,3,1,-1,0,1
mít,3,2,1,1,-1,1,1
setřásat,1,13,12,1,1,0,1
přiložit,2,2,0,0,-1,0,1
lovit,5,2,3,1,-1,0,1
položit,1,2,1,1,1,0,1
přerušit,1,3,2,1,1,1,1
rozbalovat,4,2,-2,-1,1,0,1
vybrat,1,3,2,1,1,1,1
nalít,1,7,6,1,1,0,1
vzít,2,2,0,0,-1,1,1
položit,2,2,0,0,1,0,1
vyrazit,2,2,0,0,-1,1,1
mít,6,2,4,1,-1,1,1
nosit,3,8,5,1,1,0,1
zamknout,1,2,-1,-1,-1,1,1
koupit,10,3,7,1,-1,0,1
pohodit,1,2,1,1,1,0,1
vyhrabat,1,4,3,1,1,1,1
přitisknout,3,4,1,1,1,0,1
postavit,1,2,1,1,1,1,1
slupnout,1,2,1,1,1,0,1
oklepat,2,3,1,1,1,0,1
mít,7,3,4,1,-1,0,1
vyndat,3,3,0,0,-1,0,1
postavit,1,2,1,1,1,1,1
napít,3,2,1,1,-1,0,1
nosit,1,2,1,1,1,0,1
shodit,2,2,0,0,-1,0,1
mít,4,2,2,1,-1,0,1
mít,2,2,0,0,-1,1,1
přitisknout,1,2,1,1,1,0,1
vytáhnout,3,2,1,1,-1,0,1
položit,1,4,3,1,1,1,1
pohodit,1,3,2,1,1,0,1
připravovat,2,2,0,0,-1,0,1
vmést,8,2,6,1,-1,0,1
mít,2,3,1,1,1,0,1
vzít,1,2,1,1,1,1,1
nechat,4,2,-2,-1,1,1,1
mít,2,2,0,0,1,-1,1
chytit,1,2,1,1,1,1,1
říci,1,2,-1,-1,-1,-1,1
třísknout,1,2,1,1,1,0,1
připravit,4,3,1,1,-1,0,1
bodnout,1,2,1,1,1,1,1
najít,3,3,0,0,1,1,1
mít,1,2,1,1,1,1,1
navléknout,1,2,1,1,1,0,1
prohlédnout,1,2,1,1,1,1,1
brát,1,2,1,1,1,1,1
sloužit,3,3,0,0,1,0,1
uvařit,1,4,3,1,1,0,1
postavit,3,4,-1,-1,-1,0,1
nést,6,3,3,1,-1,1,1
zapnout,1,3,2,1,1,0,1
odložit,3,3,0,0,1,0,1
chystat,1,5,4,1,1,0,1
mít,5,2,3,1,-1,0,1
znát,3,6,3,1,1,0,1
odvést,1,2,1,1,1,0,1
položit,11,2,9,1,-1,1,1
obejmout,1,2,1,1,1,1,1
shazovat,4,2,2,1,-1,0,1
postavit,1,2,1,1,1,1,1
položit,3,4,-1,-1,-1,0,1
přelít,1,4,3,1,1,0,1
vhodit,14,2,12,1,-1,0,1
obouvat,1,2,1,1,1,1,1
mít,1,2,-1,-1,-1,0,1
přehodit,1,2,-1,-1,-1,0,1
najít,6,2,4,1,-1,0,1
nalít,1,4,3,1,1,0,1
táhnout,1,2,-1,-1,-1,1,1
vložit,1,2,1,1,1,0,1
navát,1,2,1,1,1,0,1
vylovit,9,3,6,1,-1,0,1
schovat,1,4,3,1,1,1,1
zastrčit,1,2,1,1,1,0,1
odhrabat,1,4,3,1,1,0,1
pěstovat,2,2,0,0,1,0,1
třít,1,8,7,1,1,1,1
vidět,31,2,29,1,-1,1,1
upéci,2,4,-2,-1,-1,0,1
obklopovat,1,3,2,1,1,0,1
mít,2,6,-4,-1,-1,0,1
volat,1,2,1,1,1,1,1
mít,10,3,7,1,-1,0,1
chytat,1,2,1,1,1,0,1
brát,1,2,1,1,1,0,1
mít,3,2,1,1,-1,0,1
vyzvednout,1,2,1,1,1,0,1
cítit,4,3,1,1,-1,0,1
vzít,1,2,1,1,1,1,1
připadat,13,2,11,1,-1,0,1
dýchat,1,2,-1,-1,-1,0,1
mít,2,2,0,0,-1,0,1
odložit,1,2,1,1,1,0,1
narovnat,2,4,-2,-1,-1,0,1
mít,2,2,0,0,-1,1,1
nakládat,1,2,1,1,1,0,1
odkládat,3,4,1,1,1,0,1
oklepat,1,3,2,1,1,0,1
obrat,3,3,0,0,-1,0,1
dovést,1,2,1,1,1,0,1
stavět,1,2,1,1,1,1,1
otřít,1,2,1,1,1,0,1
mít,1,2,1,1,1,0,1
slyšet,1,2,1,1,1,0,1
ulovit,4,3,1,1,-1,0,1
vybalovat,1,2,-1,-1,-1,0,1
ukládat,1,2,1,1,1,1,1
vysoukat,3,2,1,1,-1,0,1
vyzvednout,1,2,1,1,1,0,1
zabít,1,3,2,1,1,0,1
ušít,2,3,-1,-1,-1,0,1
ulomit,1,2,-1,-1,-1,0,1
mít,3,2,1,1,-1,1,1
položit,1,2,1,1,1,0,1
praštit,1,2,1,1,1,0,1
praštit,1,2,1,1,1,0,1
hnát,2,2,0,0,-1,0,1
dát,1,2,1,1,1,0,1
najít,2,2,0,0,-1,1,1
mít,2,3,-1,-1,-1,0,1
zavést,2,3,1,1,1,0,1
chovat,1,3,-2,-1,-1,0,1
skrýt,1,3,2,1,1,0,1
držet,2,2,0,0,1,0,1
strávit,1,2,1,1,1,0,1
zaplnit,3,4,1,1,1,0,1
přečíst,3,3,0,0,-1,0,1
sbírat,3,2,-1,-1,1,0,1
přebarvit,3,2,-1,-1,1,0,1
uvidět,1,2,1,1,1,1,1
vážit,5,6,1,1,1,0,1
rozdrtit,1,4,3,1,1,1,1
vzít,1,2,1,1,1,1,1
zvednout,1,2,1,1,1,0,1
vzít,1,2,-1,-1,-1,0,1
odvést,1,2,1,1,1,1,1
zavést,1,2,1,1,1,0,1
mít,1,2,-1,-1,-1,0,1
pozvat,1,2,1,1,1,0,1
vztáhnout,1,4,3,1,1,0,1
vážit,1,2,1,1,1,0,1
najít,1,4,3,1,1,1,1
udělat,3,2,1,1,-1,0,1
dát,2,2,0,0,-1,0,1
znát,5,3,2,1,-1,0,1
posadit,1,2,1,1,1,0,1
dovést,1,2,1,1,1,0,1
vypít,2,2,0,0,-1,0,1
nechat,1,2,1,1,1,1,1
uložit,1,4,3,1,1,1,1
poslat,1,14,13,1,1,0,1
zhotovit,2,3,1,1,1,0,1
zkoumat,2,2,0,0,1,0,1
zavolat,1,2,-1,-1,-1,1,1
změnit,1,3,2,1,1,0,1
změnit,1,3,2,1,1,0,1
dovést,1,13,12,1,1,1,1
vychutnávat,4,3,1,1,-1,0,1
odtrhnout,1,16,15,1,1,0,1
schovat,1,2,1,1,1,0,1
ohřát,6,2,4,1,-1,0,1
předat,3,2,-1,-1,1,0,1
ověřit,10,2,8,1,-1,0,1
dovést,1,19,18,1,1,1,1
přivést,3,2,-1,-1,1,0,1
najít,1,2,1,1,1,1,1
zarazit,4,4,0,0,1,0,1
položit,1,2,1,1,1,0,1
držet,1,2,-1,-1,-1,0,1
naslouchat,2,3,1,1,1,0,1
pozvat,1,2,1,1,1,0,1
převyprávět,3,3,0,0,-1,0,1
potkat,9,2,7,1,-1,0,1
dát,1,2,-1,-1,-1,1,1
položit,2,2,0,0,1,0,1
vzít,4,2,2,1,-1,1,1
snížit,1,4,3,1,1,0,1
ukončit,2,5,3,1,1,0,1
chovat,8,3,5,1,-1,0,1
hodit,1,2,1,1,1,0,1
položit,5,3,-2,-1,1,0,1
mít,2,2,0,0,-1,1,1
posadit,1,2,1,1,1,1,1
přehodit,1,2,1,1,1,0,1
prodat,1,2,1,1,1,0,1
zavřít,1,3,2,1,1,1,1
zavolat,2,2,0,0,-1,1,1
vzít,3,2,1,1,-1,0,1
podnikat,1,3,2,1,1,1,1
přidržovat,1,2,-1,-1,-1,0,1
najít,2,5,3,1,1,0,1
vtisknout,3,2,1,1,-1,0,1
nalít,1,2,1,1,1,0,1
splnit,3,5,2,1,1,0,1
hostit,1,3,2,1,1,1,1
obejmout,1,2,1,1,1,1,1
smést,1,2,1,1,1,-1,1
vztáhnout,1,2,1,1,1,0,1
velebit,2,10,8,1,1,0,1
hledat,2,2,0,0,-1,0,1
pochovat,1,3,2,1,1,1,1
mít,3,2,1,1,-1,0,1
protloukat,1,4,3,1,1,0,1
vyndat,3,3,0,0,-1,0,1
mít,2,3,-1,-1,-1,0,1
porušit,2,3,1,1,1,0,1
dát,4,11,7,1,1,0,1
členit,2,5,3,1,1,0,1
mít,6,4,2,1,-1,0,1
využít,11,2,9,1,-1,0,1
dávat,1,2,-1,-1,-1,0,1
dát,12,6,6,1,-1,0,1
muset,2,3,1,1,1,0,1
kupovat,1,2,1,1,1,0,1
vyřídit,3,2,1,1,-1,1,1
uvádět,2,3,1,1,1,0,1
projednat,7,2,5,1,-1,0,1
uzavřít,8,2,6,1,-1,1,1
mít,3,3,0,0,1,0,1
dostat,1,4,3,1,1,0,1
získat,2,18,16,1,1,0,1
používat,1,3,2,1,1,1,1
používat,1,3,2,1,1,0,1
připravovat,3,2,-1,-1,1,0,1
vyrábět,3,2,-1,-1,1,0,1
rozšířit,1,3,2,1,1,0,1
udržet,1,6,5,1,1,1,1
vyžadovat,2,2,0,0,-1,0,1
nakoupit,1,6,5,1,1,0,1
zdražit,2,6,4,1,1,0,1
přinést,3,4,-1,-1,-1,0,1
používat,2,4,2,1,1,0,1
dosahovat,6,5,-1,-1,1,0,1
obsahovat,5,4,1,1,-1,0,1
prožít,2,3,-1,-1,-1,0,1
prodat,2,3,-1,-1,-1,0,1
mít,12,2,10,1,-1,0,1
získat,3,2,1,1,-1,0,1
požadovat,4,2,2,1,-1,0,1
získat,2,3,-1,-1,-1,0,1
převzít,7,3,4,1,-1,0,1
pořídit,3,5,2,1,1,0,1
sjednávat,1,2,-1,-1,-1,1,1
povolat,4,3,-1,-1,1,0,1
směrovat,2,9,7,1,1,0,1
usnadňovat,5,2,3,1,-1,0,1
zvednout,1,3,2,1,1,0,1
mít,2,4,2,1,1,0,1
integrovat,3,2,1,1,-1,0,1
operovat,2,2,0,0,1,-1,1
prodávat,2,3,1,1,1,0,1
poškozovat,2,2,0,0,-1,0,1
najít,2,5,3,1,1,0,1
volit,2,2,0,0,1,0,1
odpovídat,3,5,2,1,1,0,1
dát,1,2,-1,-1,-1,0,1
zapojit,1,5,4,1,1,0,1
platit,7,3,-4,-1,1,0,1
uznat,5,14,9,1,1,0,1
ověřit,2,6,4,1,1,0,1
využívat,1,30,29,1,1,0,1
změnit,1,12,11,1,1,0,1
mít,2,10,8,1,1,0,1
poskytnout,1,6,5,1,1,0,1
vydražit,2,22,20,1,1,0,1
dát,8,2,6,1,-1,0,1
mít,2,2,0,0,-1,0,1
přijmout,2,6,4,1,1,0,1
rozvázat,2,9,7,1,1,0,1
mít,7,2,5,1,-1,0,1
najít,6,12,6,1,1,0,1
platit,1,4,-3,-1,-1,0,1
mít,6,6,0,0,-1,0,1
převést,4,2,2,1,-1,0,1
vykazovat,1,6,-5,-1,-1,0,1
poskytnout,2,3,-1,-1,-1,0,1
uplatnit,3,7,4,1,1,0,1
uplatnit,2,3,1,1,1,0,1
stanovovat,3,4,-1,-1,-1,0,1
obsahovat,18,5,13,1,-1,0,1
podat,1,6,-5,-1,-1,0,1
muset,3,3,0,0,1,0,1
muset,3,3,0,0,1,0,1
mít,4,2,-2,-1,1,0,1
předložit,6,3,3,1,-1,0,1
vložit,3,3,0,0,1,0,1
pověsit,1,2,1,1,1,0,1
připravovat,6,8,-2,-1,-1,0,1
hrát,1,5,4,1,1,1,1
chápat,1,4,3,1,1,0,1
najít,16,2,14,1,-1,0,1
umožnit,5,3,-2,-1,1,0,1
zvýšit,2,3,1,1,1,0,1
eliminovat,1,10,9,1,1,0,1
sbírat,2,9,7,1,1,0,1
utrpět,2,4,-2,-1,-1,0,1
očekávat,2,2,0,0,-1,0,1
ztratit,4,2,2,1,-1,0,1
vkládat,4,4,0,0,-1,0,1
vydat,2,2,0,0,-1,0,1
zaujmout,3,3,0,0,1,0,1
předvést,2,2,0,0,1,0,1
vzít,2,2,0,0,1,0,1
mít,2,2,0,0,-1,0,1
nakupovat,3,6,3,1,1,0,1
investovat,2,2,0,0,1,0,1
získat,11,8,3,1,-1,0,1
představovat,3,3,0,0,-1,0,1
stavět,2,14,12,1,1,0,1
umístit,4,3,-1,-1,1,0,1
vzít,5,3,-2,-1,1,0,1
poskytovat,2,13,11,1,1,0,1
nakupovat,2,2,0,0,1,0,1
vidět,2,6,4,1,1,0,1
dovážet,2,5,3,1,1,0,1
hledat,1,6,5,1,1,0,1
mívat,13,2,11,1,-1,0,1
mít,3,2,1,1,-1,0,1
přivážet,5,2,3,1,-1,0,1
zvýšit,1,2,1,1,1,0,1
objednávat,1,2,1,1,1,0,1
vytočit,1,5,4,1,1,0,1
mít,3,3,0,0,1,0,1
mít,3,2,1,1,-1,0,1
zaznamenat,6,2,4,1,-1,0,1
dosahovat,2,2,0,0,1,0,1
zajišťovat,3,2,1,1,-1,0,1
hledat,6,2,4,1,-1,0,1
mívat,2,3,-1,-1,-1,0,1
mít,4,2,2,1,-1,1,1
muset,5,2,-3,-1,1,0,1
pořádat,4,2,2,1,-1,0,1
využívat,1,2,-1,-1,-1,0,1
zvažovat,2,3,1,1,1,0,1
rozpracovat,1,4,3,1,1,1,1
nachytat,1,2,1,1,1,1,1
použít,7,3,4,1,-1,0,1
dosahovat,2,2,0,0,-1,0,1
napojit,2,4,2,1,1,0,1
použít,2,2,0,0,-1,0,1
nabízet,3,3,0,0,-1,0,1
dostat,1,3,2,1,1,0,1
přečíst,1,2,-1,-1,-1,0,1
pocítit,2,11,9,1,1,0,1
mít,2,3,-1,-1,-1,0,1
objednávat,1,3,2,1,1,0,1
koupit,7,3,4,1,-1,0,1
zmodernizovat,3,3,0,0,1,0,1
koupit,1,2,1,1,1,0,1
zaplatit,3,3,0,0,-1,0,1
zpracovávat,8,2,6,1,-1,0,1
podívat,3,2,1,1,-1,0,1
vybírat,2,6,4,1,1,0,1
dostávat,2,3,-1,-1,-1,0,1
potřebovat,1,5,4,1,1,0,1
provést,1,3,2,1,1,0,1
drobit,1,4,3,1,1,0,1
najít,1,2,-1,-1,-1,0,1
odmítnout,1,5,-4,-1,-1,0,1
použít,3,3,0,0,1,0,1
založit,4,2,2,1,-1,0,1
uvést,16,3,13,1,-1,0,1
zahájit,3,3,0,0,-1,0,1
najít,2,4,2,1,1,0,1
omezit,3,2,-1,-1,1,0,1
mít,12,3,9,1,-1,0,1
mít,3,9,6,1,1,0,1
spojovat,2,3,1,1,1,0,1
spojovat,2,3,1,1,1,0,1
uzavřít,4,4,0,0,1,0,1
dotáhnout,4,3,1,1,-1,0,1
mít,2,3,-1,-1,-1,0,1
dodávat,4,3,1,1,-1,0,1
zlepšit,1,4,3,1,1,0,1
vyžadovat,7,8,-1,-1,-1,0,1
mít,5,3,-2,-1,1,0,1
podléhat,1,14,13,1,1,0,1
koupit,1,3,2,1,1,0,1
mít,4,10,6,1,1,0,1
moci,2,3,1,1,1,0,1
hlásit,1,5,4,1,1,1,1
převyšovat,1,3,-2,-1,-1,0,1
dosáhnout,4,2,2,1,-1,0,1
vložit,2,4,2,1,1,0,1
rozptýlit,1,5,4,1,1,0,1
stanovit,8,5,-3,-1,1,0,1
způsobovat,1,18,17,1,1,0,1
nalézt,2,4,2,1,1,0,1
vložit,2,5,-3,-1,-1,0,1
předpokládat,30,5,25,1,-1,0,1
vytvořit,3,4,-1,-1,-1,0,1
zajistit,3,5,2,1,1,0,1
zavést,8,3,5,1,-1,0,1
znamenat,6,8,2,1,1,0,1
vydávat,2,4,-2,-1,-1,0,1
vyžadovat,4,4,0,0,-1,0,1
vyžádat,3,2,1,1,-1,0,1
použít,5,2,3,1,-1,0,1
vypravovat,6,2,4,1,-1,0,1
vytočit,1,5,4,1,1,0,1
odpovídat,3,3,0,0,1,0,1
překračovat,2,2,0,0,-1,0,1
seřizovat,1,3,2,1,1,0,1
subvencovat,6,5,-1,-1,1,0,1
získat,5,6,-1,-1,-1,0,1
omezit,2,6,4,1,1,0,1
uslyšet,12,3,9,1,-1,0,1
vyšroubovat,1,16,15,1,1,0,1
dát,3,5,2,1,1,0,1
vydávat,2,5,3,1,1,0,1
zůstat,1,11,10,1,1,0,1
vidět,1,3,2,1,1,0,1
přinést,8,4,4,1,-1,0,1
zvládnout,3,2,-1,-1,1,0,1
odebrat,1,3,2,1,1,0,1
tvořit,2,5,-3,-1,-1,0,1
splnit,2,3,1,1,1,0,1
vědět,1,2,-1,-1,-1,0,1
vykupovat,5,8,3,1,1,0,1
dělat,1,15,14,1,1,0,1
srovnat,2,9,-7,-1,-1,0,1
objevit,2,2,0,0,-1,0,1
mít,1,2,1,1,1,0,1
převyšovat,1,4,3,1,1,0,1
způsobovat,6,4,2,1,-1,0,1
přihlásit,1,2,1,1,1,1,1
povzbudit,1,8,7,1,1,0,1
navrhovat,2,3,-1,-1,-1,0,1
vytvořit,14,4,10,1,-1,0,1
vést,1,5,4,1,1,0,1
vést,5,5,0,0,1,0,1
poznat,4,5,1,1,1,0,1
pouštět,4,2,2,1,-1,0,1
uvést,1,2,-1,-1,-1,0,1
chystat,2,3,1,1,1,0,1
dát,1,3,2,1,1,0,1
strhávat,8,3,-5,-1,1,0,1
vynakládat,7,8,-1,-1,-1,0,1
vyžadovat,8,2,6,1,-1,0,1
věnovat,1,9,8,1,1,0,1
mít,5,4,1,1,-1,0,1
mít,2,13,11,1,1,0,1
vypovědět,2,3,1,1,1,0,1
potřebovat,1,13,12,1,1,-1,1
potřebovat,1,8,7,1,1,0,1
mít,4,14,10,1,1,0,1
užívat,1,3,2,1,1,0,1
dodat,4,2,2,1,-1,0,1
vzbudit,1,3,-2,-1,-1,0,1
využít,2,4,2,1,1,0,1
prozkoumat,1,4,3,1,1,0,1
mít,2,2,0,0,1,0,1
sevřít,1,2,1,1,1,0,1
hrát,1,4,3,1,1,0,1
řadit,10,11,1,1,1,0,1
investovat,3,4,1,1,1,0,1
představovat,5,2,3,1,-1,0,1
koupit,1,7,6,1,1,0,1
mít,2,4,2,1,1,0,1
napojit,2,4,2,1,1,0,1
ukázat,2,31,29,1,1,0,1
zahrnovat,23,4,19,1,-1,0,1
zkreslovat,2,5,3,1,1,0,1
rozvinout,2,4,2,1,1,0,1
vpustit,3,4,-1,-1,-1,0,1
mít,5,4,1,1,-1,0,1
mít,2,14,12,1,1,0,1
tvořit,3,2,1,1,-1,0,1
navázat,6,2,4,1,-1,0,1
absolvovat,1,2,1,1,1,-1,1
rozložit,4,3,-1,-1,1,0,1
platit,2,3,1,1,1,0,1
držet,2,2,0,0,1,0,1
rozprodat,3,4,1,1,1,0,1
mít,2,15,13,1,1,0,1
koupit,1,7,6,1,1,0,1
stávat,5,6,1,1,1,0,1
zřídit,2,3,1,1,1,0,1
uzavřít,4,5,-1,-1,-1,0,1
investovat,3,10,7,1,1,0,1
přenést,3,2,-1,-1,1,0,1
prověřovat,1,2,1,1,1,0,1
použít,2,3,1,1,1,0,1
sestavovat,1,7,6,1,1,0,1
používat,2,5,3,1,1,0,1
přivést,4,2,2,1,-1,0,1
umístit,4,15,11,1,1,0,1
uspořádat,4,2,2,1,-1,0,1
poradit,1,4,3,1,1,0,1
prověřit,2,5,3,1,1,0,1
vést,1,3,2,1,1,0,1
vést,1,3,2,1,1,0,1
zavést,2,2,0,0,-1,0,1
posoudit,1,3,2,1,1,1,1
rozšířit,5,15,10,1,1,0,1
využívat,2,2,0,0,1,0,1
zaplatit,4,2,2,1,-1,0,1
stát,3,3,0,0,-1,0,1
mít,5,10,5,1,1,0,1
postavit,1,3,2,1,1,1,1
mít,3,2,1,1,-1,1,1
znamenat,4,3,1,1,-1,0,1
vnést,1,4,3,1,1,0,1
držet,2,3,-1,-1,-1,0,1
mít,2,3,-1,-1,-1,0,1
získat,3,3,0,0,-1,0,1
popisovat,1,8,7,1,1,1,1
pořizovat,1,3,2,1,1,0,1
vypůjčit,3,4,1,1,1,0,1
pojistit,1,36,35,1,1,1,1
mít,3,4,-1,-1,-1,0,1
pojistit,2,4,2,1,1,0,1
udělat,1,4,-3,-1,-1,0,1
zabývat,1,7,6,1,1,1,1
projednat,1,3,2,1,1,1,1
vnášet,7,2,5,1,-1,0,1
mít,5,3,2,1,-1,0,1
přinést,17,4,13,1,-1,0,1
přesunout,1,6,5,1,1,1,1
vyzvědět,2,3,-1,-1,-1,0,1
získat,1,2,-1,-1,-1,1,1
postihnout,3,6,3,1,1,0,1
krást,1,3,2,1,1,0,1
zařadit,2,4,2,1,1,0,1
podat,1,2,1,1,1,0,1
dát,1,2,-1,-1,-1,0,1
poskytnout,11,6,5,1,-1,0,1
mít,3,3,0,0,-1,0,1
připravovat,3,3,0,0,-1,0,1
dosáhnout,4,3,1,1,-1,0,1
účtovat,1,2,-1,-1,-1,0,1
platit,1,2,1,1,1,1,1
mít,1,2,1,1,1,0,1
přinášet,11,2,9,1,-1,0,1
vidět,2,6,4,1,1,0,1
donutit,2,2,0,0,-1,0,1
najít,4,3,-1,-1,1,0,1
upřesnit,7,2,5,1,-1,1,1
stát,3,2,1,1,-1,0,1
dodávat,1,19,18,1,1,0,1
prosadit,2,3,-1,-1,-1,0,1
dovézt,2,3,1,1,1,0,1
mít,11,2,9,1,-1,0,1
srážet,1,6,5,1,1,0,1
znamenat,4,3,1,1,-1,0,1
koupit,4,4,0,0,1,0,1
převést,5,4,1,1,-1,0,1
stavět,3,2,1,1,-1,0,1
provádět,2,5,3,1,1,0,1
mít,1,2,-1,-1,-1,0,1
pronajímat,1,5,4,1,1,0,1
zkrátit,2,2,0,0,1,0,1
založit,2,3,1,1,1,0,1
udělat,13,4,9,1,-1,0,1
zajistit,17,2,15,1,-1,0,1
mít,15,3,12,1,-1,0,1
zastupovat,5,2,3,1,-1,0,1
postihnout,3,7,-4,-1,-1,0,1
hledat,4,5,1,1,1,0,1
doručit,3,4,1,1,1,0,1
přepravovat,1,3,2,1,1,0,1
změnit,2,8,6,1,1,0,1
obdržet,7,4,3,1,-1,0,1
zaplavit,1,3,2,1,1,0,1
získat,12,2,10,1,-1,0,1
činit,3,4,-1,-1,-1,0,1
svěřit,2,2,0,0,-1,0,1
přesáhnout,9,6,3,1,-1,0,1
dosáhnout,4,2,2,1,-1,0,1
předávat,10,13,3,1,1,0,1
prodávat,1,4,3,1,1,0,1
přenést,5,2,-3,-1,1,0,1
kontrahovat,1,6,5,1,1,0,1
nutit,1,3,2,1,1,0,1
promítnout,5,6,1,1,1,0,1
zmocnit,4,9,5,1,1,0,1
podávat,1,3,2,1,1,0,1
vést,1,2,1,1,1,1,1
zásobovat,2,9,7,1,1,0,1
prodávat,1,3,2,1,1,0,1
vyzkoušet,3,9,6,1,1,0,1
dodávat,5,2,3,1,-1,0,1
prodávat,4,3,-1,-1,1,1,1
zavazovat,1,14,13,1,1,1,1
zařadit,5,2,3,1,-1,0,1
dostat,12,2,10,1,-1,0,1
obstarat,8,2,6,1,-1,0,1
hradit,3,7,4,1,1,0,1
zaměstnávat,2,5,3,1,1,0,1
prodávat,2,7,5,1,1,0,1
vykonávat,11,3,8,1,-1,0,1
rozdělit,1,21,20,1,1,0,1
zvýšit,2,5,3,1,1,0,1
odvolat,17,2,15,1,-1,0,1
přivézt,4,2,2,1,-1,0,1
připravovat,4,2,2,1,-1,0,1
organizovat,4,2,-2,-1,1,-1,1
založit,2,3,1,1,1,0,1
uvědomit,1,25,24,1,1,0,1
nahradit,4,6,2,1,1,0,1
stát,4,4,0,0,-1,0,1
ochránit,2,5,3,1,1,0,1
vytáhnout,2,4,2,1,1,0,1
ukrást,2,2,0,0,-1,1,1
splatit,1,3,2,1,1,0,1
prodlužovat,2,16,14,1,1,0,1
restrukturalizovat,2,3,1,1,1,0,1
splácet,1,3,2,1,1,0,1
odbřemenit,2,19,17,1,1,0,1
převzít,1,3,-2,-1,-1,0,1
investovat,2,7,5,1,1,0,1
zvýšit,3,4,1,1,1,0,1
dosahovat,2,3,-1,-1,-1,0,1
považovat,5,2,3,1,-1,0,1
koncentrovat,2,2,0,0,1,0,1
činit,4,2,2,1,-1,0,1
objednat,2,2,0,0,1,0,1
zabít,1,2,-1,-1,-1,0,1
zastavit,4,7,3,1,1,0,1
dostat,3,3,0,0,-1,0,1
svolat,4,10,6,1,1,0,1
stát,1,4,3,1,1,0,1
najít,1,6,5,1,1,0,1
přesunout,2,6,4,1,1,0,1
využívat,3,11,8,1,1,0,1
nabízet,6,5,1,1,-1,0,1
očekávat,3,3,0,0,-1,0,1
ustavit,3,3,0,0,-1,0,1
rozdělit,1,4,3,1,1,0,1
zastupovat,2,2,0,0,1,0,1
zajišťovat,10,2,8,1,-1,0,1
vyvolat,7,3,-4,-1,1,0,1
zařadit,4,6,2,1,1,0,1
dostat,1,10,9,1,1,0,1
dosahovat,2,4,2,1,1,0,1
přinést,4,2,2,1,-1,0,1
protáhnout,2,4,2,1,1,0,1
nařídit,6,6,0,0,1,0,1
vypočítávat,5,3,2,1,-1,0,1
vydat,1,3,2,1,1,0,1
zahájit,2,4,2,1,1,0,1
umístit,5,2,3,1,-1,0,1
odečíst,7,3,-4,-1,1,0,1
zajišťovat,5,2,3,1,-1,0,1
předpokládat,5,4,1,1,-1,0,1
dosáhnout,3,3,0,0,-1,0,1
nastavovat,2,3,1,1,1,0,1
vyčlenit,6,4,2,1,-1,0,1
uslyšet,2,2,0,0,-1,0,1
vnášet,1,4,-3,-1,-1,0,1
mít,4,3,1,1,-1,0,1
učinit,2,4,2,1,1,0,1
mít,1,2,1,1,1,0,1
využívat,1,3,2,1,1,0,1
prohlubovat,5,12,7,1,1,0,1
zahnat,1,2,1,1,1,0,1
získat,1,3,2,1,1,0,1
navazovat,3,4,1,1,1,0,1
koupit,1,2,-1,-1,-1,0,1
šít,2,13,11,1,1,0,1
zaměstnávat,2,2,0,0,1,0,1
získat,3,3,0,0,-1,0,1
dát,4,2,2,1,-1,0,1
dostat,4,4,0,0,-1,0,1
znát,8,6,2,1,-1,0,1
vyčlenit,2,2,0,0,-1,0,1
prodávat,3,3,0,0,1,0,1
dočíst,1,14,13,1,1,0,1
nechat,1,2,1,1,1,0,1
mít,3,2,1,1,-1,0,1
investovat,1,6,5,1,1,0,1
slučovat,2,3,1,1,1,0,1
nasimulovat,2,9,7,1,1,0,1
založit,1,13,12,1,1,0,1
vyslat,8,2,6,1,-1,0,1
určit,3,10,7,1,1,0,1
znát,8,3,5,1,-1,0,1
přihlásit,1,14,13,1,1,1,1
koupit,7,11,4,1,1,0,1
brát,3,2,-1,-1,1,0,1
vidět,2,14,12,1,1,0,1
mít,1,2,1,1,1,-1,1
zaměstnávat,2,2,0,0,-1,0,1
mít,1,9,8,1,1,0,1
hodnotit,2,7,5,1,1,0,1
dívat,1,2,1,1,1,0,1
redukovat,4,4,0,0,1,0,1
mít,5,2,3,1,-1,1,1
mít,7,3,4,1,-1,0,1
stanovit,1,4,-3,-1,-1,0,1
najmout,5,4,1,1,-1,0,1
vysílat,2,4,2,1,1,0,1
dávat,5,8,3,1,1,0,1
podat,2,17,15,1,1,0,1
spolknout,3,4,1,1,1,0,1
stát,4,9,-5,-1,-1,0,1
stát,2,3,-1,-1,-1,0,1
stát,2,2,0,0,-1,0,1
zaplatit,8,2,6,1,-1,0,1
postavit,1,2,1,1,1,1,1
zasílat,1,3,2,1,1,0,1
přivézt,1,2,-1,-1,-1,0,1
mít,6,3,3,1,-1,0,1
vykládat,2,2,0,0,1,0,1
mít,8,4,-4,-1,1,0,1
snížit,1,3,2,1,1,0,1
uplatňovat,4,3,1,1,-1,0,1
skládat,1,4,3,1,1,0,1
konzultovat,4,6,2,1,1,0,1
přivádět,2,2,0,0,-1,0,1
přijímat,1,8,7,1,1,0,1
namarkovat,4,3,1,1,-1,0,1
kontrolovat,4,6,-2,-1,-1,0,1
zařadit,2,7,5,1,1,0,1
hledat,1,19,18,1,1,0,1
představit,1,2,1,1,1,1,1
vidět,2,2,0,0,-1,1,1
absolvovat,4,6,2,1,1,0,1
přesáhnout,3,3,0,0,-1,0,1
zaplatit,2,2,0,0,-1,0,1
obrátit,1,8,7,1,1,0,1
vysypat,5,2,3,1,-1,0,1
odmítnout,14,11,-3,-1,1,0,1
mít,1,6,5,1,1,0,1
nakupovat,1,4,3,1,1,1,1
ušetřit,3,3,0,0,-1,0,1
ztrácet,1,4,3,1,1,0,1
stát,11,14,3,1,1,0,1
najít,10,5,5,1,-1,0,1
otevřít,4,4,0,0,1,0,1
platit,5,4,1,1,-1,0,1
snížit,2,15,13,1,1,0,1
vytahat,1,2,1,1,1,0,1
vyhledat,21,3,18,1,-1,0,1
vydat,3,3,0,0,1,0,1
odpracovat,3,4,-1,-1,-1,0,1
dávat,2,5,3,1,1,0,1
stáhnout,2,3,1,1,1,0,1
prodávat,1,2,1,1,1,0,1
uvést,18,2,16,1,-1,0,1
plnit,9,2,7,1,-1,0,1
nabídnout,3,8,5,1,1,0,1
navštívit,1,2,-1,-1,-1,0,1
vyklidit,2,3,1,1,1,0,1
interpelovat,2,3,-1,-1,-1,0,1
pobírat,2,5,3,1,1,0,1
uplatnit,3,3,0,0,1,0,1
nabídnout,12,3,9,1,-1,0,1
využívat,2,5,3,1,1,0,1
dotázat,3,8,-5,-1,-1,0,1
vybrat,43,23,20,1,-1,0,1
vést,9,3,6,1,-1,0,1
odporovat,1,5,4,1,1,0,1
zvát,5,2,3,1,-1,0,1
nastříkat,2,2,0,0,1,0,1
nastříkat,2,2,0,0,-1,0,1
mít,2,2,0,0,-1,0,1
uspořádat,6,6,0,0,-1,0,1
doprovázet,11,16,5,1,1,0,1
pozvat,1,2,1,1,1,-1,1
převést,1,3,2,1,1,1,1
vykoupit,4,3,1,1,-1,0,1
dodržovat,4,3,-1,-1,1,0,1
obsadit,5,6,-1,-1,-1,0,1
dosáhnout,1,6,5,1,1,0,1
přesunout,2,2,0,0,-1,0,1
opustit,6,3,-3,-1,1,0,1
strávit,2,6,-4,-1,-1,0,1
ponechat,4,2,2,1,-1,0,1
prohlásit,1,2,1,1,1,0,1
osvobodit,3,2,1,1,-1,0,1
dostat,6,3,3,1,-1,0,1
hledat,2,2,0,0,-1,1,1
mít,2,3,-1,-1,-1,0,1
očekávat,3,2,1,1,-1,0,1
získat,2,2,0,0,1,0,1
stát,1,2,-1,-1,-1,0,1
vyhrát,2,2,0,0,1,0,1
překonat,7,3,4,1,-1,0,1
mít,11,3,8,1,-1,0,1
mít,1,3,-2,-1,-1,0,1
mít,2,2,0,0,-1,0,1
mít,1,2,-1,-1,-1,0,1
poslat,1,2,1,1,1,0,1
cítit,3,3,0,0,-1,0,1
zapálit,2,4,-2,-1,-1,0,1
mít,12,2,10,1,-1,0,1
hrát,3,2,1,1,-1,0,1
doznat,2,3,-1,-1,-1,0,1
zaznamenat,5,5,0,0,-1,0,1
dohrát,1,5,4,1,1,0,1
hrát,2,2,0,0,-1,0,1
získat,8,5,-3,-1,1,0,1
získat,3,2,-1,-1,1,0,1
znamenat,13,3,10,1,-1,0,1
vstřebat,11,2,9,1,-1,1,1
probudit,1,2,1,1,1,-1,1
ponechat,1,3,2,1,1,0,1
použít,3,4,1,1,1,0,1
mít,6,5,1,1,-1,0,1
sejmout,2,2,0,0,-1,0,1
pomoci,1,3,2,1,1,0,1
nabízet,7,5,-2,-1,1,0,1
promarnit,2,4,-2,-1,-1,0,1
připravovat,6,3,3,1,-1,0,1
vyrobit,2,3,1,1,1,0,1
dosáhnout,12,3,9,1,-1,0,1
soustředit,2,14,12,1,1,0,1
vyjednat,1,9,8,1,1,0,1
hlídat,4,10,6,1,1,0,1
nabídnout,3,7,4,1,1,0,1
nabídnout,6,2,4,1,-1,0,1
vypustit,4,7,-3,-1,-1,0,1
najít,6,2,4,1,-1,0,1
odcizit,10,9,1,1,-1,0,1
prosazovat,3,2,1,1,-1,0,1
přesunout,2,17,15,1,1,0,1
rozdělit,1,4,3,1,1,0,1
nastolit,3,3,0,0,-1,0,1
získat,1,3,-2,-1,-1,0,1
oznámit,1,2,1,1,1,0,1
učinit,2,12,10,1,1,0,1
nést,7,3,4,1,-1,0,1
podepsat,1,3,2,1,1,0,1
simulovat,6,9,3,1,1,0,1
zachycovat,1,2,-1,-1,-1,0,1
měnit,1,2,1,1,1,0,1
smést,4,2,2,1,-1,0,1
dočkat,1,4,3,1,1,0,1
promnout,1,5,4,1,1,0,1
mít,3,2,1,1,-1,0,1
podepsat,6,2,4,1,-1,0,1
mít,6,4,2,1,-1,0,1
požadovat,5,5,0,0,-1,0,1
uvádět,4,3,-1,-1,1,0,1
načerpat,1,6,5,1,1,0,1
vyvolat,3,3,0,0,-1,0,1
zvýšit,2,3,1,1,1,0,1
sdělit,7,6,1,1,-1,0,1
používat,20,11,-9,-1,1,0,1
hledat,2,16,14,1,1,0,1
postavit,2,2,0,0,1,0,1
vypracovat,2,3,1,1,1,0,1
posílit,2,2,0,0,1,0,1
vynést,2,2,0,0,-1,0,1
dělat,1,2,1,1,1,0,1
osvětlit,1,3,2,1,1,0,1
mít,2,2,0,0,-1,0,1
mít,1,2,-1,-1,-1,0,1
sledovat,3,3,0,0,-1,0,1
převést,2,3,1,1,1,0,1
ukazovat,1,3,2,1,1,0,1
zavolat,7,5,-2,-1,1,0,1
mít,3,2,1,1,-1,1,1
absolvovat,2,13,11,1,1,0,1
poskytovat,2,13,11,1,1,0,1
činit,1,5,4,1,1,0,1
dělat,1,3,2,1,1,0,1
mít,3,2,1,1,-1,0,1
porazit,1,2,-1,-1,-1,0,1
vydržet,4,3,-1,-1,1,0,1
mít,4,3,1,1,-1,0,1
dát,3,2,1,1,-1,0,1
mít,1,2,1,1,1,0,1
mít,1,3,-2,-1,-1,0,1
mít,2,9,7,1,1,0,1
číst,6,5,1,1,-1,0,1
porazit,2,2,0,0,-1,0,1
vyzbrojovat,1,3,2,1,1,0,1
odnést,1,2,1,1,1,0,1
přijmout,5,5,0,0,-1,0,1
zaslat,16,4,12,1,-1,0,1
zakopat,2,2,0,0,-1,0,1
získat,2,2,0,0,-1,0,1
shánět,1,5,4,1,1,0,1
hledat,16,5,11,1,-1,0,1
zabývat,3,4,1,1,1,0,1
zprovoznit,3,3,0,0,1,0,1
vlastnit,1,4,3,1,1,0,1
zaznamenat,10,3,7,1,-1,0,1
využít,7,4,3,1,-1,0,1
předložit,2,2,0,0,-1,0,1
přijmout,12,7,-5,-1,1,0,1
dostat,6,3,3,1,-1,0,1
získat,5,4,-1,-1,1,0,1
mít,4,3,1,1,-1,0,1
přislíbit,11,9,2,1,-1,0,1
zvyšovat,3,2,1,1,-1,0,1
akceptovat,1,4,3,1,1,0,1
mít,2,2,0,0,1,0,1
vyvážet,1,2,1,1,1,0,1
vybudovat,4,2,-2,-1,1,0,1
vydupat,4,2,2,1,-1,0,1
mít,6,2,4,1,-1,0,1
přeladit,1,8,7,1,1,0,1
dát,1,8,7,1,1,0,1
zahájit,4,4,0,0,-1,0,1
očekávat,3,9,6,1,1,0,1
podrobit,1,4,-3,-1,-1,0,1
opouštět,2,5,3,1,1,0,1
poskytnout,3,4,-1,-1,-1,0,1
označit,8,5,-3,-1,1,0,1
zkoušet,2,4,-2,-1,-1,0,1
uvádět,7,2,5,1,-1,0,1
uvádět,9,2,7,1,-1,0,1
iniciovat,15,4,11,1,-1,0,1
mít,2,16,14,1,1,0,1
představit,3,3,0,0,1,0,1
pozvat,17,2,15,1,-1,0,1
hemžit,1,4,3,1,1,0,1
zkoušet,2,4,-2,-1,-1,0,1
odvážet,3,2,1,1,-1,0,1
podepsat,2,2,0,0,1,0,1
končit,6,3,3,1,-1,0,1
odolávat,2,8,6,1,1,0,1
nastřílet,2,3,-1,-1,-1,0,1
vyhrát,9,2,7,1,-1,0,1
hodnotit,1,7,-6,-1,-1,0,1
pomoci,1,3,2,1,1,0,1
odhadnout,1,2,-1,-1,-1,0,1
odvézt,2,2,0,0,-1,0,1
mít,8,4,4,1,-1,0,1
mít,1,3,2,1,1,0,1
dovést,2,8,6,1,1,0,1
prodat,1,2,1,1,1,1,1
mít,3,3,0,0,-1,0,1
dostat,4,2,-2,-1,1,0,1
dodat,9,2,7,1,-1,0,1
podepsat,5,2,3,1,-1,0,1
mít,2,3,1,1,1,0,1
povést,1,6,5,1,1,0,1
liberalizovat,4,4,0,0,-1,0,1
dostávat,2,5,-3,-1,-1,0,1
nastřílet,2,3,-1,-1,-1,0,1
omezit,1,15,14,1,1,0,1
smést,17,2,15,1,-1,0,1
dělat,1,2,1,1,1,0,1
předložit,22,2,20,1,-1,0,1
žalovat,1,9,8,1,1,0,1
vinit,1,22,21,1,1,0,1
vidět,2,3,-1,-1,-1,0,1
požadovat,4,4,0,0,-1,0,1
obvinit,1,11,10,1,1,0,1
převést,2,4,2,1,1,0,1
získat,6,3,3,1,-1,0,1
vyšetřit,4,4,0,0,-1,0,1
mít,8,6,2,1,-1,0,1
korigovat,3,3,0,0,-1,0,1
dovolávat,1,2,1,1,1,0,1
poskytnout,2,3,1,1,1,0,1
předávat,5,2,3,1,-1,1,1
uvést,1,2,1,1,1,0,1
vnášet,6,3,3,1,-1,0,1
evidovat,11,2,9,1,-1,0,1
informovat,3,4,1,1,1,0,1
sledovat,1,3,2,1,1,0,1
stát,7,2,5,1,-1,0,1
vidět,1,2,1,1,1,0,1
přivést,2,3,1,1,1,0,1
nacházet,10,9,1,1,-1,0,1
obdržet,7,7,0,0,1,0,1
získávat,3,4,1,1,1,0,1
konstatovat,1,11,10,1,1,0,1
prosadit,23,2,21,1,-1,0,1
podepsat,9,2,7,1,-1,0,1
rozdělit,1,7,6,1,1,0,1
dosáhnout,2,3,1,1,1,0,1
vystupňovat,4,9,5,1,1,0,1
odvolat,3,8,-5,-1,-1,0,1
doplatit,4,4,0,0,1,0,1
vyjádřit,21,3,18,1,-1,0,1
získat,3,3,0,0,-1,0,1
obdržet,3,6,3,1,1,0,1
těšit,14,4,10,1,-1,0,1
zpovídat,11,13,2,1,1,0,1
mít,12,4,8,1,-1,0,1
přivést,4,3,-1,-1,1,0,1
zůstat,1,6,-5,-1,-1,0,1
ukončit,4,2,2,1,-1,0,1
stát,6,4,2,1,-1,0,1
udržet,3,2,-1,-1,1,0,1
dostat,1,3,2,1,1,1,1
vést,1,18,17,1,1,0,1
odložit,2,3,1,1,1,0,1
utírat,1,2,1,1,1,0,1
vylepšovat,4,2,-2,-1,1,0,1
zajišťovat,2,5,3,1,1,0,1
dát,4,2,2,1,-1,0,1
prodloužit,3,4,1,1,1,0,1
vykoupit,4,7,3,1,1,0,1
prodat,12,5,7,1,-1,0,1
konkurovat,8,4,4,1,-1,0,1
spojovat,4,4,0,0,1,0,1
vyplatit,2,2,0,0,-1,0,1
přesáhnout,3,3,0,0,-1,0,1
schválit,5,13,8,1,1,0,1
zvýšit,1,3,2,1,1,0,1
přesáhnout,3,7,4,1,1,0,1
dosahovat,4,4,0,0,-1,0,1
mít,2,7,-5,-1,-1,0,1
mít,4,4,0,0,-1,0,1
mít,5,3,2,1,-1,0,1
přepravovat,1,2,1,1,1,0,1
přivézt,1,2,1,1,1,0,1
koupit,2,3,-1,-1,-1,0,1
umět,1,3,2,1,1,0,1
zažít,4,3,1,1,-1,0,1
mít,3,2,1,1,-1,0,1
mít,3,3,0,0,-1,0,1
pomáhat,1,2,1,1,1,0,1
prodávat,4,3,-1,-1,1,0,1
odpykávat,1,5,4,1,1,0,1
trávit,2,29,27,1,1,0,1
připojit,12,8,4,1,-1,0,1
mít,1,3,-2,-1,-1,0,1
vyloučit,1,3,-2,-1,-1,0,1
osvědčit,3,10,7,1,1,0,1
vyhnat,1,6,5,1,1,0,1
zajistit,7,2,5,1,-1,0,1
znamenat,2,5,-3,-1,-1,0,1
uvést,12,2,10,1,-1,0,1
střídat,4,6,2,1,1,0,1
ujmout,3,4,-1,-1,-1,0,1
vstřelit,2,3,-1,-1,-1,0,1
zanechat,7,2,5,1,-1,0,1
položit,13,9,4,1,-1,0,1
určit,1,3,-2,-1,-1,0,1
pozdravovat,1,15,14,1,1,0,1
zdolat,2,4,-2,-1,-1,0,1
přivézt,4,3,1,1,-1,0,1
mít,3,2,1,1,-1,1,1
dostat,1,3,2,1,1,0,1
mít,2,7,5,1,1,0,1
rovnat,7,2,-5,-1,1,-1,1
obléknout,3,3,0,0,1,0,1
posuzovat,17,10,-7,-1,1,0,1
zaplatit,3,3,0,0,1,0,1
žádat,13,6,7,1,-1,0,1
stavět,2,4,2,1,1,0,1
moci,2,4,2,1,1,0,1
učinit,5,3,-2,-1,1,0,1
vysílat,7,4,-3,-1,1,0,1
vyvolat,14,10,4,1,-1,0,1
mít,6,2,4,1,-1,1,1
motivovat,1,8,7,1,1,0,1
usmrtit,2,2,0,0,-1,0,1
uzavřít,15,3,12,1,-1,0,1
žádat,8,2,6,1,-1,0,1
zastřelit,1,3,2,1,1,0,1
použít,6,4,2,1,-1,0,1
mít,2,2,0,0,-1,0,1
zaujímat,2,8,6,1,1,0,1
vyrýt,2,2,0,0,-1,0,1
vzít,3,2,1,1,-1,1,1
předložit,1,2,-1,-1,-1,0,1
svěřovat,7,7,0,0,1,0,1
účastnit,2,5,3,1,1,0,1
mít,1,4,3,1,1,0,1
sestavit,1,3,-2,-1,-1,0,1
začlenit,19,6,13,1,-1,0,1
koupit,2,2,0,0,1,0,1
citovat,20,3,17,1,-1,0,1
zavraždit,4,2,2,1,-1,0,1
zahrnovat,17,2,15,1,-1,0,1
přislíbit,2,4,2,1,1,0,1
získat,2,10,8,1,1,0,1
složit,1,2,-1,-1,-1,0,1
určit,2,11,9,1,1,0,1
evakuovat,2,2,0,0,-1,0,1
vyslat,8,2,6,1,-1,0,1
omlouvat,10,10,0,0,1,0,1
míchat,1,4,3,1,1,0,1
uvolnit,1,12,11,1,1,0,1
stáhnout,2,5,3,1,1,0,1
dostávat,2,12,10,1,1,0,1
odmítnout,8,9,1,1,1,0,1
dopustit,2,2,0,0,-1,0,1
přijímat,10,4,6,1,-1,0,1
napojovat,1,2,1,1,1,1,1
mít,44,2,42,1,-1,0,1
stavět,4,2,2,1,-1,0,1
postavit,3,3,0,0,-1,0,1
mít,3,2,1,1,-1,0,1
mít,1,3,-2,-1,-1,0,1
vyslovit,23,7,16,1,-1,0,1
začít,1,4,3,1,1,0,1
nalézt,3,2,-1,-1,1,0,1
mít,13,3,10,1,-1,0,1
mít,5,3,2,1,-1,0,1
mít,1,2,-1,-1,-1,0,1
rozestavět,1,3,2,1,1,1,1
mít,3,2,1,1,-1,0,1
uvádět,10,2,8,1,-1,0,1
brát,1,2,-1,-1,-1,0,1
mít,8,3,5,1,-1,0,1
mít,3,2,1,1,-1,0,1
pomoci,14,3,11,1,-1,0,1
natočit,3,5,2,1,1,0,1
dodávat,1,5,4,1,1,0,1
zanechat,3,8,-5,-1,-1,0,1
zachraňovat,2,2,0,0,1,0,1
jídat,4,4,0,0,1,0,1
získat,2,7,-5,-1,-1,0,1
vložit,2,9,7,1,1,0,1
prokázat,1,2,-1,-1,-1,0,1
porazit,2,4,-2,-1,-1,0,1
vystřídat,2,2,0,0,-1,0,1
darovat,1,2,1,1,1,0,1
mít,1,2,-1,-1,-1,0,1
hrát,2,4,-2,-1,-1,0,1
vidět,2,3,-1,-1,-1,0,1
zúčastnit,3,2,1,1,-1,0,1
vidět,3,2,1,1,-1,0,1
dostat,4,3,-1,-1,1,0,1
přivézt,2,2,0,0,1,0,1
očekávat,2,4,2,1,1,0,1
mít,2,2,0,0,1,1,1
nacházet,2,4,2,1,1,0,1
odložit,4,3,-1,-1,1,0,1
přizvat,2,10,8,1,1,0,1
mít,3,2,1,1,-1,0,1
představit,2,2,0,0,-1,0,1
udílet,5,4,-1,-1,1,0,1
zavádět,7,4,3,1,-1,0,1
činit,1,6,5,1,1,0,1
schválit,3,5,-2,-1,-1,0,1
prožívat,2,8,6,1,1,0,1
shazovat,1,8,7,1,1,0,1
uvést,1,2,1,1,1,0,1
tvrdit,1,6,5,1,1,0,1
mít,11,2,9,1,-1,0,1
zajistit,3,2,-1,-1,1,0,1
zavírat,1,6,5,1,1,0,1
mít,1,4,3,1,1,0,1
semnout,2,4,2,1,1,0,1
přidat,1,13,12,1,1,0,1
vyslechnout,6,2,4,1,-1,1,1
strávit,2,2,0,0,1,0,1
přesahovat,2,3,1,1,1,0,1
mít,5,3,2,1,-1,0,1
organizovat,2,2,0,0,-1,0,1
převést,2,4,2,1,1,0,1
dostat,1,2,-1,-1,-1,0,1
hrát,2,4,2,1,1,0,1
mít,6,3,3,1,-1,0,1
zakázat,1,4,3,1,1,0,1
prodloužit,1,4,3,1,1,0,1
vzepřít,2,2,0,0,-1,0,1
vytvořit,2,2,0,0,1,0,1
dostat,5,2,3,1,-1,0,1
překonat,2,4,-2,-1,-1,0,1
porazit,1,3,-2,-1,-1,0,1
mít,5,3,2,1,-1,0,1
získat,2,4,-2,-1,-1,0,1
mít,1,3,2,1,1,0,1
mít,4,3,1,1,-1,0,1
přivézt,13,2,11,1,-1,0,1
překročit,2,2,0,0,1,0,1
vrátit,5,2,3,1,-1,0,1
převzít,9,3,6,1,-1,0,1
řídit,1,2,1,1,1,0,1
vést,4,4,0,0,1,0,1
lákat,1,3,2,1,1,0,1
přijmout,5,2,3,1,-1,0,1
vyřadit,4,2,2,1,-1,0,1
zadržet,5,11,6,1,1,0,1
posílit,1,6,5,1,1,0,1
dostávat,1,2,-1,-1,-1,0,1
uvolňovat,3,4,-1,-1,-1,0,0
dostat,16,2,-14,-1,1,0,0
vést,2,3,-1,-1,-1,0,0
využít,2,4,-2,-1,-1,0,0
otevřít,3,5,2,1,1,0,0
vystřídat,1,8,-7,-1,-1,-1,0
upoutat,2,2,0,0,1,-1,0
řídit,2,5,-3,-1,-1,0,0
požívat,3,7,4,1,1,0,0
uvádět,19,5,-14,-1,1,0,0
představovat,8,3,-5,-1,1,1,0
vychutnat,5,4,1,1,-1,0,0
vydat,4,4,0,0,-1,0,0
podsouvat,9,5,-4,-1,1,0,0
dostávat,4,2,-2,-1,1,0,0
schválit,8,5,3,1,-1,0,0
zbavit,7,2,-5,-1,1,0,0
ohrožovat,2,4,-2,-1,-1,0,0
stanovit,4,7,-3,-1,-1,0,0
postrádat,4,5,1,1,1,0,0
řadit,2,14,-12,-1,-1,0,0
vnést,1,15,-14,-1,-1,0,0
trpět,2,5,3,1,1,0,0
charakterizovat,3,4,-1,-1,-1,0,0
zavést,2,3,-1,-1,-1,0,0
dávat,7,2,5,1,-1,0,0
vidět,5,2,-3,-1,1,0,0
zachránit,2,2,0,0,-1,0,0
převézt,1,2,-1,-1,-1,0,0
představit,12,4,-8,-1,1,0,0
nabídnout,2,3,-1,-1,-1,0,0
situovat,1,16,-15,-1,-1,0,0
mít,4,3,-1,-1,1,0,0
řídit,1,4,-3,-1,-1,0,0
získávat,6,3,-3,-1,1,0,0
hodnotit,3,3,0,0,-1,0,0
obsadit,2,3,-1,-1,-1,0,0
pokládat,1,4,-3,-1,-1,0,0
sklonit,1,16,-15,-1,-1,1,0
mít,3,2,1,1,-1,0,0
vydělat,15,2,-13,-1,1,0,0
mít,3,5,2,1,1,0,0
sehrát,2,6,4,1,1,0,0
žádat,3,3,0,0,1,0,0
vzít,2,2,0,0,-1,0,0
nechat,2,4,2,1,1,0,0
povzbuzovat,1,2,1,1,1,0,0
podrazit,1,2,-1,-1,-1,0,0
vylovit,1,2,1,1,1,0,0
hodit,1,2,-1,-1,-1,0,0
povést,2,2,0,0,1,0,0
pozvat,2,7,-5,-1,-1,0,0
překonat,6,2,-4,-1,1,0,0
získat,4,2,-2,-1,1,0,0
mít,5,3,-2,-1,1,0,0
získat,8,3,-5,-1,1,0,0
stát,11,5,-6,-1,1,0,0
mít,1,3,2,1,1,0,0
poslat,1,2,1,1,1,0,0
vybojovat,2,3,-1,-1,-1,0,0
absolvovat,2,4,-2,-1,-1,0,0
doplnit,2,3,-1,-1,-1,0,0
utrpět,2,2,0,0,1,0,0
nastolit,1,2,-1,-1,-1,0,0
bít,1,4,-3,-1,-1,0,0
použít,2,2,0,0,1,0,0
zjistit,2,3,1,1,1,0,0
vozit,2,6,-4,-1,-1,0,0
vyřizovat,4,3,-1,-1,1,0,0
vyučovat,2,5,-3,-1,-1,0,0
zařídit,5,7,2,1,1,0,0
dodat,7,3,-4,-1,1,0,0
nést,2,4,-2,-1,-1,0,0
připomenout,3,4,1,1,1,0,0
brát,1,2,1,1,1,0,0
využívat,5,3,2,1,-1,0,0
spatřit,2,3,1,1,1,0,0
uvést,3,2,-1,-1,1,0,0
vzbuzovat,1,3,2,1,1,0,0
snižovat,6,5,-1,-1,1,0,0
snižovat,4,3,1,1,-1,0,0
uvidět,5,3,-2,-1,1,0,0
postavit,3,2,1,1,-1,0,0
hledat,15,3,-12,-1,1,0,0
odpovídat,1,13,12,1,1,0,0
získat,4,10,-6,-1,-1,0,0
vlastnit,2,3,-1,-1,-1,0,0
mít,3,11,-8,-1,-1,0,0
připravovat,6,3,-3,-1,1,0,0
natočit,20,3,-17,-1,1,0,0
určovat,2,3,-1,-1,-1,0,0
vzniknout,1,5,-4,-1,-1,0,0
vzniknout,1,3,-2,-1,-1,0,0
mít,46,5,-41,-1,1,0,0
zavést,13,5,-8,-1,1,0,0
mít,1,3,2,1,1,0,0
regulovat,2,3,-1,-1,-1,0,0
mít,5,2,-3,-1,1,0,0
tvrdit,1,4,-3,-1,-1,0,0
získat,3,4,1,1,1,0,0
stát,5,2,-3,-1,1,0,0
mít,2,2,0,0,-1,0,0
tvrdit,9,5,-4,-1,1,0,0
využít,1,6,-5,-1,-1,0,0
plést,1,2,-1,-1,-1,0,0
číst,4,3,1,1,-1,0,0
mít,1,6,-5,-1,-1,0,0
prodávat,2,3,-1,-1,-1,0,0
mít,5,2,-3,-1,1,-1,0
uvést,1,10,-9,-1,-1,0,0
mít,2,3,-1,-1,-1,0,0
mít,3,3,0,0,1,0,0
organizovat,4,4,0,0,1,0,0
získat,9,3,-6,-1,1,0,0
chystat,3,3,0,0,1,0,0
najít,2,4,-2,-1,-1,0,0
vyinkasovat,2,3,1,1,1,0,0
odstraňovat,7,4,3,1,-1,0,0
bodnout,4,2,2,1,-1,0,0
utrpět,6,2,-4,-1,1,0,0
způsobit,4,3,-1,-1,1,0,0
vyměnit,6,2,-4,-1,1,0,0
odcizit,4,4,0,0,1,0,0
vyhlásit,4,3,1,1,-1,0,0
porazit,1,2,1,1,1,0,0
předčit,2,4,-2,-1,-1,0,0
prolomit,3,5,2,1,1,0,0
potvrdit,2,2,0,0,1,0,0
objevit,3,3,0,0,1,0,0
odvádět,1,3,-2,-1,-1,0,0
přidat,2,4,-2,-1,-1,0,0
získat,1,3,-2,-1,-1,0,0
mít,2,9,-7,-1,-1,0,0
platit,10,2,-8,-1,1,0,0
změřit,1,3,-2,-1,-1,0,0
získat,6,3,3,1,-1,0,0
vytvořit,7,3,-4,-1,1,0,0
zanechat,1,2,1,1,1,-1,0
reprezentovat,1,3,-2,-1,-1,0,0
střídat,6,2,-4,-1,1,0,0
převzít,1,5,-4,-1,-1,0,0
vybrat,3,3,0,0,1,0,0
vyvést,1,2,-1,-1,-1,0,0
sbírat,2,2,0,0,-1,0,0
porazit,6,4,2,1,-1,0,0
mít,2,2,0,0,1,0,0
vytvořit,3,3,0,0,-1,0,0
získat,2,5,-3,-1,-1,0,0
mít,7,6,-1,-1,1,0,0
získat,2,2,0,0,1,0,0
poskytnout,2,2,0,0,-1,0,0
mít,3,3,0,0,1,0,0
získat,1,2,-1,-1,-1,0,0
porazit,1,2,1,1,1,0,0
mít,2,3,1,1,1,0,0
dostat,5,3,-2,-1,1,0,0
hrát,3,3,0,0,1,0,0
poznat,1,6,5,1,1,0,0
porazit,2,5,3,1,1,0,0
otočit,1,3,-2,-1,-1,0,0
poslat,1,3,-2,-1,-1,0,0
přihrát,5,2,-3,-1,1,0,0
zachytit,2,3,1,1,1,0,0
zvednout,1,2,-1,-1,-1,0,0
pustit,1,2,-1,-1,-1,0,0
překonat,2,3,1,1,1,0,0
otevřít,1,5,-4,-1,-1,0,0
dostat,1,2,-1,-1,-1,0,0
rozhodnout,1,3,-2,-1,-1,0,0
hrát,2,2,0,0,-1,0,0
přivítat,6,4,-2,-1,1,0,0
vzít,1,3,-2,-1,-1,0,0
podávat,1,3,2,1,1,0,0
zvát,1,4,-3,-1,-1,-1,0
mít,9,2,-7,-1,1,0,0
zvýšit,2,6,-4,-1,-1,0,0
přesahovat,5,3,2,1,-1,0,0
udávat,6,8,2,1,1,0,0
hlídat,4,7,-3,-1,-1,0,0
požadovat,3,3,0,0,-1,0,0
zajistit,13,4,-9,-1,1,0,0
prodávat,1,4,-3,-1,-1,0,0
ponechat,4,3,1,1,-1,0,0
mít,1,3,-2,-1,-1,-1,0
podpořit,5,10,-5,-1,-1,0,0
stát,7,3,-4,-1,1,0,0
znamenat,6,3,-3,-1,1,0,0
poskytnout,1,5,-4,-1,-1,0,0
čekat,4,3,1,1,-1,0,0
vyprodávat,3,3,0,0,-1,0,0
prodávat,2,2,0,0,-1,1,0
stát,3,3,0,0,1,0,0
dát,1,5,-4,-1,-1,0,0
umožnit,2,3,-1,-1,-1,0,0
měřit,4,8,-4,-1,-1,0,0
dodržet,25,3,-22,-1,1,0,0
sledovat,3,4,-1,-1,-1,0,0
držet,1,3,-2,-1,-1,0,0
připadnout,1,6,5,1,1,0,0
překročit,3,3,0,0,-1,0,0
mít,9,2,-7,-1,1,0,0
mívat,7,3,-4,-1,1,0,0
použít,5,9,-4,-1,-1,0,0
využívat,8,3,-5,-1,1,0,0
žádat,11,6,-5,-1,1,0,0
hradit,4,5,-1,-1,-1,0,0
podlehnout,1,5,-4,-1,-1,0,0
soustředit,1,3,-2,-1,-1,0,0
diskutovat,6,3,-3,-1,1,0,0
vytvořit,3,3,0,0,1,-1,0
mít,1,2,1,1,1,0,0
mít,1,4,3,1,1,0,0
snížit,1,3,-2,-1,-1,0,0
odhadovat,6,4,2,1,-1,0,0
dočkat,7,3,-4,-1,1,0,0
uvést,2,4,2,1,1,0,0
přijímat,13,7,-6,-1,1,0,0
mít,1,2,1,1,1,0,0
zahájit,2,5,-3,-1,-1,0,0
zatknout,5,2,-3,-1,1,0,0
propustit,6,4,-2,-1,1,0,0
oznámit,1,2,-1,-1,-1,0,0
přivézt,2,2,0,0,1,0,0
přebírat,5,4,-1,-1,1,0,0
ratifikovat,1,3,-2,-1,-1,0,0
ubodat,4,2,-2,-1,1,0,0
zaujímat,3,2,-1,-1,1,0,0
poslat,2,3,-1,-1,-1,0,0
zahájit,4,2,-2,-1,1,0,0
vytahovat,4,2,-2,-1,1,0,0
vyhlásit,11,9,2,1,-1,0,0
otevřít,3,5,-2,-1,-1,0,0
mít,4,3,-1,-1,1,0,0
směstnat,4,7,-3,-1,-1,0,0
udělit,1,8,-7,-1,-1,0,0
vyhlásit,2,2,0,0,1,0,0
vidět,6,2,-4,-1,1,0,0
najít,3,2,-1,-1,1,0,0
srovnat,1,2,-1,-1,-1,0,0
dobývat,1,3,2,1,1,0,0
podminovat,4,2,-2,-1,1,0,0
připravovat,2,3,-1,-1,-1,0,0
užívat,2,4,-2,-1,-1,0,0
vidět,1,15,-14,-1,-1,0,0
potvrdit,1,2,-1,-1,-1,0,0
opatřit,3,2,-1,-1,1,0,0
činit,8,2,-6,-1,1,0,0
vykazovat,1,3,2,1,1,0,0
mít,9,2,-7,-1,1,0,0
dostávat,5,6,1,1,1,0,0
vyhovovat,1,10,-9,-1,-1,0,0
odebírat,1,3,-2,-1,-1,0,0
udržet,3,3,0,0,1,0,0
obdařit,4,3,-1,-1,1,0,0
vydat,6,2,-4,-1,1,0,0
pozvat,3,2,-1,-1,1,0,0
proměnit,27,4,-23,-1,1,0,0
poznávat,2,4,2,1,1,0,0
dostat,3,8,-5,-1,-1,0,0
dorazit,2,3,-1,-1,-1,0,0
strhnout,1,3,-2,-1,-1,0,0
získat,5,4,-1,-1,1,0,0
podrobit,12,10,-2,-1,1,0,0
zajišťovat,6,8,-2,-1,-1,0,0
potopit,5,3,-2,-1,1,0,0
zkoušet,2,4,-2,-1,-1,0,0
mít,3,6,-3,-1,-1,0,0
nechat,3,2,1,1,-1,0,0
nosit,4,2,-2,-1,1,-1,0
nabízet,4,7,-3,-1,-1,0,0
poslat,4,15,-11,-1,-1,0,0
získat,3,3,0,0,1,0,0
nastínit,2,3,1,1,1,0,0
spravit,1,5,-4,-1,-1,0,0
načechrat,3,3,0,0,-1,0,0
narazit,1,2,-1,-1,-1,-1,0
fauloval,1,3,2,1,1,0,0
podnikat,2,3,1,1,1,0,0
dostat,2,3,-1,-1,-1,0,0
pustit,1,3,-2,-1,-1,0,0
přivézt,13,3,-10,-1,1,0,0
hájit,2,6,-4,-1,-1,0,0
mít,3,2,-1,-1,1,-1,0
rehabilitovat,1,10,-9,-1,-1,-1,0
mít,1,21,-20,-1,-1,0,0
dovést,1,5,-4,-1,-1,0,0
mít,3,2,1,1,-1,0,0
vnést,1,6,-5,-1,-1,0,0
mít,2,3,1,1,1,0,0
mít,4,2,-2,-1,1,0,0
posílat,3,3,0,0,-1,0,0
odebrat,2,9,-7,-1,-1,0,0
zařídit,1,3,2,1,1,0,0
dát,1,3,2,1,1,0,0
dávat,1,3,-2,-1,-1,0,0
skupovat,3,3,0,0,1,0,0
spáchat,1,3,2,1,1,0,0
nastoupit,1,3,-2,-1,-1,0,0
odsoudit,1,3,2,1,1,0,0
vydělat,2,3,-1,-1,-1,0,0
dosáhnout,3,3,0,0,1,0,0
dát,3,4,-1,-1,-1,0,0
dosáhnout,10,3,-7,-1,1,0,0
poslat,22,2,-20,-1,1,0,0
přerušit,5,7,-2,-1,-1,0,0
potvrdit,7,8,1,1,1,0,0
najít,12,3,-9,-1,1,1,0
vypovědět,1,2,1,1,1,0,0
mít,1,2,1,1,1,0,0
vítat,3,4,-1,-1,-1,0,0
postavit,2,4,2,1,1,0,0
vnést,3,11,-8,-1,-1,0,0
napojit,2,4,-2,-1,-1,0,0
získat,4,8,-4,-1,-1,0,0
zvládnout,1,3,-2,-1,-1,0,0
sloužit,1,3,-2,-1,-1,0,0
připomínat,3,9,6,1,1,0,0
přivítat,8,5,-3,-1,1,0,0
oznámit,6,5,-1,-1,1,0,0
najít,3,4,-1,-1,-1,0,0
vypátrat,2,4,-2,-1,-1,0,0
kritizovat,2,2,0,0,1,0,0
zastavit,11,3,-8,-1,1,0,0
znevýhodňovat,2,15,-13,-1,-1,0,0
odstranit,2,3,-1,-1,-1,0,0
vnášet,6,9,3,1,1,0,0
vzrušovat,2,11,-9,-1,-1,0,0
vnášet,2,2,0,0,1,0,0
zdát,1,3,2,1,1,0,0
mít,22,2,-20,-1,1,-1,0
mít,6,2,-4,-1,1,0,0
říci,1,2,-1,-1,-1,0,0
zastupovat,1,9,-8,-1,-1,0,0
parafovat,12,2,-10,-1,1,0,0
vytrhnout,2,2,0,0,1,0,0
oznámit,1,2,-1,-1,-1,0,0
předat,4,3,-1,-1,1,0,0
odnést,4,2,-2,-1,1,0,0
prostříhat,1,4,-3,-1,-1,0,0
převzít,1,8,-7,-1,-1,0,0
ponechat,4,2,-2,-1,1,0,0
stát,2,2,0,0,1,0,0
podniknout,38,2,-36,-1,1,-1,0
vyhlásit,4,4,0,0,-1,0,0
vydat,6,2,-4,-1,1,0,0
nasadit,1,4,-3,-1,-1,0,0
vyškrtnout,1,3,-2,-1,-1,-1,0
nosit,1,3,-2,-1,-1,-1,0
zaznamenat,2,2,0,0,1,0,0
zmocnit,10,5,-5,-1,1,0,0
pobírat,4,4,0,0,1,0,0
vozit,5,3,-2,-1,1,0,0
mít,1,15,-14,-1,-1,0,0
vtěsnat,4,3,1,1,-1,0,0
odkázat,1,14,-13,-1,-1,-1,0
mít,2,4,2,1,1,0,0
vytvářet,2,4,2,1,1,0,0
ovládat,1,4,-3,-1,-1,0,0
vědět,1,2,-1,-1,-1,0,0
zabývat,1,3,-2,-1,-1,0,0
vyšetřit,4,2,2,1,-1,0,0
mít,1,3,2,1,1,0,0
vyloučit,1,4,-3,-1,-1,0,0
vědět,1,2,-1,-1,-1,0,0
vědět,1,2,-1,-1,-1,0,0
vydat,12,2,-10,-1,1,0,0
mít,16,3,-13,-1,1,0,0
uvést,2,4,-2,-1,-1,0,0
mít,7,2,-5,-1,1,0,0
opakovat,8,17,-9,-1,-1,0,0
činit,5,3,-2,-1,1,0,0
natočit,5,2,-3,-1,1,0,0
přikládat,2,5,3,1,1,0,0
potvrdit,6,6,0,0,-1,0,0
podporovat,1,3,2,1,1,0,0
spojovat,1,7,-6,-1,-1,0,0
splnit,8,8,0,0,-1,0,0
stát,2,3,1,1,1,0,0
vytvářet,11,5,-6,-1,1,0,0
odhalit,11,2,-9,-1,1,0,0
nechat,7,2,-5,-1,1,0,0
založit,22,3,-19,-1,1,0,0
vnést,6,5,-1,-1,1,0,0
vydobýt,14,2,-12,-1,1,0,0
zneužívat,1,4,-3,-1,-1,0,0
potrestat,1,21,-20,-1,-1,0,0
snížit,9,9,0,0,-1,0,0
potvrdit,2,3,1,1,1,0,0
projednat,2,3,-1,-1,-1,0,0
přinést,4,4,0,0,1,0,0
mít,3,3,0,0,1,0,0
vydat,4,16,-12,-1,-1,0,0
nalézt,3,3,0,0,-1,0,0
zúčastnit,3,3,0,0,1,0,0
dočkat,1,4,-3,-1,-1,0,0
vyřídit,4,4,0,0,-1,0,0
prodat,3,3,0,0,1,0,0
udržet,2,6,-4,-1,-1,0,0
mít,11,2,-9,-1,1,0,0
mít,2,13,-11,-1,-1,0,0
očekávat,2,4,2,1,1,0,0
dočkat,1,4,-3,-1,-1,0,0
přivítat,1,5,4,1,1,0,0
pozorovat,5,2,-3,-1,1,0,0
koupit,5,4,1,1,-1,0,0
nabývat,4,3,-1,-1,1,0,0
vnést,2,3,1,1,1,0,0
zastřelit,6,5,-1,-1,1,0,0
přidělit,2,5,-3,-1,-1,0,0
zažalovat,4,22,-18,-1,-1,0,0
vidět,7,3,4,1,-1,0,0
domáhat,23,3,-20,-1,1,0,0
dovést,4,27,-23,-1,-1,0,0
mít,4,2,-2,-1,1,0,0
mít,3,2,-1,-1,1,0,0
znamenat,2,4,2,1,1,0,0
prosadit,3,10,-7,-1,-1,0,0
stát,3,4,1,1,1,0,0
zprivatizovat,5,6,-1,-1,-1,0,0
vyvážet,2,2,0,0,-1,0,0
mít,2,3,-1,-1,-1,0,0
domluvit,1,8,-7,-1,-1,0,0
postavit,2,2,0,0,1,0,0
dosáhnout,4,3,-1,-1,1,0,0
představovat,2,7,5,1,1,0,0
ustavit,14,4,-10,-1,1,0,0
dělat,1,5,-4,-1,-1,0,0
sbírat,2,2,0,0,-1,0,0
odnášet,1,2,1,1,1,0,0
vytlačit,8,5,-3,-1,1,0,0
znamenat,1,4,3,1,1,0,0
přijít,2,2,0,0,-1,0,0
vyhodit,5,2,-3,-1,1,0,0
uznat,3,3,0,0,1,0,0
vznášet,3,2,-1,-1,1,0,0
zaručit,3,3,0,0,-1,0,0
vyvolat,1,2,1,1,1,0,0
učinit,6,3,-3,-1,1,0,0
posadit,1,5,-4,-1,-1,0,0
prozkoumat,1,4,-3,-1,-1,0,0
pozvat,7,3,-4,-1,1,0,0
představovat,6,18,-12,-1,-1,0,0
čekat,1,3,-2,-1,-1,-1,0
mít,1,3,-2,-1,-1,-1,0
odkázat,2,16,-14,-1,-1,0,0
mít,4,3,-1,-1,1,0,0
nastoupit,2,8,-6,-1,-1,0,0
nastoupit,2,2,0,0,-1,0,0
zkoumat,2,3,-1,-1,-1,0,0
vyhlásit,4,4,0,0,1,0,0
mít,1,9,-8,-1,-1,0,0
vytvořit,3,2,-1,-1,1,0,0
připomínat,1,24,-23,-1,-1,0,0
uvádět,4,2,-2,-1,1,0,0
mít,1,7,-6,-1,-1,0,0
připojit,12,2,-10,-1,1,0,0
mít,2,3,1,1,1,0,0
dostat,11,2,-9,-1,1,0,0
vyvolat,1,6,5,1,1,0,0
mít,5,2,-3,-1,1,-1,0
vybírat,1,2,1,1,1,-1,0
nabízet,2,3,-1,-1,-1,0,0
očekávat,5,8,3,1,1,0,0
zaznamenat,4,2,-2,-1,1,0,0
provozovat,3,4,-1,-1,-1,0,0
požádat,3,5,2,1,1,0,0
zahájit,1,4,-3,-1,-1,0,0
dosáhnout,7,3,-4,-1,1,0,0
dosáhnout,5,3,-2,-1,1,0,0
dovézt,5,6,-1,-1,-1,0,0
získat,2,3,1,1,1,0,0
provádět,2,2,0,0,-1,0,0
využívat,2,3,-1,-1,-1,0,0
přijít,1,3,2,1,1,0,0
stáčet,5,4,-1,-1,1,0,0
naplnit,2,2,0,0,-1,0,0
nahradit,4,3,1,1,-1,0,0
odsávat,1,7,-6,-1,-1,0,0
tlačit,2,20,-18,-1,-1,0,0
odsát,13,3,-10,-1,1,0,0
vyřizovat,2,24,-22,-1,-1,0,0
vykonávat,4,4,0,0,-1,0,0
přesáhnout,4,4,0,0,1,0,0
mít,3,5,2,1,1,0,0
půjčit,2,2,0,0,-1,0,0
vyjádřit,16,2,-14,-1,1,0,0
investovat,2,2,0,0,1,0,0
prosazovat,1,18,-17,-1,-1,0,0
podplatit,3,5,-2,-1,-1,0,0
střežit,8,3,-5,-1,1,0,0
zaměstnávat,2,2,0,0,-1,0,0
svolat,10,2,-8,-1,1,0,0
prosazovat,1,3,-2,-1,-1,-1,0
soustředit,5,2,-3,-1,1,0,0
získávat,1,3,-2,-1,-1,0,0
zbavovat,2,2,0,0,-1,0,0
dělat,1,2,1,1,1,0,0
chystat,9,7,2,1,-1,0,0
dokončit,1,3,2,1,1,0,0
dát,1,3,2,1,1,0,0
mít,4,2,-2,-1,1,0,0
znamenat,1,3,2,1,1,0,0
uvolnit,2,3,-1,-1,-1,0,0
zajistit,1,3,-2,-1,-1,0,0
klást,6,3,-3,-1,1,0,0
provozovat,3,9,-6,-1,-1,0,0
sundat,1,2,-1,-1,-1,0,0
zavézt,1,5,-4,-1,-1,-1,0
hledat,3,4,1,1,1,0,0
poskytovat,2,4,2,1,1,0,0
omezovat,2,3,-1,-1,-1,0,0
rozněcovat,1,3,2,1,1,0,0
ukrást,9,8,-1,-1,1,0,0
připojit,3,2,-1,-1,1,-1,0
spadnout,3,2,-1,-1,1,0,0
povýšit,6,6,0,0,1,0,0
zastávat,9,6,-3,-1,1,0,0
omezit,3,2,-1,-1,1,0,0
zhostit,2,2,0,0,-1,0,0
přesunout,4,9,-5,-1,-1,0,0
zneužívat,2,2,0,0,1,0,0
přivítat,2,3,1,1,1,0,0
naplánovat,3,3,0,0,-1,0,0
vyvolat,5,2,-3,-1,1,0,0
likvidovat,7,3,-4,-1,1,0,0
vytlačit,5,3,2,1,-1,0,0
mít,3,3,0,0,1,0,0
postihnout,1,4,-3,-1,-1,0,0
přinést,1,2,-1,-1,-1,0,0
vypovědět,4,2,-2,-1,1,0,0
vypovědět,1,2,-1,-1,-1,-1,0
pokousat,1,4,-3,-1,-1,-1,0
zaznamenat,3,7,4,1,1,0,0
patřit,2,2,0,0,1,0,0
nabízet,13,6,-7,-1,1,0,0
uvést,14,2,-12,-1,1,0,0
vymáhat,1,4,-3,-1,-1,0,0
nacházet,1,7,-6,-1,-1,-1,0
psát,3,3,0,0,1,0,0
doručit,1,3,-2,-1,-1,0,0
donášet,1,8,-7,-1,-1,0,0
dodávat,1,2,-1,-1,-1,0,0
sehrát,2,9,-7,-1,-1,0,0
porazit,1,4,-3,-1,-1,0,0
zaznamenat,1,5,-4,-1,-1,0,0
ztratit,1,15,-14,-1,-1,0,0
ujmout,1,16,-15,-1,-1,0,0
dostat,1,2,-1,-1,-1,0,0
prostřelit,2,3,1,1,1,0,0
přinést,2,3,-1,-1,-1,0,0
mít,2,4,-2,-1,-1,0,0
zařadit,3,3,0,0,-1,0,0
potvrdit,3,10,-7,-1,-1,0,0
dostat,2,5,3,1,1,0,0
uvítat,1,3,-2,-1,-1,0,0
promítnout,3,2,-1,-1,1,0,0
zařadit,2,4,-2,-1,-1,0,0
nastoupit,2,3,-1,-1,-1,0,0
přivézt,11,2,-9,-1,1,0,0
přihlásit,3,3,0,0,1,0,0
dostat,3,5,-2,-1,-1,0,0
mít,2,2,0,0,1,0,0
zrušit,29,3,-26,-1,1,0,0
ovlivnit,6,4,2,1,-1,0,0
mít,1,8,-7,-1,-1,0,0
vložit,3,2,-1,-1,1,0,0
držet,1,2,1,1,1,0,0
nechat,4,3,-1,-1,1,0,0
trhat,1,2,-1,-1,-1,0,0
činit,3,7,-4,-1,-1,0,0
zvýhodňovat,4,4,0,0,1,0,0
požadovat,3,5,2,1,1,0,0
zpožďovat,4,3,1,1,-1,0,0
nakupovat,4,2,2,1,-1,0,0
tlačit,2,6,-4,-1,-1,0,0
očekávat,2,3,1,1,1,0,0
vyrobit,9,2,-7,-1,1,0,0
dosáhnout,4,3,-1,-1,1,0,0
dosáhnout,4,3,-1,-1,1,0,0
dosahovat,2,2,0,0,1,0,0
oznámit,1,2,-1,-1,-1,0,0
najít,2,4,2,1,1,0,0
vystřídat,3,2,-1,-1,1,0,0
vyplivnout,2,6,-4,-1,-1,0,0
dosáhnout,3,3,0,0,1,0,0
stavět,7,3,4,1,-1,0,0
prodávat,5,3,-2,-1,1,0,0
dostat,1,2,1,1,1,0,0
představovat,2,3,-1,-1,-1,1,0
poskytnout,1,5,-4,-1,-1,-1,0
získat,6,2,-4,-1,1,0,0
označit,5,2,-3,-1,1,0,0
obdržet,8,11,3,1,1,0,0
mít,3,3,0,0,1,1,0
nabízet,3,4,-1,-1,-1,0,0
pomáhat,4,3,1,1,-1,0,0
požádat,3,9,-6,-1,-1,0,0
podat,4,7,-3,-1,-1,0,0
potřebovat,16,3,-13,-1,1,0,0
vyrábět,3,3,0,0,1,0,0
zavést,7,3,-4,-1,1,0,0
zastřelit,2,4,2,1,1,0,0
vyjmout,4,2,-2,-1,1,0,0
zamířit,1,7,-6,-1,-1,-1,0
vysílat,2,5,-3,-1,-1,0,0
vyzývat,1,10,-9,-1,-1,0,0
nechat,8,2,6,1,-1,0,0
mít,2,4,2,1,1,0,0
chápat,5,8,-3,-1,-1,0,0
pohnat,8,2,-6,-1,1,0,0
připustit,9,3,-6,-1,1,0,0
vyslat,16,2,-14,-1,1,0,0
vyjádřit,9,3,-6,-1,1,0,0
vést,11,3,-8,-1,1,0,0
mít,3,2,-1,-1,1,0,0
zavádět,3,5,-2,-1,-1,0,0
vzít,13,2,-11,-1,1,0,0
zahájit,2,2,0,0,1,-1,0
zahájit,11,2,-9,-1,1,0,0
získat,5,4,1,1,-1,0,0
mít,2,3,1,1,1,0,0
hledat,2,5,-3,-1,-1,0,0
dát,2,2,0,0,1,0,0
mít,6,3,-3,-1,1,0,0
vycítit,7,3,-4,-1,1,0,0
hrát,1,3,2,1,1,0,0
mít,2,9,-7,-1,-1,0,0
spravovat,4,5,-1,-1,-1,0,0
zahrnovat,11,3,-8,-1,1,0,0
posoudit,6,3,3,1,-1,0,0
obsahovat,1,2,1,1,1,0,0
obsahovat,15,3,-12,-1,1,0,0
založit,4,5,1,1,1,0,0
získat,2,3,-1,-1,-1,0,0
nést,18,2,-16,-1,1,0,0
sledovat,14,3,-11,-1,1,0,0
mít,5,2,-3,-1,1,0,0
zkusit,1,3,-2,-1,-1,0,0
objet,2,3,-1,-1,-1,0,0
mít,6,2,-4,-1,1,0,0
získat,2,4,-2,-1,-1,0,0
zachvátit,3,3,0,0,1,0,0
obdržet,11,6,5,1,-1,0,0
sdílet,5,4,-1,-1,1,0,0
shledat,5,2,-3,-1,1,0,0
vyvolat,3,7,-4,-1,-1,0,0
mít,7,3,-4,-1,1,0,0
omezit,2,4,-2,-1,-1,0,0
dodržet,1,2,1,1,1,-1,0
mít,4,3,-1,-1,1,0,0
mít,1,2,-1,-1,-1,-1,0
dotknout,3,5,2,1,1,0,0
připustit,26,3,-23,-1,1,0,0
uspořádat,2,2,0,0,-1,0,0
nominovat,2,5,3,1,1,0,0
porazit,1,2,1,1,1,0,0
volit,1,2,1,1,1,0,0
zvrátit,2,3,-1,-1,-1,0,0
převzít,4,4,0,0,-1,0,0
dovézt,1,4,-3,-1,-1,-1,0
zasáhnout,2,2,0,0,1,0,0
mít,3,2,-1,-1,1,-1,0
udělat,6,3,-3,-1,1,0,0
přijmout,6,5,-1,-1,1,0,0
zapíchnout,1,4,-3,-1,-1,0,0
pamatovat,2,3,1,1,1,0,0
vzdát,2,3,1,1,1,0,0
mít,3,2,-1,-1,1,0,0
hrát,1,3,2,1,1,0,0
zajišťovat,1,2,-1,-1,-1,0,0
najít,1,2,1,1,1,-1,0
dostat,1,10,9,1,1,0,0
mít,2,12,-10,-1,-1,0,0
zdolat,2,3,1,1,1,0,0
mít,2,2,0,0,1,0,0
vytvořit,2,8,6,1,1,0,0
vidět,3,4,-1,-1,-1,0,0
odstranit,1,3,-2,-1,-1,0,0
rozestavět,2,4,-2,-1,-1,0,0
nabýt,1,2,1,1,1,0,0
mít,9,2,-7,-1,1,-1,0
uvádět,1,3,-2,-1,-1,0,0
zaznamenat,4,5,1,1,1,0,0
rozšiřovat,2,5,-3,-1,-1,0,0
chválit,2,4,-2,-1,-1,0,0
pochválit,5,5,0,0,-1,0,0
předpokládat,3,3,0,0,1,0,0
mít,8,3,-5,-1,1,0,0
mít,11,2,-9,-1,1,0,0
zajistit,18,4,-14,-1,1,0,0
získat,1,3,-2,-1,-1,0,0
vyžadovat,3,6,3,1,1,0,0
vytáhnout,1,3,2,1,1,0,0
sehnat,1,7,-6,-1,-1,0,0
postavit,1,2,1,1,1,0,0
absorbovat,5,3,2,1,-1,0,0
vyšlechtit,11,2,-9,-1,1,0,0
činit,4,7,-3,-1,-1,0,0
rozšířit,2,2,0,0,1,0,0
stát,6,4,-2,-1,1,0,0
pomáhat,5,8,-3,-1,-1,0,0
uvádět,2,3,-1,-1,-1,0,0
vyhrát,2,3,-1,-1,-1,0,0
napsat,1,7,-6,-1,-1,0,0
postrádat,10,3,-7,-1,1,0,0
mít,2,12,-10,-1,-1,0,0
preferovat,7,4,3,1,-1,0,0
vykonávat,3,3,0,0,-1,0,0
navrhovat,11,3,-8,-1,1,0,0
připravit,7,3,-4,-1,1,0,0
doporučit,14,2,-12,-1,1,0,0
vložit,1,2,1,1,1,0,0
mít,3,2,-1,-1,1,0,0
posunout,1,5,-4,-1,-1,0,0
mít,8,4,-4,-1,1,0,0
najít,1,3,-2,-1,-1,0,0
psát,10,2,-8,-1,1,0,0
poškozovat,2,3,-1,-1,-1,0,0
bránit,2,4,-2,-1,-1,0,0
podpořit,25,7,-18,-1,1,0,0
uvalit,1,2,1,1,1,0,0
identifikovat,9,6,3,1,-1,0,0
mít,2,2,0,0,1,-1,0
zrušit,24,3,-21,-1,1,0,0
zaujmout,14,3,-11,-1,1,0,0
překročit,3,7,-4,-1,-1,0,0
představovat,2,3,1,1,1,0,0
postavit,3,18,-15,-1,-1,0,0
stát,8,6,2,1,-1,0,0
hltat,1,2,-1,-1,-1,0,0
mít,9,3,-6,-1,1,0,0
prohlásit,1,2,-1,-1,-1,0,0
dávat,1,3,-2,-1,-1,0,0
splnit,2,5,-3,-1,-1,0,0
opustit,1,3,-2,-1,-1,0,0
soustředit,1,3,-2,-1,-1,-1,0
stát,11,2,-9,-1,1,0,0
dostat,2,9,-7,-1,-1,0,0
dodržet,1,3,-2,-1,-1,0,0
označit,2,4,2,1,1,0,0
požadovat,3,3,0,0,1,0,0
platit,3,3,0,0,1,0,0
prodat,15,3,-12,-1,1,0,0
mít,20,4,-16,-1,1,0,0
oslavovat,3,6,3,1,1,0,0
zaznamenávat,4,4,0,0,-1,0,0
cítit,4,3,-1,-1,1,0,0
učit,2,3,-1,-1,-1,0,0
vyjádřit,5,3,-2,-1,1,0,0
vyžádat,3,3,0,0,1,0,0
vyslat,7,3,-4,-1,1,0,0
iniciovat,10,5,5,1,-1,0,0
podepsat,8,2,-6,-1,1,0,0
zakopat,15,3,-12,-1,1,0,0
držet,1,2,-1,-1,-1,0,0
zanechat,2,2,0,0,1,0,0
vyvolat,8,4,-4,-1,1,0,0
rozložit,2,2,0,0,-1,0,0
vyložit,1,2,-1,-1,-1,0,0
tlačit,1,3,-2,-1,-1,0,0
popadnout,1,4,-3,-1,-1,-1,0
zachovávat,5,2,-3,-1,1,0,0
nechat,1,2,-1,-1,-1,0,0
vytesávat,6,6,0,0,-1,0,0
určit,3,3,0,0,-1,0,0
mýt,1,3,-2,-1,-1,0,0
převzít,1,20,-19,-1,-1,0,0
nabízet,1,2,-1,-1,-1,0,0
stopovat,2,8,-6,-1,-1,0,0
otrávit,1,3,-2,-1,-1,0,0
mít,9,5,-4,-1,1,0,0
vyhodit,4,2,-2,-1,1,0,0
zasloužit,3,6,-3,-1,-1,0,0
učit,1,7,-6,-1,-1,0,0
uvádět,1,4,-3,-1,-1,0,0
pořádat,6,3,-3,-1,1,0,0
zavolat,1,13,-12,-1,-1,-1,0
využívat,13,7,6,1,-1,0,0
stát,4,3,-1,-1,1,0,0
představovat,9,3,-6,-1,1,0,0
vyzvat,3,2,-1,-1,1,0,0
prodloužit,18,3,15,1,-1,0,0
vyzývat,1,2,-1,-1,-1,0,0
pozvat,3,2,1,1,-1,0,0
řídit,6,8,-2,-1,-1,0,0
přivážet,9,3,-6,-1,1,0,0
vyčerpat,4,3,1,1,-1,0,0
splnit,2,19,-17,-1,-1,0,0
mít,1,2,-1,-1,-1,0,0
použít,3,4,-1,-1,-1,0,0
přepadnout,1,3,2,1,1,0,0
jmenovat,19,3,-16,-1,1,0,0
vybrat,1,3,2,1,1,0,0
sdělit,1,2,1,1,1,0,0
vynadat,1,2,-1,-1,-1,-1,0
zařadit,2,9,-7,-1,-1,0,0
zpozdit,4,4,0,0,-1,0,0
vyslat,1,3,2,1,1,0,0
mít,2,4,2,1,1,0,0
sejmout,5,2,-3,-1,1,-1,0
získat,4,3,-1,-1,1,0,0
opakovat,2,3,-1,-1,-1,0,0
mít,2,2,0,0,1,0,0
učinit,1,10,-9,-1,-1,0,0
vzbudit,1,3,2,1,1,0,0
citovat,1,4,-3,-1,-1,0,0
vést,1,16,-15,-1,-1,0,0
vyplatit,1,3,2,1,1,0,0
splnit,1,3,-2,-1,-1,0,0
odhalovat,28,3,-25,-1,1,0,0
mít,4,3,-1,-1,1,0,0
vzít,1,2,-1,-1,-1,0,0
vypustit,1,2,-1,-1,-1,0,0
vyvážet,4,2,2,1,-1,0,0
mít,2,2,0,0,1,0,0
ukazovat,4,3,-1,-1,1,0,0
zúčastnit,4,2,-2,-1,1,0,0
uhrát,4,2,-2,-1,1,0,0
odložit,6,6,0,0,-1,0,0
kopnout,2,2,0,0,-1,0,0
uchopit,1,4,-3,-1,-1,0,0
mít,2,2,0,0,1,0,0
dohánět,1,3,-2,-1,-1,0,0
mít,1,13,-12,-1,-1,-1,0
mít,2,2,0,0,1,0,0
obsadit,2,6,4,1,1,0,0
dát,2,2,0,0,-1,0,0
prosadit,2,2,0,0,1,0,0
dostávat,1,3,-2,-1,-1,0,0
vymknout,1,2,-1,-1,-1,0,0
provést,1,3,-2,-1,-1,0,0
mít,2,2,0,0,1,0,0
mít,21,2,-19,-1,1,-1,0
využít,3,3,0,0,-1,0,0
založit,7,2,-5,-1,1,-1,0
sehnat,5,3,-2,-1,1,0,0
vybrat,6,3,-3,-1,1,0,0
investovat,2,4,-2,-1,-1,0,0
otevřít,1,2,-1,-1,-1,0,0
připravit,2,4,-2,-1,-1,0,0
vypěstovat,6,2,-4,-1,1,-1,0
poskytnout,1,4,-3,-1,-1,0,0
zařídit,1,7,-6,-1,-1,-1,0
uspořádat,1,3,2,1,1,0,0
stát,1,5,4,1,1,0,0
poznat,1,3,-2,-1,-1,-1,0
zanechat,2,2,0,0,1,-1,0
stříkat,2,3,-1,-1,-1,0,0
vykouzlit,5,3,-2,-1,1,0,0
mít,1,3,-2,-1,-1,0,0
koupit,12,5,-7,-1,1,0,0
studovat,1,3,-2,-1,-1,0,0
mít,1,2,1,1,1,0,0
naroubovat,1,3,-2,-1,-1,-1,0
mít,2,7,-5,-1,-1,0,0
cítit,1,8,-7,-1,-1,0,0
koupit,2,2,0,0,1,0,0
posílit,2,3,1,1,1,0,0
interpelovat,11,4,-7,-1,1,0,0
podporovat,2,2,0,0,1,0,0
přivést,1,3,-2,-1,-1,0,0
přihrát,8,2,-6,-1,1,0,0
vyrobit,6,4,-2,-1,1,0,0
obrátit,1,2,1,1,1,0,0
míchat,1,3,2,1,1,0,0
mít,4,2,-2,-1,1,0,0
přetlumočit,15,2,-13,-1,1,0,0
psát,1,2,-1,-1,-1,0,0
psát,1,2,-1,-1,-1,0,0
překračovat,4,2,-2,-1,1,-1,0
najít,8,2,-6,-1,1,0,0
stát,8,6,-2,-1,1,0,0
prosadit,3,12,-9,-1,-1,0,0
mít,4,3,-1,-1,1,0,0
iniciovat,7,10,-3,-1,-1,0,0
uveřejnit,2,3,-1,-1,-1,0,0
udržet,2,3,-1,-1,-1,0,0
mít,4,5,-1,-1,-1,0,0
převzít,2,2,0,0,1,0,0
mít,1,2,-1,-1,-1,0,0
ztrácet,3,3,0,0,1,0,0
obsahovat,9,3,-6,-1,1,0,0
dělat,2,22,-20,-1,-1,0,0
mít,2,17,-15,-1,-1,0,0
pronést,1,2,-1,-1,-1,-1,0
mít,3,6,-3,-1,-1,0,0
mít,5,2,-3,-1,1,-1,0
překládat,2,3,1,1,1,0,0
vypít,3,3,0,0,-1,0,0
vybudovat,2,5,-3,-1,-1,0,0
překřtít,2,7,-5,-1,-1,0,0
číst,10,6,-4,-1,1,1,0
držet,4,2,-2,-1,1,0,0
mít,9,4,-5,-1,1,0,0
zahájit,4,5,-1,-1,-1,0,0
zůstávat,6,3,-3,-1,1,0,0
založit,18,3,-15,-1,1,0,0
zabývat,2,7,-5,-1,-1,0,0
rozvést,2,9,-7,-1,-1,0,0
představovat,1,3,2,1,1,0,0
splnit,1,2,1,1,1,0,0
stát,7,2,-5,-1,1,0,0
splnit,2,7,5,1,1,0,0
vynést,14,3,-11,-1,1,0,0
doklepnout,1,2,-1,-1,-1,0,0
poslat,2,2,0,0,1,0,0
poslat,2,3,1,1,1,0,0
přežít,2,8,6,1,1,0,0
zabít,1,2,-1,-1,-1,0,0
prohrát,2,3,-1,-1,-1,0,0
mít,2,22,-20,-1,-1,0,0
mít,15,2,-13,-1,1,0,0
pustit,1,2,1,1,1,0,0
dostat,3,2,-1,-1,1,0,0
vzít,2,2,0,0,1,0,0
mít,10,2,-8,-1,1,0,0
mít,13,3,-10,-1,1,0,0
pozorovat,1,4,-3,-1,-1,0,0
dělat,2,3,1,1,1,0,0
nahnat,2,3,-1,-1,-1,0,0
dostávat,8,4,-4,-1,1,0,0
mít,2,8,-6,-1,-1,0,0
mít,2,31,-29,-1,-1,0,0
realizovat,2,4,-2,-1,-1,0,0
mít,2,2,0,0,1,0,0
ospravedlňovat,2,9,-7,-1,-1,0,0
využívat,2,3,1,1,1,0,0
mít,2,2,0,0,1,-1,0
mít,1,10,-9,-1,-1,0,0
projevovat,3,2,-1,-1,1,0,0
odvolat,5,3,-2,-1,1,0,0
odvádět,2,2,0,0,-1,0,0
obsadit,2,5,3,1,1,0,0
mít,2,7,-5,-1,-1,0,0
mít,1,2,1,1,1,0,0
odrážet,1,3,-2,-1,-1,-1,0
porazit,2,3,1,1,1,0,0
ponechávat,2,3,-1,-1,-1,0,0
zaznamenat,6,2,-4,-1,1,0,0
získat,6,4,-2,-1,1,0,0
mít,2,6,4,1,1,0,0
přihrát,1,3,2,1,1,0,0
zabetonovat,1,2,-1,-1,-1,-1,0
podepsat,13,2,-11,-1,1,0,0
znát,1,2,1,1,1,1,0
vyřadit,1,4,-3,-1,-1,0,0
vyřadit,1,10,-9,-1,-1,0,0
zdolat,2,5,3,1,1,0,0
ztratit,1,2,-1,-1,-1,0,0
vyzkoušet,1,2,-1,-1,-1,0,0
splnit,1,2,-1,-1,-1,0,0
porovnat,2,3,-1,-1,-1,0,0
mít,6,2,-4,-1,1,0,0
nacvičovat,2,3,1,1,1,0,0
napomáhat,2,16,-14,-1,-1,0,0
udržet,4,4,0,0,1,0,0
spravovat,3,7,-4,-1,-1,0,0
účastnit,5,2,-3,-1,1,0,0
promítnout,7,8,-1,-1,-1,0,0
připravovat,12,3,-9,-1,1,0,0
získat,3,5,2,1,1,0,0
prodat,2,5,-3,-1,-1,0,0
dosáhnout,4,2,-2,-1,1,0,0
mít,10,2,-8,-1,1,0,0
mít,3,4,1,1,1,0,0
přesáhnout,6,3,-3,-1,1,0,0
mít,15,2,-13,-1,1,-1,0
zrušit,6,4,2,1,-1,0,0
mít,5,4,-1,-1,1,0,0
nahradit,2,3,1,1,1,0,0
odpovídat,2,3,1,1,1,0,0
podat,6,3,3,1,-1,0,0
předražovat,1,3,-2,-1,-1,0,0
předražit,1,5,-4,-1,-1,0,0
nahlásit,3,4,-1,-1,-1,0,0
využít,6,2,-4,-1,1,-1,0
mít,1,5,-4,-1,-1,0,0
jmenovat,3,5,2,1,1,0,0
mít,3,2,-1,-1,1,0,0
předhánět,5,3,-2,-1,1,0,0
mít,3,2,-1,-1,1,-1,0
prezentovat,2,2,0,0,1,0,0
podat,1,3,2,1,1,0,0
zaručovat,1,3,-2,-1,-1,0,0
dosáhnout,5,3,-2,-1,1,0,0
pronajmout,2,9,-7,-1,-1,0,0
dělat,1,2,1,1,1,-1,0
zůstat,1,7,6,1,1,0,0
zůstat,1,3,2,1,1,0,0
mít,7,2,-5,-1,1,0,0
postavit,2,2,0,0,1,0,0
řešit,2,8,-6,-1,-1,0,0
spolykat,3,2,-1,-1,1,0,0
mít,9,2,-7,-1,1,0,0
deformovat,2,5,-3,-1,-1,0,0
vysílat,1,4,-3,-1,-1,0,0
stáhnout,1,6,-5,-1,-1,0,0
získat,2,3,1,1,1,0,0
mít,3,2,-1,-1,1,0,0
strhnout,1,3,-2,-1,-1,0,0
stáhnout,2,6,-4,-1,-1,0,0
udržovat,6,3,-3,-1,1,0,0
označit,8,2,-6,-1,1,0,0
podepsat,14,2,-12,-1,1,0,0
umístit,4,7,-3,-1,-1,0,0
stát,3,3,0,0,-1,0,0
stanovit,1,3,-2,-1,-1,0,0
podnikat,13,2,-11,-1,1,0,0
stavět,2,2,0,0,-1,0,0
odsunout,2,2,0,0,1,0,0
vydělit,3,10,-7,-1,-1,0,0
hledat,6,4,2,1,-1,0,0
přijmout,21,2,-19,-1,1,0,0
zahájit,13,3,-10,-1,1,0,0
zveřejnit,29,2,-27,-1,1,0,0
vyloupnout,1,8,-7,-1,-1,-1,0
udržet,3,3,0,0,-1,0,0
mít,3,2,-1,-1,1,-1,0
spotřebovat,13,4,-9,-1,1,0,0
vyjmout,1,3,-2,-1,-1,0,0
zbrzdit,2,4,-2,-1,-1,0,0
zavázat,2,4,-2,-1,-1,0,0
udávat,10,8,-2,-1,1,0,0
dostávat,2,6,-4,-1,-1,0,0
umístit,15,2,-13,-1,1,0,0
otočit,2,3,-1,-1,-1,0,0
odsouvat,8,2,-6,-1,1,0,0
povolit,2,2,0,0,1,0,0
mít,1,4,-3,-1,-1,0,0
spáchat,1,4,3,1,1,0,0
připočíst,22,2,-20,-1,1,0,0
postavit,1,9,-8,-1,-1,0,0
mít,1,7,6,1,1,0,0
založit,2,6,4,1,1,0,0
získávat,5,3,-2,-1,1,0,0
mít,2,3,1,1,1,0,0
dokázat,2,3,-1,-1,-1,0,0
dosáhnout,2,3,1,1,1,0,0
vidět,2,2,0,0,-1,0,0
vrátit,1,3,-2,-1,-1,0,0
počastovat,2,6,-4,-1,-1,0,0
hrát,2,2,0,0,-1,0,0
dávat,1,4,3,1,1,0,0
přivézt,2,3,1,1,1,0,0
přistavovat,1,4,3,1,1,0,0
držet,3,4,-1,-1,-1,0,0
mít,1,2,1,1,1,0,0
schytat,2,2,0,0,-1,0,0
mít,5,5,0,0,1,0,0
zakazovat,4,3,1,1,-1,0,0
smést,3,2,1,1,-1,0,0
navrhovat,3,11,-8,-1,-1,0,0
sehrát,3,2,-1,-1,1,-1,0
glajchšaltovat,1,3,-2,-1,-1,0,0
přihlásit,1,5,-4,-1,-1,0,0
hledat,1,11,-10,-1,-1,0,0
uvést,8,2,-6,-1,1,0,0
označit,5,7,2,1,1,0,0
pomoci,1,3,-2,-1,-1,0,0
najít,7,3,4,1,-1,0,0
zasáhnout,2,2,0,0,-1,0,0
vypravit,2,3,1,1,1,0,0
strčit,1,5,-4,-1,-1,0,0
plnit,2,4,-2,-1,-1,0,0
vykládat,1,2,-1,-1,-1,0,0
převzít,4,3,-1,-1,1,0,0
mít,6,7,1,1,1,0,0
přednést,5,3,-2,-1,1,0,0
shromáždit,13,12,-1,-1,1,0,0
vyhnout,2,3,1,1,1,0,0
trávit,2,2,0,0,1,0,0
platit,3,3,0,0,-1,0,0
zůstávat,20,6,-14,-1,1,0,0
zůstávat,1,6,-5,-1,-1,0,0
zůstat,3,2,1,1,-1,0,0
mít,19,10,-9,-1,1,0,0
získat,2,4,-2,-1,-1,0,0
určovat,3,8,-5,-1,-1,0,0
obsahovat,19,3,-16,-1,1,0,0
mít,1,2,1,1,1,-1,0
vidět,1,2,-1,-1,-1,0,0
vzdorovat,3,10,7,1,1,0,0
mít,2,2,0,0,1,0,0
prodat,10,4,-6,-1,1,0,0
mít,5,3,-2,-1,1,0,0
brát,11,3,-8,-1,1,0,0
trpět,5,3,-2,-1,1,0,0
vidět,1,3,2,1,1,0,0
mít,1,3,2,1,1,0,0
chtít,2,4,-2,-1,-1,0,0
odevzdat,4,3,-1,-1,1,0,0
patřit,26,2,-24,-1,1,0,0
získat,5,3,-2,-1,1,0,0
vést,1,2,-1,-1,-1,0,0
mívat,9,3,-6,-1,1,0,0
rozšířit,1,5,-4,-1,-1,0,0
dodávat,2,5,-3,-1,-1,0,0
uvádět,12,7,-5,-1,1,0,0
mít,2,4,2,1,1,0,0
mít,7,3,-4,-1,1,0,0
pozvat,6,8,2,1,1,0,0
slyšet,1,14,-13,-1,-1,0,0
ukázat,1,7,-6,-1,-1,0,0
podat,7,6,1,1,-1,0,0
mít,1,2,1,1,1,0,0
obsadit,2,3,-1,-1,-1,0,0
přijmout,23,6,-17,-1,1,0,0
mít,2,3,1,1,1,0,0
ztratit,1,3,-2,-1,-1,0,0
ověřit,4,10,-6,-1,-1,0,0
vydat,1,3,-2,-1,-1,0,0
vyřadit,3,3,0,0,1,0,0
vyhrávat,2,2,0,0,-1,0,0
podržet,1,3,-2,-1,-1,0,0
malovat,1,2,-1,-1,-1,0,0
stát,5,2,-3,-1,1,0,0
vzbudit,1,3,2,1,1,0,0
zůstávat,4,4,0,0,1,0,0
potrápit,6,3,-3,-1,1,0,0
mít,1,2,-1,-1,-1,1,0
mít,3,2,-1,-1,1,-1,0
dostat,2,3,1,1,1,0,0
překračovat,2,24,-22,-1,-1,0,0
sjednávat,1,2,-1,-1,-1,0,0
vypočítat,2,6,-4,-1,-1,0,0
slavit,2,6,-4,-1,-1,0,0
uvidět,10,4,-6,-1,1,0,0
přivést,7,2,-5,-1,1,0,0
vymyslet,6,2,-4,-1,1,0,0
nahrávat,9,2,-7,-1,1,0,0
nahrát,4,4,0,0,-1,0,0
zahájit,6,2,-4,-1,1,0,0
použít,2,6,-4,-1,-1,0,0
stát,4,5,1,1,1,0,0
vyhodit,1,2,-1,-1,-1,0,0
změnit,1,3,-2,-1,-1,0,0
zažalovat,3,5,-2,-1,-1,0,0
uskutečnit,3,6,-3,-1,-1,0,0
cítit,3,2,-1,-1,1,-1,0
mít,1,2,-1,-1,-1,0,0
vyzpívat,6,2,-4,-1,1,0,0
zapojit,2,24,-22,-1,-1,0,0
rozvěsit,5,6,-1,-1,-1,0,0
natáhnout,2,2,0,0,1,0,0
položit,3,2,-1,-1,1,0,0
hledat,2,4,-2,-1,-1,0,0
znamenat,2,4,2,1,1,0,0
doprovázet,2,3,1,1,1,0,0
přivést,2,3,-1,-1,-1,0,0
získat,5,8,-3,-1,-1,0,0
dávat,1,5,-4,-1,-1,0,0
hledat,3,17,-14,-1,-1,0,0
připravit,5,23,-18,-1,-1,0,0
znamenat,1,4,3,1,1,0,0
překonat,4,4,0,0,1,0,0
vychutnat,3,2,1,1,-1,0,0
pouštět,1,2,1,1,1,-1,0
vystrčit,1,2,-1,-1,-1,0,0
zapomenout,1,2,-1,-1,-1,-1,0
předvádět,2,3,-1,-1,-1,0,0
dívat,2,2,0,0,1,0,0
porazit,1,3,2,1,1,0,0
podařit,1,4,3,1,1,0,0
poslat,1,2,-1,-1,-1,0,0
zakřičet,1,3,-2,-1,-1,0,0
atakovat,1,3,-2,-1,-1,0,0
mít,2,5,3,1,1,0,0
mít,1,3,-2,-1,-1,0,0
vrátit,1,2,-1,-1,-1,0,0
mít,1,2,-1,-1,-1,0,0
vrátit,1,5,-4,-1,-1,0,0
vyhrát,2,12,-10,-1,-1,0,0
napadnout,2,4,2,1,1,0,0
obeplout,1,2,1,1,1,0,0
zrekapitulovat,3,3,0,0,1,0,0
mít,2,2,0,0,1,0,0
mít,4,3,-1,-1,1,0,0
udělat,1,2,1,1,1,-1,0
mít,1,4,3,1,1,0,0
mít,3,4,1,1,1,0,0
vadit,9,7,-2,-1,1,0,0
zastavit,3,3,0,0,-1,0,0
mít,4,2,-2,-1,1,0,0
činit,2,4,2,1,1,0,0
vytvořit,1,3,2,1,1,0,0
činit,3,2,-1,-1,1,0,0
překročit,2,4,-2,-1,-1,0,0
přepravit,4,2,-2,-1,1,0,0
vyvézt,7,3,-4,-1,1,0,0
vyplatit,16,3,-13,-1,1,0,0
vyčlenit,3,3,0,0,1,0,0
definovat,2,3,-1,-1,-1,0,0
třímat,2,4,-2,-1,-1,0,0
mít,4,5,1,1,1,0,0
hlásit,3,3,0,0,1,0,0
vykázat,3,3,0,0,1,0,0
poskytnout,2,3,1,1,1,0,0
prodávat,4,5,-1,-1,-1,0,0
porazit,1,11,10,1,1,0,0
vypracovat,6,2,-4,-1,1,0,0
oddělovat,7,6,1,1,-1,0,0
mít,1,3,-2,-1,-1,0,0
prověřit,4,4,0,0,-1,0,0
mít,2,2,0,0,-1,0,0
získat,1,7,-6,-1,-1,0,0
založit,23,3,-20,-1,1,0,0
ukládat,1,4,-3,-1,-1,0,0
porodit,1,3,2,1,1,0,0
vidět,2,9,-7,-1,-1,0,0
přivádět,1,2,-1,-1,-1,0,0
vytrhovat,3,3,0,0,-1,0,0
získat,1,5,-4,-1,-1,0,0
získat,3,3,0,0,-1,0,0
kritizovat,3,4,-1,-1,-1,0,0
mít,25,4,-21,-1,1,0,0
vzít,19,2,-17,-1,1,0,0
vyvolat,5,3,-2,-1,1,0,0
dělat,2,8,-6,-1,-1,0,0
provozovat,5,3,-2,-1,1,0,0
provozovat,2,2,0,0,1,0,0
mít,2,2,0,0,1,0,0
propustit,2,2,0,0,1,0,0
obdržet,3,3,0,0,1,0,0
vyhodit,3,2,1,1,-1,0,0
mít,2,2,0,0,1,0,0
mít,17,2,-15,-1,1,0,0
mlátit,2,2,0,0,-1,0,0
tlouci,1,2,-1,-1,-1,0,0
mít,1,2,-1,-1,-1,0,0
hodit,3,2,-1,-1,1,0,0
mít,7,2,-5,-1,1,0,0
mít,4,2,-2,-1,1,0,0
vést,1,3,-2,-1,-1,0,0
mít,12,2,-10,-1,1,-1,0
podat,1,3,2,1,1,0,0
omezovat,8,4,4,1,-1,0,0
přesunout,2,4,-2,-1,-1,0,0
pomoci,10,2,8,1,-1,0,0
mít,1,3,-2,-1,-1,0,0
korumpovat,5,3,-2,-1,1,0,0
zatknout,9,3,-6,-1,1,0,0
dovést,1,7,-6,-1,-1,0,0
nabízet,6,8,2,1,1,0,0
péci,1,5,-4,-1,-1,-1,0
uříznout,2,4,-2,-1,-1,0,0
ujmout,1,3,-2,-1,-1,0,0
opravovat,5,3,-2,-1,1,0,0
zabít,2,4,2,1,1,0,0
prodloužit,8,19,-11,-1,-1,0,0
označit,8,6,-2,-1,1,0,0
stanovit,6,5,1,1,-1,0,0
změnit,10,3,7,1,-1,0,0
navodit,20,4,16,1,-1,0,0
odmítnout,3,20,-17,-1,-1,0,0
opatřit,6,2,-4,-1,1,-1,0
umožňovat,15,3,-12,-1,1,0,0
zavádět,3,2,-1,-1,1,-1,0
uskutečňovat,3,5,-2,-1,-1,0,0
řešit,2,6,-4,-1,-1,0,0
sjednotit,3,4,-1,-1,-1,0,0
zahájit,21,3,-18,-1,1,0,0
umístit,1,4,-3,-1,-1,0,0
projít,2,2,0,0,1,0,0
opustit,1,3,-2,-1,-1,0,0
umístit,2,5,-3,-1,-1,0,0
stáhnout,6,2,-4,-1,1,0,0
položit,3,3,0,0,-1,0,0
studovat,1,3,2,1,1,0,0
vynést,3,2,-1,-1,1,0,0
sdělit,1,13,-12,-1,-1,0,0
vidět,1,19,-18,-1,-1,-1,0
dodávat,10,2,-8,-1,1,0,0
uvést,13,3,-10,-1,1,0,0
slyšet,1,13,-12,-1,-1,0,0
mít,3,8,-5,-1,-1,0,0
uvést,6,2,-4,-1,1,0,0
dělit,2,7,-5,-1,-1,0,0
vyslechnout,13,2,-11,-1,1,0,0
mít,1,3,2,1,1,0,0
překážet,1,2,-1,-1,-1,-1,0
postavit,1,15,-14,-1,-1,0,0
nabízet,6,4,-2,-1,1,0,0
získat,6,2,-4,-1,1,0,0
umožnit,3,3,0,0,-1,0,0
honit,1,2,-1,-1,-1,-1,0
upravit,1,13,-12,-1,-1,-1,0
zprostředkovat,3,3,0,0,1,0,0
vyrábět,1,8,-7,-1,-1,0,0
nakupovat,2,3,-1,-1,-1,0,0
vykázat,4,5,1,1,1,0,0
poskytovat,2,2,0,0,1,0,0
přenést,9,4,-5,-1,1,0,0
předčit,4,3,-1,-1,1,0,0
slibovat,2,4,-2,-1,-1,0,0
donutit,2,3,1,1,1,0,0
disponovat,2,4,-2,-1,-1,0,0
mít,1,3,2,1,1,0,0
využívat,2,13,-11,-1,-1,0,0
vyzvat,2,19,-17,-1,-1,0,0
pozdravit,7,3,4,1,-1,0,0
zkusit,1,4,-3,-1,-1,0,0
vidět,12,3,-9,-1,1,0,0
rozšířit,9,4,5,1,-1,0,0
vyzvat,5,2,3,1,-1,0,0
tvrdit,2,14,-12,-1,-1,-1,0
dovézt,3,2,1,1,-1,0,0
nabízet,7,5,-2,-1,1,0,0
udržovat,9,3,6,1,-1,0,0
mít,12,2,-10,-1,1,0,0
odložit,1,3,-2,-1,-1,-1,0
používat,6,2,-4,-1,1,0,0
použít,1,3,-2,-1,-1,0,0
testovat,1,3,-2,-1,-1,0,0
zaplatit,2,3,-1,-1,-1,0,0
vysílat,2,4,-2,-1,-1,0,0
vyhodit,1,2,-1,-1,-1,0,0
provádět,6,4,-2,-1,1,0,0
rušit,3,2,-1,-1,1,0,0
zastupovat,2,2,0,0,1,0,0
objednávat,1,7,-6,-1,-1,0,0
vytvořit,2,4,2,1,1,0,0
postavit,1,13,-12,-1,-1,0,0
uvést,3,2,-1,-1,1,0,0
používat,6,4,2,1,-1,0,0
uvést,2,7,-5,-1,-1,0,0
přebírat,4,2,-2,-1,1,0,0
podporovat,2,8,-6,-1,-1,0,0
postavit,6,2,-4,-1,1,-1,0
najít,2,4,-2,-1,-1,0,0
postavit,14,4,-10,-1,1,0,0
prosadit,13,4,-9,-1,1,0,0
prosazovat,5,3,2,1,-1,0,0
mít,10,2,-8,-1,1,0,0
mít,9,2,-7,-1,1,-1,0
strávit,2,4,-2,-1,-1,0,0
vydat,2,10,-8,-1,-1,0,0
mít,3,2,-1,-1,1,0,0
zvýšit,2,4,-2,-1,-1,0,0
hledat,5,14,-9,-1,-1,0,0
sypat,1,3,2,1,1,0,0
vodit,1,2,-1,-1,-1,0,0
vyrábět,2,3,-1,-1,-1,0,0
mít,8,2,-6,-1,1,-1,0
popřít,25,2,-23,-1,1,0,0
udržovat,18,2,-16,-1,1,0,0
dovolovat,1,3,-2,-1,-1,0,0
povolovat,3,5,-2,-1,-1,0,0
prohlásit,1,2,-1,-1,-1,0,0
stáhnout,2,4,-2,-1,-1,0,0
přispěchat,1,2,-1,-1,-1,0,0
způsobit,1,12,-11,-1,-1,0,0
sehrát,1,7,-6,-1,-1,0,0
získávat,11,7,-4,-1,1,0,0
mít,2,19,-17,-1,-1,0,0
uvádět,7,7,0,0,1,0,0
vybrat,7,3,-4,-1,1,0,0
změnit,3,2,1,1,-1,0,0
mít,6,7,1,1,1,0,0
vyslat,4,10,6,1,1,0,0
udržet,2,5,-3,-1,-1,0,0
radikalizovat,9,2,-7,-1,1,0,0
vidět,2,3,-1,-1,-1,0,0
varovat,1,3,-2,-1,-1,0,0
nabízet,2,3,-1,-1,-1,0,0
nabídnout,2,13,-11,-1,-1,0,0
vyprodat,4,2,2,1,-1,0,0
užívat,2,13,-11,-1,-1,0,0
mít,4,2,-2,-1,1,0,0
stát,1,6,5,1,1,0,0
vyvolat,1,3,2,1,1,0,0
zřídit,6,5,1,1,-1,0,0
vložit,3,10,7,1,1,0,0
vypovědět,1,15,-14,-1,-1,-1,0
vést,2,4,2,1,1,0,0
přinést,6,2,-4,-1,1,0,0
utrhnout,1,2,1,1,1,0,0
mít,2,2,0,0,1,-1,0
znamenat,2,3,1,1,1,0,0
dostat,3,4,1,1,1,0,0
vyvolat,2,10,8,1,1,0,0
mít,3,3,0,0,1,0,0
trpět,1,5,-4,-1,-1,0,0
mít,14,3,-11,-1,1,0,0
předvést,1,3,-2,-1,-1,0,0
účtovat,3,8,-5,-1,-1,0,0
platit,8,4,-4,-1,1,0,0
vestavět,3,2,-1,-1,1,0,0
určovat,11,3,-8,-1,1,0,0
hledat,6,2,-4,-1,1,-1,0
sdružovat,1,2,-1,-1,-1,-1,0
provádět,1,2,-1,-1,-1,0,0
zachovat,5,5,0,0,-1,0,0
pouštět,4,2,-2,-1,1,0,0
upřesnit,5,3,-2,-1,1,0,0
porazit,1,3,2,1,1,0,0
vzít,6,2,-4,-1,1,-1,0
nahradit,3,8,5,1,1,0,0
porazit,2,2,0,0,1,0,0
porazit,5,5,0,0,1,0,0
mít,1,4,3,1,1,0,0
kontaktovat,2,6,4,1,1,0,0
hrát,3,2,1,1,-1,0,0
hrát,3,2,1,1,-1,0,0
připravit,8,2,-6,-1,1,0,0
ujmout,1,3,2,1,1,0,0
rozpoutat,1,4,3,1,1,0,0
vytvořit,8,5,-3,-1,1,0,0
zlepšit,2,3,-1,-1,-1,0,0
okusovat,1,4,-3,-1,-1,0,0
odmítnout,3,17,-14,-1,-1,0,0
nahlédnout,1,2,-1,-1,-1,-1,0
okopávat,1,2,1,1,1,0,0
mít,2,2,0,0,1,0,0
získat,2,4,-2,-1,-1,0,0
získat,1,2,-1,-1,-1,0,0
nechat,2,3,-1,-1,-1,0,0
odklízet,1,3,-2,-1,-1,0,0
postavit,7,4,-3,-1,1,0,0
dosáhnout,3,8,5,1,1,0,0
vyzvednout,2,3,-1,-1,-1,0,0
uvést,1,13,-12,-1,-1,-1,0
převádět,3,7,-4,-1,-1,0,0
dočkat,1,5,-4,-1,-1,0,0
zaznamenávat,4,3,1,1,-1,0,0
přinášet,2,2,0,0,1,0,0
oživovat,3,4,-1,-1,-1,0,0
mít,7,3,-4,-1,1,0,0
prodloužit,2,5,-3,-1,-1,0,0
vydat,23,3,-20,-1,1,0,0
zdobit,2,3,-1,-1,-1,0,0
zůstávat,2,4,2,1,1,0,0
zasazovat,2,6,-4,-1,-1,0,0
mít,2,10,-8,-1,-1,0,0
rozříznout,1,2,-1,-1,-1,0,0
zvedat,2,2,0,0,-1,0,0
přilepit,3,2,-1,-1,1,0,0
lákat,1,2,-1,-1,-1,0,0
dosáhnout,1,3,2,1,1,0,0
zřídit,1,3,2,1,1,0,0
dovést,4,10,-6,-1,-1,0,0
mít,1,3,2,1,1,0,0
přivést,1,8,-7,-1,-1,0,0
sledovat,5,2,-3,-1,1,0,0
zhotovit,1,3,2,1,1,0,0
chytnout,3,2,-1,-1,1,0,0
mít,5,3,2,1,-1,0,0
zavést,2,4,2,1,1,0,0
vrhat,2,33,-31,-1,-1,0,0
vyhledávat,2,8,-6,-1,-1,0,0
prodat,3,4,1,1,1,0,0
vytrhovat,7,8,1,1,1,0,0
uplatňovat,2,2,0,0,1,-1,0
považovat,1,3,-2,-1,-1,0,0
mít,3,2,-1,-1,1,0,0
mít,3,4,1,1,1,0,0
udržet,4,2,-2,-1,1,0,0
vsunout,1,4,3,1,1,0,0
zvyšovat,5,3,2,1,-1,0,0
nabízet,2,3,-1,-1,-1,0,0
nechat,1,2,-1,-1,-1,0,0
utrpět,2,2,0,0,1,0,0
mít,2,2,0,0,1,-1,0
založit,3,3,0,0,1,0,0
vynaložit,2,3,1,1,1,0,0
mít,3,2,-1,-1,1,-1,0
vytáhnout,2,4,-2,-1,-1,0,0
vyčlenit,3,4,1,1,1,0,0
čekat,1,2,-1,-1,-1,-1,0
vést,4,2,2,1,-1,0,0
mít,2,2,0,0,1,-1,0
napáchat,2,2,0,0,-1,0,0
realizovat,3,4,1,1,1,0,0
ztrácet,1,7,6,1,1,0,0
ztratit,2,3,1,1,1,0,0
vytvořit,2,2,0,0,1,0,0
zaseknout,2,3,1,1,1,0,0
připsat,18,3,-15,-1,1,0,0
zaplatit,5,7,2,1,1,0,0
platit,5,2,3,1,-1,0,0
koupit,7,5,2,1,-1,0,0
svolávat,1,4,-3,-1,-1,0,0
přiložit,1,2,-1,-1,-1,0,0
mít,12,2,-10,-1,1,0,0
zjistit,11,3,-8,-1,1,0,0
mít,3,2,-1,-1,1,0,0
považovat,8,2,6,1,-1,0,0
vyjádřit,13,3,-10,-1,1,0,0
přiznat,4,10,-6,-1,-1,0,0
postavit,2,8,-6,-1,-1,0,0
tolerovat,1,3,-2,-1,-1,0,0
uvést,4,2,-2,-1,1,0,0
uvolnit,3,3,0,0,-1,0,0
odpouštět,2,13,-11,-1,-1,0,0
projevit,2,2,0,0,1,0,0
propustit,2,2,0,0,1,0,0
projevovat,13,2,-11,-1,1,0,0
obhájit,9,5,-4,-1,1,0,0
zamítnout,2,11,-9,-1,-1,0,0
dosáhnout,3,6,-3,-1,-1,0,0
zaznamenat,2,3,1,1,1,0,0
pořádat,7,3,-4,-1,1,0,0
činit,2,2,0,0,1,0,0
poskytovat,20,5,-15,-1,1,0,0
obdržet,8,5,-3,-1,1,0,0
oznámit,1,2,-1,-1,-1,0,0
uhradit,2,2,0,0,-1,0,0
zlomit,2,4,2,1,1,0,0
natočit,2,4,-2,-1,-1,0,0
vytáhnout,1,2,1,1,1,0,0
ovlivňovat,5,10,-5,-1,-1,0,0
doplatit,1,6,-5,-1,-1,0,0
stáhnout,2,9,-7,-1,-1,0,0
mít,2,2,0,0,-1,0,0
předběhnout,2,2,0,0,1,0,0
minout,1,3,-2,-1,-1,0,0
mít,3,3,0,0,1,0,0
porazit,4,4,0,0,1,0,0
získat,2,3,1,1,1,0,0
zahájit,2,2,0,0,-1,0,0
porazit,2,3,1,1,1,0,0
držet,2,6,-4,-1,-1,0,0
posílit,3,4,1,1,1,0,0
uvolnit,1,6,-5,-1,-1,0,0
uvolnit,2,4,-2,-1,-1,0,0
hrát,2,3,-1,-1,-1,0,0
soudit,1,3,-2,-1,-1,-1,0
stát,2,4,-2,-1,-1,0,0
najít,2,5,-3,-1,-1,0,0
bagatelizovat,2,6,-4,-1,-1,0,0
sjednocovat,2,22,-20,-1,-1,0,0
přenést,3,3,0,0,-1,0,0
ovládnout,1,8,-7,-1,-1,0,0
uvést,8,3,-5,-1,1,0,0
kompilovat,1,6,-5,-1,-1,0,0
mít,7,4,-3,-1,1,0,0
získat,1,4,-3,-1,-1,0,0
stát,5,5,0,0,-1,0,0
potkat,1,2,-1,-1,-1,-1,0
najít,1,3,-2,-1,-1,0,0
uplatnit,4,9,-5,-1,-1,0,0
přivézt,14,4,-10,-1,1,0,0
pořádat,4,2,2,1,-1,0,0
zařadit,1,18,-17,-1,-1,-1,0
uspořádat,4,2,-2,-1,1,0,0
uvést,11,2,-9,-1,1,0,0
pořádat,6,2,-4,-1,1,0,0
uvádět,4,3,-1,-1,1,0,0
vytvářet,6,3,-3,-1,1,0,0
připravovat,2,4,2,1,1,0,0
pozastavit,5,2,-3,-1,1,0,0
dodávat,5,3,-2,-1,1,0,0
vyčistit,1,3,-2,-1,-1,0,0
postřílet,4,2,-2,-1,1,0,0
vyslat,5,3,2,1,-1,0,0
oslavit,2,3,1,1,1,0,0
usmrtit,5,7,-2,-1,-1,0,0
prohlásit,1,3,-2,-1,-1,0,0
omezovat,3,13,-10,-1,-1,0,0
naladit,1,3,-2,-1,-1,-1,0
líbit,3,3,0,0,-1,0,0
mít,4,4,0,0,1,0,0
ztratit,3,3,0,0,1,0,0
mít,1,2,1,1,1,-1,0
najít,2,4,-2,-1,-1,0,0
ovlivnit,5,7,-2,-1,-1,0,0
protlačit,3,4,1,1,1,0,0
vrátit,1,2,-1,-1,-1,0,0
spatřit,6,3,-3,-1,1,0,0
vyvíjet,1,3,-2,-1,-1,0,0
mít,2,3,1,1,1,0,0
odvolat,2,7,-5,-1,-1,0,0
posílat,1,2,-1,-1,-1,0,0
mít,4,3,-1,-1,1,0,0
vytvořit,1,6,-5,-1,-1,0,0
mít,1,2,-1,-1,-1,0,0
mít,9,2,-7,-1,1,0,0
zaplatit,2,5,-3,-1,-1,0,0
vyrobit,7,3,-4,-1,1,0,0
upisovat,1,3,2,1,1,0,0
získat,1,4,-3,-1,-1,0,0
omezit,2,4,-2,-1,-1,0,0
poslat,1,2,-1,-1,-1,-1,0
nacházet,2,15,-13,-1,-1,0,0
vypít,2,3,-1,-1,-1,0,0
milovat,1,3,-2,-1,-1,-1,0
přinášet,2,4,2,1,1,0,0
mít,2,3,1,1,1,0,0
srážet,2,2,0,0,-1,0,0
vyzvat,3,6,-3,-1,-1,0,0
udělat,1,7,-6,-1,-1,0,0
zintenzívnit,4,4,0,0,-1,0,0
vést,1,6,-5,-1,-1,0,0
dozvědět,17,3,-14,-1,1,1,0
lapit,1,2,-1,-1,-1,0,0
říkat,3,4,-1,-1,-1,0,0
udržet,13,3,-10,-1,1,0,0
dostat,12,2,-10,-1,1,0,0
vymoci,4,2,-2,-1,1,0,0
hrát,5,2,-3,-1,1,0,0
zachovat,4,2,-2,-1,1,-1,0
zpracovávat,1,6,-5,-1,-1,0,0
provzdušňovat,1,2,-1,-1,-1,-1,0
transplantovat,2,2,0,0,-1,0,0
zůstat,4,3,-1,-1,1,0,0
zrevidovat,5,2,-3,-1,1,-1,0
reprezentovat,1,5,-4,-1,-1,0,0
zaujmout,8,2,-6,-1,1,-1,0
mít,6,2,-4,-1,1,0,0
použít,2,4,-2,-1,-1,0,0
mít,2,3,-1,-1,-1,0,0
navazovat,2,2,0,0,1,-1,0
tvořit,2,3,-1,-1,-1,0,0
mít,1,3,-2,-1,-1,1,0
vyžadovat,2,3,1,1,1,0,0
dávat,2,2,0,0,-1,0,0
vystavovat,1,2,-1,-1,-1,-1,0
mít,5,2,-3,-1,1,0,0
mít,5,2,-3,-1,1,0,0
mít,7,2,-5,-1,1,0,0
hrát,2,2,0,0,-1,0,0
zavinit,8,4,-4,-1,1,0,0
uvidět,60,2,-58,-1,1,0,0
změřit,1,20,-19,-1,-1,0,0
získat,8,3,-5,-1,1,0,0
vybojovat,1,5,-4,-1,-1,0,0
nést,2,3,1,1,1,0,0
vyhrát,2,6,-4,-1,-1,0,0
zkusit,1,3,-2,-1,-1,0,0
utrpět,5,2,-3,-1,1,0,0
začít,5,2,-3,-1,1,0,0
imponovat,12,2,-10,-1,1,0,0
zvýšit,2,3,-1,-1,-1,0,0
připustit,2,3,1,1,1,0,0
zůstávat,1,6,-5,-1,-1,0,0
nakupovat,2,2,0,0,1,0,0
vyvážet,1,2,-1,-1,-1,-1,0
chopit,1,4,3,1,1,0,0
extrahovat,3,7,-4,-1,-1,0,0
poskytovat,1,4,-3,-1,-1,0,0
přilákat,2,2,0,0,1,0,0
udržet,1,2,-1,-1,-1,-1,0
mít,5,10,5,1,1,0,0
udržet,2,2,0,0,-1,0,0
dosahovat,2,3,-1,-1,-1,0,0
mít,9,2,-7,-1,1,0,0
dosáhnout,5,8,-3,-1,-1,0,0
dostat,2,3,-1,-1,-1,0,0
držet,1,2,-1,-1,-1,0,0
přivést,2,9,-7,-1,-1,0,0
vystřídat,2,2,0,0,1,0,0
poškozovat,5,2,-3,-1,1,0,0
dopravit,2,2,0,0,-1,0,0
dovézt,3,3,0,0,1,0,0
stát,2,4,-2,-1,-1,0,0
mít,4,3,-1,-1,1,0,0
dostávat,6,2,-4,-1,1,0,0
brát,1,2,-1,-1,-1,0,0
prodloužit,4,4,0,0,-1,0,0
mít,4,3,1,1,-1,0,0
mít,2,8,-6,-1,-1,0,0
předkládat,2,19,-17,-1,-1,0,0
mít,5,2,-3,-1,1,-1,0
sklidit,5,9,-4,-1,-1,0,0
dosáhnout,8,3,-5,-1,1,0,0
mít,3,2,-1,-1,1,-1,0
překonat,4,6,2,1,1,0,0
hledat,2,4,-2,-1,-1,0,0
pokrývat,3,3,0,0,-1,0,0
podporovat,3,15,-12,-1,-1,0,0
vykonávat,2,8,-6,-1,-1,0,0
mít,2,3,1,1,1,0,0
mít,23,2,-21,-1,1,0,0
vyslechnout,3,3,0,0,1,0,0
mít,18,2,-16,-1,1,0,0
ztratit,2,10,-8,-1,-1,0,0
absolvovat,2,6,-4,-1,-1,0,0
splnit,1,5,-4,-1,-1,0,0
mít,9,2,-7,-1,1,0,0
nominovat,3,7,4,1,1,0,0
mít,2,4,-2,-1,-1,0,0
otevřít,4,3,1,1,-1,0,0
obsadit,8,5,-3,-1,1,0,0
stát,4,2,-2,-1,1,-1,0
angažovat,14,3,-11,-1,1,0,0
odstranit,1,3,-2,-1,-1,0,0
složit,3,2,-1,-1,1,0,0
hrát,2,7,-5,-1,-1,0,0
dostat,5,4,-1,-1,1,0,0
vyjít,1,2,-1,-1,-1,-1,0
vyhodit,1,6,-5,-1,-1,0,0
dostat,2,2,0,0,-1,0,0
mít,2,3,1,1,1,0,0
znamenat,3,7,4,1,1,0,0
překonat,7,3,4,1,-1,0,0
střídat,13,3,-10,-1,1,0,0
vyhrát,3,7,-4,-1,-1,0,0
mít,2,3,1,1,1,0,0
zaplavat,3,4,-1,-1,-1,0,0
trávit,1,3,-2,-1,-1,0,0
obsadit,12,3,-9,-1,1,0,0
doložit,1,23,-22,-1,-1,0,0
získat,2,12,-10,-1,-1,0,0
ozářit,1,11,-10,-1,-1,0,0
sklidit,3,6,3,1,1,0,0
očekávat,2,8,-6,-1,-1,0,0
krást,2,7,-5,-1,-1,0,0
bombardovat,7,3,-4,-1,1,0,0
vytvořit,6,3,-3,-1,1,0,0
mít,6,2,-4,-1,1,0,0
mít,5,2,-3,-1,1,-1,0
kritizovat,7,4,3,1,-1,0,0
vybudovat,2,18,-16,-1,-1,0,0
zaručit,3,6,-3,-1,-1,0,0
vypustit,4,2,2,1,-1,0,0
udělat,2,4,-2,-1,-1,0,0
zvyšovat,1,7,-6,-1,-1,0,0
mít,7,3,-4,-1,1,0,0
naladit,2,3,-1,-1,-1,0,0
zkoncentrovat,2,3,-1,-1,-1,1,0
mít,2,4,-2,-1,-1,0,0
říci,1,5,-4,-1,-1,0,0
hledat,2,6,-4,-1,-1,0,0
nést,4,2,-2,-1,1,0,0
nalézat,2,3,1,1,1,0,0
převzít,1,2,1,1,1,0,0
porazit,5,4,1,1,-1,0,0
tlačit,2,3,-1,-1,-1,0,0
ovlivnit,2,15,-13,-1,-1,0,0
postrádat,16,15,-1,-1,1,0,0
podávat,1,3,-2,-1,-1,0,0
hledat,1,2,-1,-1,-1,0,0
podporovat,3,4,-1,-1,-1,0,0
mít,20,3,-17,-1,1,0,0
mít,2,2,0,0,1,0,0
považovat,2,3,-1,-1,-1,0,0
udržovat,1,2,-1,-1,-1,0,0
smontovat,5,4,-1,-1,1,0,0
způsobit,2,9,-7,-1,-1,0,0
mít,3,3,0,0,-1,0,0
mít,2,4,-2,-1,-1,0,0
zdvojnásobit,2,5,-3,-1,-1,0,0
nechávat,2,3,-1,-1,-1,0,0
dovézt,7,3,-4,-1,1,0,0
mít,3,2,-1,-1,1,0,0
zaměstnávat,4,2,-2,-1,1,0,0
mít,2,6,-4,-1,-1,0,0
vyřizovat,5,2,-3,-1,1,0,0
zajistit,15,3,-12,-1,1,0,0
nabízet,2,11,-9,-1,-1,0,0
přijít,1,3,-2,-1,-1,0,0
dosáhnout,3,3,0,0,1,0,0
přepravit,2,5,3,1,1,0,0
uvést,7,8,-1,-1,-1,0,0
vyčlenit,12,2,-10,-1,1,0,0
skrývat,3,2,1,1,-1,0,0
zůstávat,5,6,-1,-1,-1,0,0
povraždit,3,3,0,0,-1,0,0
spojit,2,2,0,0,-1,0,0
dostat,5,3,2,1,-1,0,0
vyzývat,1,12,-11,-1,-1,0,0
mít,6,2,-4,-1,1,0,0
strávit,2,2,0,0,-1,0,0
vypovědět,1,6,-5,-1,-1,0,0
shánět,3,2,-1,-1,1,0,0
urazit,16,5,-11,-1,1,0,0
rozehrát,1,6,-5,-1,-1,0,0
představovat,6,5,1,1,-1,0,0
vytvořit,1,9,-8,-1,-1,0,0
dát,2,2,0,0,1,0,0
vyměnit,3,3,0,0,-1,0,0
zaznamenat,2,3,1,1,1,0,0
dosáhnout,2,4,-2,-1,-1,0,0
zaznamenat,3,6,-3,-1,-1,0,0
pomoci,2,8,-6,-1,-1,0,0
doprovázet,1,10,-9,-1,-1,0,0
mít,3,4,1,1,1,0,0
zúčastnit,2,4,-2,-1,-1,0,0
mít,1,3,2,1,1,0,0
běžet,1,4,-3,-1,-1,0,0
dát,2,2,0,0,-1,0,0
změnit,3,3,0,0,-1,0,0
vkládat,21,2,-19,-1,1,-1,0
dávat,2,2,0,0,1,0,0
dohrávat,3,2,1,1,-1,0,0
mít,4,2,-2,-1,1,-1,0
budit,1,10,-9,-1,-1,0,0
získat,2,3,1,1,1,0,0
zůstat,5,3,-2,-1,1,0,0
mít,2,3,-1,-1,-1,0,0
stát,3,3,0,0,-1,0,0
přidávat,4,2,-2,-1,1,0,0
uspořádat,7,4,-3,-1,1,0,0
vyvolat,3,9,-6,-1,-1,0,0
vidět,2,3,-1,-1,-1,0,0
uvádět,1,2,1,1,1,0,0
odpracovat,2,2,0,0,1,-1,0
mít,2,3,1,1,1,0,0
být,1,2,-1,-1,-1,-1,0
strávit,4,10,-6,-1,-1,0,0
dosáhnout,1,2,1,1,1,0,0
mít,2,2,0,0,1,0,0
stát,2,2,0,0,1,0,0
postavit,9,4,-5,-1,1,0,0
udělat,1,3,-2,-1,-1,-1,0
zveřejňovat,1,2,-1,-1,-1,-1,0
zažít,1,5,-4,-1,-1,0,0
mít,6,2,-4,-1,1,0,0
prožívat,2,4,-2,-1,-1,0,0
pronést,2,2,0,0,1,0,0
dělat,1,2,-1,-1,-1,0,0
získat,4,2,-2,-1,1,0,0
čerpat,2,2,0,0,1,-1,0
znamenat,38,5,-33,-1,1,0,0
odhodit,1,3,-2,-1,-1,0,0
přinést,2,4,2,1,1,0,0
avizovat,2,11,9,1,1,0,0
stát,4,3,-1,-1,1,0,0
čekat,1,4,-3,-1,-1,0,0
zařadit,1,3,-2,-1,-1,0,0
mít,1,2,1,1,1,0,0
dát,8,5,-3,-1,1,0,0
přijímat,1,2,1,1,1,-1,0
získat,2,2,0,0,1,0,0
realizovat,7,2,-5,-1,1,0,0
vyzvat,3,7,-4,-1,-1,0,0
uvést,1,14,-13,-1,-1,0,0
dobývat,1,3,-2,-1,-1,0,0
zrušit,11,3,-8,-1,1,0,0
udržet,8,4,-4,-1,1,0,0
blokovat,3,3,0,0,1,0,0
vlastnit,6,4,-2,-1,1,0,0
vypustit,3,2,-1,-1,1,0,0
odvrátit,1,6,-5,-1,-1,0,0
stát,16,2,-14,-1,1,-1,0
udržet,4,3,1,1,-1,0,0
dát,1,2,1,1,1,0,0
soustřeďovat,1,8,-7,-1,-1,-1,0
zvát,3,2,1,1,-1,0,0
nabídnout,5,3,-2,-1,1,0,0
vyzvat,13,5,-8,-1,1,0,0
opustit,1,2,1,1,1,0,0
vyjádřit,2,2,0,0,1,0,0
předat,9,11,-2,-1,-1,0,0
zavést,4,4,0,0,-1,0,0
zaplatit,6,3,-3,-1,1,0,0
zvýšit,3,3,0,0,-1,0,0
platit,2,2,0,0,1,0,0
dostat,2,7,-5,-1,-1,0,0
dát,1,3,2,1,1,0,0
používat,3,2,-1,-1,1,0,0
odkoupit,6,4,-2,-1,1,0,0
mít,11,2,-9,-1,1,0,0
vědět,8,4,-4,-1,1,0,0
očekávat,2,10,8,1,1,0,0
mít,5,4,-1,-1,1,0,0
vyřizovat,4,4,0,0,1,0,0
přečerpat,3,3,0,0,1,0,0
vést,3,9,-6,-1,-1,0,0
vést,9,4,5,1,-1,0,0
odhadnout,3,4,-1,-1,-1,0,0
provést,4,3,1,1,-1,0,0
mít,2,2,0,0,1,0,0
porušovat,1,3,-2,-1,-1,0,0
používat,2,8,6,1,1,0,0
získat,8,5,-3,-1,1,0,0
mít,5,2,3,1,-1,0,0
změnit,2,2,0,0,-1,0,0
ušetřit,5,2,-3,-1,1,0,0
dosáhnout,2,2,0,0,1,0,0
rozšířit,4,3,1,1,-1,0,0
předpovídat,6,3,-3,-1,1,0,0
dosáhnout,8,3,-5,-1,1,0,0
uskutečnit,1,5,-4,-1,-1,0,0
analyzovat,7,3,4,1,-1,0,0
vést,2,9,-7,-1,-1,0,0
představovat,2,3,1,1,1,0,0
převýšit,2,4,-2,-1,-1,0,0
využít,2,5,-3,-1,-1,0,0
přijmout,5,2,-3,-1,1,-1,0
ponechat,8,2,6,1,-1,0,0
najít,5,2,-3,-1,1,-1,0
napravit,2,3,1,1,1,0,0
disponovat,6,2,-4,-1,1,0,0
vydělat,8,2,-6,-1,1,0,0
požadovat,5,11,6,1,1,0,0
řídit,2,5,3,1,1,0,0
zaplatit,1,3,-2,-1,-1,0,0
zaplatit,3,2,-1,-1,1,0,0
využívat,31,5,-26,-1,1,0,0
udržet,2,2,0,0,1,0,0
povést,5,8,-3,-1,-1,0,0
vybírat,4,3,-1,-1,1,0,0
vstřelit,3,4,1,1,1,0,0
poznat,2,3,1,1,1,0,0
dosvědčovat,4,3,1,1,-1,0,0
ochránit,3,2,-1,-1,1,0,0
dosáhnout,2,2,0,0,1,0,0
vydělat,2,2,0,0,1,0,0
brát,14,2,-12,-1,1,0,0
činit,2,2,0,0,1,0,0
připsat,2,3,1,1,1,0,0
sledovat,1,2,-1,-1,-1,-1,0
řešit,4,8,-4,-1,-1,0,0
potrestat,2,16,-14,-1,-1,0,0
uvolnit,3,2,-1,-1,1,0,0
srovnat,1,4,-3,-1,-1,0,0
přimáčknout,1,3,-2,-1,-1,0,0
využít,3,3,0,0,1,0,0
dát,1,2,1,1,1,-1,0
strhnout,1,3,-2,-1,-1,0,0
vstřelit,2,3,1,1,1,0,0
propustit,9,5,-4,-1,1,0,0
získat,8,4,-4,-1,1,0,0
řídit,5,4,1,1,-1,0,0
uspokojit,4,4,0,0,-1,0,0
iniciovat,6,8,2,1,1,0,0
vystavovat,2,3,-1,-1,-1,0,0
představovat,2,9,-7,-1,-1,0,0
zpracovat,4,4,0,0,-1,0,0
vyslovit,13,10,-3,-1,1,0,0
ovládnout,3,3,0,0,1,0,0
zneužívat,2,17,-15,-1,-1,0,0
najít,1,3,-2,-1,-1,0,0
nacházet,2,3,1,1,1,0,0
sjednat,3,3,0,0,1,0,0
vybrat,3,2,-1,-1,1,0,0
stát,6,3,-3,-1,1,0,0
vytrhnout,3,2,1,1,-1,0,0
vyhlásit,3,2,-1,-1,1,0,0
přizvat,14,2,-12,-1,1,-1,0
uvést,5,2,-3,-1,1,0,0
odvést,1,3,-2,-1,-1,0,0
získat,1,3,2,1,1,0,0
obléci,2,2,0,0,1,0,0
zadržet,17,2,-15,-1,1,0,0
vrátit,1,2,-1,-1,-1,0,0
dostat,6,2,-4,-1,1,0,0
spatřit,6,3,-3,-1,1,0,0
pěstovat,1,3,-2,-1,-1,0,0
získat,1,5,-4,-1,-1,0,0
najít,1,10,-9,-1,-1,0,0
považovat,2,2,0,0,-1,0,0
přednést,2,6,-4,-1,-1,0,0
tvořit,1,3,2,1,1,0,0
stát,3,7,4,1,1,0,0
dostat,31,5,-26,-1,1,0,0
mít,7,5,-2,-1,1,-1,0
vylosovat,6,3,-3,-1,1,0,0
mít,7,2,-5,-1,1,-1,0
mít,3,4,1,1,1,0,0
snížit,3,3,0,0,-1,0,0
mít,2,3,1,1,1,0,0
platit,2,4,-2,-1,-1,0,0
přinést,9,3,-6,-1,1,0,0
zablokovat,6,3,-3,-1,1,0,0
mít,1,4,-3,-1,-1,0,0
stát,3,2,-1,-1,1,0,0
měnit,1,4,-3,-1,-1,0,0
podat,2,3,-1,-1,-1,0,0
připisovat,5,3,-2,-1,1,0,0
zaznamenat,6,3,-3,-1,1,0,0
použít,2,4,2,1,1,0,0
uvést,1,2,-1,-1,-1,0,0
mít,5,2,-3,-1,1,0,0
převyšovat,2,3,-1,-1,-1,0,0
oznámit,1,2,-1,-1,-1,0,0
vyrábět,1,3,-2,-1,-1,0,0
činit,4,3,-1,-1,1,0,0
vybudovat,6,3,-3,-1,1,0,0
mít,13,2,-11,-1,1,0,0
prodávat,3,8,-5,-1,-1,0,0
nabízet,5,12,-7,-1,-1,0,0
uzavřít,2,18,-16,-1,-1,0,0
znamenat,4,3,-1,-1,1,0,0
překročit,3,8,5,1,1,0,0
mít,17,2,-15,-1,1,-1,0
získat,3,6,3,1,1,0,0
vypsat,13,3,-10,-1,1,0,0
dosáhnout,3,3,0,0,1,0,0
zvýšit,1,4,-3,-1,-1,0,0
započítávat,6,3,3,1,-1,0,0
zvýšit,7,2,-5,-1,1,0,0
nabízet,5,3,2,1,-1,0,0
dosáhnout,3,3,0,0,1,0,0
využít,1,6,-5,-1,-1,0,0
založit,2,3,-1,-1,-1,0,0
hlídat,1,2,-1,-1,-1,0,0
přivést,1,3,-2,-1,-1,0,0
odvézt,1,2,-1,-1,-1,0,0
uhrát,2,2,0,0,1,0,0
mít,1,2,1,1,1,0,0
chtít,1,3,-2,-1,-1,0,0
srovnat,1,3,-2,-1,-1,0,0
vzdát,9,5,4,1,-1,0,0
podrobit,2,2,0,0,1,0,0
připravit,4,10,-6,-1,-1,0,0
stát,2,4,-2,-1,-1,0,0
zastupovat,2,4,-2,-1,-1,0,0
zastupovat,1,4,-3,-1,-1,0,0
najít,2,2,0,0,-1,0,0
podepsat,4,4,0,0,-1,0,0
uvolnit,2,7,-5,-1,-1,0,0
mít,3,4,1,1,1,0,0
řadit,1,2,-1,-1,-1,0,0
prožívat,1,13,-12,-1,-1,0,0
obdržet,4,2,-2,-1,1,0,0
přesahovat,2,2,0,0,1,0,0
dotovat,1,3,-2,-1,-1,0,0
patřit,10,2,-8,-1,1,0,0
provést,6,5,-1,-1,1,0,0
uvést,13,4,-9,-1,1,0,0
zveřejnit,15,2,-13,-1,1,0,0
odvolat,3,2,-1,-1,1,0,0
vyvíjet,2,3,1,1,1,0,0
mít,5,9,4,1,1,0,0
vyslat,2,10,-8,-1,-1,0,0
připravovat,7,3,-4,-1,1,0,0
zahájit,18,4,-14,-1,1,0,0
propustit,9,3,-6,-1,1,0,0
hodnotit,5,4,1,1,-1,0,0
mít,6,3,-3,-1,1,0,0
vyvíjet,2,3,1,1,1,0,0
zpracovat,1,3,-2,-1,-1,0,0
nasadit,3,4,1,1,1,0,0
vybrat,2,2,0,0,1,0,0
zkoumat,7,3,-4,-1,1,0,0
probírat,3,7,-4,-1,-1,0,0
získávat,1,4,-3,-1,-1,0,0
docílit,5,3,-2,-1,1,0,0
doporučit,16,2,-14,-1,1,0,0
mít,1,3,2,1,1,0,0
doporučit,24,2,-22,-1,1,0,0
ustavit,17,6,-11,-1,1,0,0
připravit,6,7,-1,-1,-1,0,0
zaměstnávat,3,3,0,0,1,0,0
dostávat,5,3,2,1,-1,0,0
připravovat,10,3,-7,-1,1,0,0
stavět,1,3,-2,-1,-1,0,0
soustředit,4,3,1,1,-1,0,0
mít,8,3,-5,-1,1,0,0
pomoci,3,3,0,0,-1,0,0
mít,1,6,-5,-1,-1,0,0
zaplatit,4,2,-2,-1,1,0,0
posunout,2,3,-1,-1,-1,0,0
obsahovat,13,5,-8,-1,1,0,0
vyčlenit,3,2,-1,-1,1,0,0
zaznamenat,5,6,1,1,1,0,0
spravovat,5,3,-2,-1,1,0,0
provozovat,3,5,-2,-1,-1,0,0
určovat,3,3,0,0,-1,0,0
vyvolat,4,3,1,1,-1,0,0
převzít,4,3,-1,-1,1,0,0
vydat,8,8,0,0,1,0,0
spatřovat,3,3,0,0,1,0,0
uzavřít,1,2,1,1,1,0,0
uzavřít,2,2,0,0,1,0,0
vyvážet,4,2,-2,-1,1,0,0
vyvézt,6,5,-1,-1,1,0,0
dosáhnout,6,5,-1,-1,1,0,0
nalézt,1,3,-2,-1,-1,0,0
nabízet,6,4,2,1,-1,0,0
přečerpat,2,6,-4,-1,-1,0,0
zavádět,7,3,-4,-1,1,0,0
přečerpat,4,20,-16,-1,-1,0,0
mít,5,4,-1,-1,1,0,0
přečerpat,1,5,-4,-1,-1,0,0
nabízet,9,6,-3,-1,1,0,0
zajišťovat,2,2,0,0,1,0,0
nacházet,3,3,0,0,1,0,0
vypracovat,5,3,-2,-1,1,0,0
organizovat,3,2,-1,-1,1,0,0
získat,3,2,-1,-1,1,0,0
mít,3,2,-1,-1,1,0,0
rozšířit,4,4,0,0,-1,0,0
hnát,2,2,0,0,-1,0,0
potřebovat,3,5,2,1,1,0,0
vyhrát,5,2,-3,-1,1,0,0
udržet,1,4,-3,-1,-1,-1,0
vybojovat,1,3,2,1,1,0,0
poslat,8,6,-2,-1,1,0,0
vybrat,12,2,-10,-1,1,-1,0
vyslat,3,2,-1,-1,1,0,0
stát,4,9,5,1,1,0,0
mít,6,5,-1,-1,1,0,0
získat,5,6,-1,-1,-1,0,0
působit,1,2,-1,-1,-1,0,0
překonat,3,6,-3,-1,-1,0,0
mít,4,2,-2,-1,1,0,0
zlomit,1,10,9,1,1,0,0
spočítat,5,3,2,1,-1,0,0
využít,3,5,-2,-1,-1,0,0
rozdělit,1,4,-3,-1,-1,0,0
zříkat,2,3,-1,-1,-1,0,0
zasílat,7,3,-4,-1,1,0,0
přiznat,2,6,-4,-1,-1,0,0
odmítnout,2,2,0,0,-1,0,0
mít,5,2,-3,-1,1,0,0
odrážet,6,11,-5,-1,-1,0,0
podat,3,9,-6,-1,-1,0,0
využít,3,3,0,0,-1,0,0
prozradit,4,4,0,0,-1,0,0
vyjádřit,15,2,-13,-1,1,-1,0
přidávat,13,2,-11,-1,1,-1,0
ztvárnit,3,7,-4,-1,-1,0,0
zahájit,7,5,-2,-1,1,0,0
udělat,1,5,-4,-1,-1,0,0
mít,2,4,-2,-1,-1,0,0
rozpoutat,2,2,0,0,-1,0,0
přinášet,10,3,-7,-1,1,0,0
přidat,7,3,-4,-1,1,-1,0
brát,1,2,1,1,1,0,0
mít,2,2,0,0,-1,0,0
hodnotit,6,4,2,1,-1,0,0
mít,2,4,2,1,1,0,0
mít,2,2,0,0,1,-1,0
mít,2,2,0,0,1,-1,0
vzít,4,4,0,0,1,0,0
připojit,2,2,0,0,-1,0,0
posílat,2,2,0,0,-1,0,0
vytáhnout,3,2,-1,-1,1,0,0
ukončit,1,3,-2,-1,-1,0,0
klást,20,4,-16,-1,1,0,0
mít,2,2,0,0,1,0,0
vepsat,2,12,-10,-1,-1,0,0
přivést,2,12,-10,-1,-1,0,0
mít,11,2,-9,-1,1,0,0
prohlásit,3,3,0,0,1,0,0
oslavovat,6,3,-3,-1,1,0,0
vnímat,2,3,-1,-1,-1,0,0
vyžadovat,1,10,-9,-1,-1,0,0
tvořit,2,4,2,1,1,0,0
změnit,1,11,-10,-1,-1,-1,0
zpochybnit,3,2,-1,-1,1,0,0
vrhat,1,8,-7,-1,-1,0,0
využívat,2,4,-2,-1,-1,0,0
zaujmout,1,4,-3,-1,-1,0,0
najít,5,2,-3,-1,1,-1,0
navštívit,5,3,-2,-1,1,0,0
vyžádat,2,4,2,1,1,0,0
moci,2,3,-1,-1,-1,0,0
rozšířit,7,4,3,1,-1,0,0
malovat,11,7,-4,-1,1,0,0
odsunout,3,2,1,1,-1,0,0
uvádět,1,3,-2,-1,-1,0,0
vybrat,2,2,0,0,-1,-1,0
říkat,1,8,-7,-1,-1,0,0
slibovat,4,4,0,0,1,0,0
propouštět,6,9,-3,-1,-1,0,0
odsoudit,2,5,-3,-1,-1,0,0
zvýšit,2,2,0,0,-1,0,0
vylákat,7,7,0,0,1,0,0
vidět,3,17,-14,-1,-1,0,0
mít,1,2,-1,-1,-1,-1,0
zvát,1,4,-3,-1,-1,-1,0
zaplatit,18,3,-15,-1,1,0,0
mít,2,6,-4,-1,-1,0,0
zaznamenat,2,8,-6,-1,-1,0,0
přinést,8,2,6,1,-1,0,0
vysvětlovat,4,3,1,1,-1,0,0
dát,2,2,0,0,1,0,0
balit,1,2,1,1,1,0,0
mít,9,2,-7,-1,1,0,0
inzerovat,1,4,-3,-1,-1,0,0
zaplatit,4,5,1,1,1,0,0
peskovat,3,16,-13,-1,-1,0,0
získat,6,4,-2,-1,1,0,0
registrovat,12,5,-7,-1,1,0,0
postavit,5,2,-3,-1,1,0,0
mít,4,3,-1,-1,1,0,0
mít,1,3,-2,-1,-1,0,0
vyřešit,2,2,0,0,1,0,0
pomáhat,4,9,-5,-1,-1,0,0
stát,8,4,-4,-1,1,0,0
stanovovat,10,5,-5,-1,1,0,0
vyznačit,4,3,-1,-1,1,0,0
představovat,5,3,-2,-1,1,0,0
těšit,2,6,-4,-1,-1,0,0
zabezpečovat,1,8,-7,-1,-1,0,0
odkoupit,7,4,-3,-1,1,0,0
zabezpečovat,1,12,-11,-1,-1,0,0
zůstávat,1,4,3,1,1,0,0
činit,2,4,2,1,1,0,0
uschovat,2,7,-5,-1,-1,0,0
porovnávat,2,5,-3,-1,-1,0,0
mít,2,3,-1,-1,-1,0,0
zaplatit,2,2,0,0,1,0,0
mít,1,16,-15,-1,-1,0,0
otevřít,6,9,3,1,1,0,0
uložit,3,14,-11,-1,-1,0,0
vlastnit,10,5,-5,-1,1,0,0
vyhledat,4,2,-2,-1,1,0,0
snímat,1,2,1,1,1,0,0
vzbuzovat,1,3,2,1,1,0,0
zaplatit,5,3,-2,-1,1,0,0
zaplatit,1,3,-2,-1,-1,0,0
činit,3,3,0,0,1,0,0
činit,14,3,-11,-1,1,0,0
schválit,17,2,-15,-1,1,0,0
tvořit,1,3,-2,-1,-1,0,0
zahájit,25,2,-23,-1,1,0,0
podařit,3,3,0,0,-1,0,0
oceňovat,2,7,-5,-1,-1,0,0
zpívat,1,5,-4,-1,-1,0,0
učit,1,4,-3,-1,-1,0,0
mít,2,2,0,0,1,0,0
představovat,1,2,-1,-1,-1,0,0
rekonstruovat,2,6,-4,-1,-1,0,0
vtiskovat,3,2,-1,-1,1,-1,0
najít,60,2,-58,-1,1,-1,0
zůstat,1,4,-3,-1,-1,-1,0
odporovat,1,5,-4,-1,-1,0,0
dodržovat,3,6,-3,-1,-1,0,0
reprezentovat,2,7,-5,-1,-1,0,0
najít,8,3,-5,-1,1,0,0
vytvářet,2,2,0,0,1,0,0
použít,1,10,-9,-1,-1,0,0
studovat,3,5,-2,-1,-1,0,0
studovat,1,7,-6,-1,-1,0,0
mapovat,4,3,1,1,-1,0,0
znamenat,13,2,-11,-1,1,0,0
pořídit,1,10,-9,-1,-1,-1,0
opatřit,1,4,3,1,1,0,0
užít,2,3,1,1,1,0,0
mít,1,2,1,1,1,0,0
doplňovat,3,3,0,0,-1,0,0
získat,1,3,-2,-1,-1,0,0
odříkat,3,5,-2,-1,-1,0,0
užívat,2,4,2,1,1,0,0
postavit,1,3,-2,-1,-1,0,0
vystrčit,1,2,-1,-1,-1,0,0
stát,2,2,0,0,1,0,0
dostat,4,2,2,1,-1,0,0
platit,1,4,3,1,1,0,0
mít,3,3,0,0,1,0,0
činit,7,2,-5,-1,1,0,0
čepovat,1,9,-8,-1,-1,0,0
nosit,1,2,-1,-1,-1,0,0
nalézat,1,3,-2,-1,-1,0,0
dosazovat,1,3,-2,-1,-1,0,0
vytvořit,9,3,-6,-1,1,0,0
povýšit,1,5,-4,-1,-1,0,0
oblékat,1,5,-4,-1,-1,0,0
mít,2,3,1,1,1,0,0
obléknout,2,7,-5,-1,-1,0,0
ztrácet,2,5,-3,-1,-1,0,0
prožít,1,2,-1,-1,-1,0,0
opálit,1,4,-3,-1,-1,0,0
mít,4,6,2,1,1,0,0
vidět,10,2,-8,-1,1,-1,0
zachytit,2,2,0,0,-1,0,0
vidět,1,6,-5,-1,-1,0,0
mít,3,2,-1,-1,1,0,0
obsahovat,2,3,1,1,1,0,0
mít,3,4,-1,-1,-1,0,0
přinést,7,3,-4,-1,1,0,0
získávat,1,4,-3,-1,-1,0,0
zvýšit,2,4,-2,-1,-1,0,0
vtáhnout,3,2,-1,-1,1,0,0
přivést,1,7,-6,-1,-1,-1,0
uvést,16,2,-14,-1,1,0,0
rozbít,1,2,-1,-1,-1,0,0
mít,2,2,0,0,1,0,0
mít,5,2,-3,-1,1,0,0
trávit,2,2,0,0,-1,0,0
povolat,1,2,1,1,1,0,0
sehrát,6,2,-4,-1,1,0,0
vyzvat,1,6,-5,-1,-1,0,0
vyzvat,1,3,-2,-1,-1,0,0
podepsat,1,4,-3,-1,-1,0,0
nahradit,21,2,-19,-1,1,0,0
dařit,4,3,1,1,-1,0,0
nahradit,4,3,-1,-1,1,0,0
přemluvit,12,12,0,0,1,0,0
oznámit,3,4,1,1,1,0,0
mít,1,2,-1,-1,-1,0,0
čekat,1,2,-1,-1,-1,0,0
mít,14,2,-12,-1,1,0,0
zlomit,1,2,-1,-1,-1,0,0
potvrdit,3,2,-1,-1,1,0,0
ztratit,1,3,-2,-1,-1,0,0
přelstít,1,3,2,1,1,0,0
mít,1,2,-1,-1,-1,0,0
zasáhnout,3,2,-1,-1,1,0,0
řídit,8,3,-5,-1,1,0,0
dávat,1,2,-1,-1,-1,0,0
řídit,6,3,3,1,-1,0,0
vybudovat,20,2,-18,-1,1,0,0
mapovat,6,2,-4,-1,1,0,0
házet,1,2,1,1,1,0,0
zatknout,8,2,-6,-1,1,0,0
vydat,2,2,0,0,1,0,0
vytlačit,2,4,-2,-1,-1,0,0
koordinovat,2,6,-4,-1,-1,0,0
odhalit,12,3,-9,-1,1,0,0
soustředit,2,4,-2,-1,-1,0,0
mít,2,5,-3,-1,-1,0,0
vést,10,10,0,0,-1,0,0
zabavit,7,2,5,1,-1,1,0
poslat,3,2,1,1,-1,-1,0
doporučit,7,2,-5,-1,1,0,0
zaplatit,3,3,0,0,-1,0,0
mít,1,2,1,1,1,0,0
vytáhnout,7,2,-5,-1,1,0,0
rozvinout,15,6,-9,-1,1,0,0
mít,1,2,1,1,1,0,0
zahájit,1,2,1,1,1,0,0
pomáhat,5,5,0,0,-1,0,0
dát,1,6,-5,-1,-1,0,0
stát,1,5,4,1,1,0,0
mít,2,2,0,0,1,0,0
předložit,15,7,-8,-1,1,0,0
nechat,5,2,-3,-1,1,0,0
zatknout,3,3,0,0,1,0,0
prohrát,3,2,1,1,-1,0,0
mít,2,2,0,0,-1,0,0
vložit,1,3,-2,-1,-1,0,0
investovat,2,5,-3,-1,-1,0,0
pozvat,1,2,-1,-1,-1,0,0
přednést,9,10,1,1,1,0,0
zprostředkovat,5,3,-2,-1,1,0,0
znamenat,18,3,-15,-1,1,0,0
přijmout,6,5,1,1,-1,0,0
vést,1,3,-2,-1,-1,0,0
mít,9,3,-6,-1,1,0,0
mít,2,2,0,0,1,0,0
využívat,4,3,1,1,-1,0,0
obsahovat,3,14,-11,-1,-1,0,0
oslabit,10,3,-7,-1,1,0,0
nabízet,5,4,1,1,-1,0,0
využít,3,4,-1,-1,-1,0,0
otevírat,1,4,-3,-1,-1,0,0
připojit,1,5,-4,-1,-1,-1,0
držet,2,2,0,0,1,0,0
předpovídat,18,3,-15,-1,1,0,0
očekávat,10,5,-5,-1,1,0,0
mít,2,2,0,0,1,0,0
mít,4,2,-2,-1,1,0,0
podávat,1,12,-11,-1,-1,0,0
páchat,2,2,0,0,1,0,0
napadnout,2,6,4,1,1,0,0
zahnat,3,3,0,0,1,0,0
hrát,3,3,0,0,1,0,0
mít,3,2,-1,-1,1,-1,0
mít,1,30,-29,-1,-1,0,0
oslavovat,13,4,-9,-1,1,0,0
přehrát,1,3,-2,-1,-1,0,0
tečovat,1,2,-1,-1,-1,0,0
mít,1,2,-1,-1,-1,0,0
poslat,4,2,-2,-1,1,0,0
vrhnout,2,2,0,0,-1,0,0
zavřít,2,2,0,0,1,0,0
podrazit,1,2,1,1,1,0,0
oznámit,1,6,-5,-1,-1,0,0
vyhrát,3,4,-1,-1,-1,0,0
vychytat,4,2,2,1,-1,0,0
nahrávat,1,2,-1,-1,-1,0,0
mít,4,2,-2,-1,1,0,0
dovést,2,3,-1,-1,-1,0,0
dostávat,1,4,3,1,1,0,0
potvrzovat,2,3,-1,-1,-1,0,0
mít,6,7,1,1,1,0,0
mít,2,3,-1,-1,-1,0,0
zrušit,4,4,0,0,-1,0,0
vyhrát,3,2,-1,-1,1,0,0
dát,2,2,0,0,1,0,0
přidat,5,2,-3,-1,1,0,0
nastřílet,2,3,1,1,1,0,0
budit,2,5,3,1,1,0,0
zlepšit,2,5,-3,-1,-1,0,0
strhnout,1,3,-2,-1,-1,0,0
potírat,3,5,-2,-1,-1,0,0
inspirovat,2,6,-4,-1,-1,0,0
vybrat,4,4,0,0,1,0,0
zahajovat,3,4,1,1,1,0,0
mít,2,2,0,0,-1,0,0
prožít,2,4,2,1,1,0,0
vymazat,4,3,1,1,-1,0,0
srovnat,4,2,-2,-1,1,0,0
vhodit,2,5,3,1,1,0,0
budit,4,2,-2,-1,1,-1,0
udělat,1,9,-8,-1,-1,-1,0
podepsat,13,2,-11,-1,1,0,0
vypočítat,3,3,0,0,-1,0,0
potřebovat,19,4,-15,-1,1,0,0
uvalit,2,11,9,1,1,0,0
hrát,1,2,1,1,1,0,0
odevzdat,3,4,1,1,1,0,0
mít,2,14,-12,-1,-1,0,0
otevřít,1,11,-10,-1,-1,0,0
mít,20,2,-18,-1,1,0,0
odnést,4,2,-2,-1,1,-1,0
odebrat,7,5,-2,-1,1,0,0
vyhýbat,1,2,1,1,1,0,0
sdělit,6,3,3,1,-1,0,0
vystřídat,1,3,-2,-1,-1,0,0
chtít,1,2,1,1,1,0,0
nabídnout,3,4,-1,-1,-1,0,0
vyšetřovat,2,6,4,1,1,0,0
označit,10,3,-7,-1,1,0,0
přinést,3,5,2,1,1,0,0
vyhánět,2,2,0,0,-1,0,0
mít,13,2,-11,-1,1,0,0
postavit,2,2,0,0,1,0,0
zanášet,3,3,0,0,-1,0,0
vychrlit,16,2,-14,-1,1,0,0
kreslit,18,3,-15,-1,1,0,0
získat,1,6,-5,-1,-1,0,0
mít,5,3,-2,-1,1,0,0
vyslat,1,2,-1,-1,-1,0,0
dosáhnout,6,3,-3,-1,1,0,0
vymanit,2,4,-2,-1,-1,0,0
mít,11,3,-8,-1,1,0,0
vézt,2,2,0,0,-1,0,0
mít,4,2,-2,-1,1,0,0
mít,5,2,-3,-1,1,0,0
mít,7,7,0,0,1,0,0
publikovat,6,8,-2,-1,-1,0,0
zajišťovat,8,4,-4,-1,1,0,0
odmítnout,3,27,-24,-1,-1,0,0
nakupovat,1,6,-5,-1,-1,0,0
preferovat,2,4,-2,-1,-1,0,0
zabezpečit,3,4,-1,-1,-1,0,0
dosáhnout,3,2,-1,-1,1,0,0
představovat,11,4,7,1,-1,0,0
přiblížit,2,3,-1,-1,-1,0,0
dostat,1,9,-8,-1,-1,0,0
mít,2,4,-2,-1,-1,0,0
přehodnotit,3,19,-16,-1,-1,0,0
investovat,4,3,1,1,-1,0,0
prodat,7,2,-5,-1,1,0,0
zajistit,4,6,-2,-1,-1,0,0
získat,2,2,0,0,-1,0,0
oslovit,18,16,2,1,-1,0,0
přinášet,10,5,-5,-1,1,0,0
považovat,1,4,-3,-1,-1,0,0
uspořádat,18,3,-15,-1,1,0,0
dohrát,1,8,-7,-1,-1,0,0
vypálit,16,2,-14,-1,1,0,0
oznámit,1,3,-2,-1,-1,0,0
vidět,1,2,1,1,1,0,0
hrát,2,2,0,0,1,0,0
ukázat,1,2,-1,-1,-1,-1,0
oznámit,1,3,-2,-1,-1,-1,0
mít,2,2,0,0,-1,0,0
pohltit,6,3,-3,-1,1,0,0
vydat,1,6,-5,-1,-1,0,0
mít,21,2,-19,-1,1,0,0
obsadit,3,2,-1,-1,1,0,0
obsadit,2,4,-2,-1,-1,0,0
porazit,2,3,-1,-1,-1,0,0
obsadit,2,2,0,0,1,0,0
dosáhnout,6,3,-3,-1,1,0,0
nakazit,1,3,-2,-1,-1,0,0
vyhrát,4,5,-1,-1,-1,0,0
přidat,2,3,1,1,1,0,0
hrát,10,3,-7,-1,1,0,0
mít,2,3,1,1,1,0,0
porazit,1,3,-2,-1,-1,0,0
porazit,4,4,0,0,1,0,0
trávit,3,4,-1,-1,-1,0,0
uhrát,3,4,1,1,1,0,0
kydat,1,7,-6,-1,-1,0,0
zinscenovat,2,3,1,1,1,0,0
podpořit,1,2,-1,-1,-1,-1,0
stát,2,7,-5,-1,-1,0,0
mít,2,3,1,1,1,0,0
dořešit,3,4,-1,-1,-1,0,0
zajistit,3,3,0,0,1,0,0
vytáhnout,3,2,-1,-1,1,0,0
střežit,1,3,2,1,1,0,0
způsobit,1,3,2,1,1,0,0
kousnout,2,2,0,0,-1,0,0
nadávat,1,3,-2,-1,-1,0,0
odnášet,3,2,1,1,-1,0,0
brát,1,3,-2,-1,-1,0,0
mít,2,2,0,0,1,-1,0
stavět,3,6,-3,-1,-1,0,0
hrát,1,3,-2,-1,-1,0,0
udržet,1,4,-3,-1,-1,0,0
mít,3,2,-1,-1,1,0,0
vyvolat,3,2,-1,-1,1,0,0
zužovat,1,18,-17,-1,-1,0,0
prohlásit,1,4,-3,-1,-1,0,0
poutat,3,8,-5,-1,-1,0,0
využívat,2,3,-1,-1,-1,0,0
oslabit,2,4,-2,-1,-1,0,0
odložit,1,5,-4,-1,-1,0,0
přerušit,4,3,-1,-1,1,0,0
oznámit,1,2,-1,-1,-1,0,0
nalézt,1,9,-8,-1,-1,0,0
vyslat,2,2,0,0,1,0,0
zničit,2,2,0,0,1,0,0
vytlačit,1,5,-4,-1,-1,0,0
udělat,1,13,-12,-1,-1,0,0
vrhnout,1,3,-2,-1,-1,0,0
odstranit,2,3,-1,-1,-1,0,0
vyzvat,2,7,-5,-1,-1,0,0
přepadnout,1,5,-4,-1,-1,0,0
slýchávat,14,2,-12,-1,1,0,0
oplakávat,13,2,-11,-1,1,0,0
označit,4,6,2,1,1,0,0
opustit,1,5,4,1,1,0,0
přepadnout,2,2,0,0,1,0,0
mít,2,11,-9,-1,-1,0,0
pouštět,1,4,-3,-1,-1,0,0
zvýšit,3,2,-1,-1,1,0,0
uskutečnit,9,5,-4,-1,1,0,0
činit,2,2,0,0,1,0,0
pozastavit,8,3,-5,-1,1,0,0
využít,11,2,-9,-1,1,0,0
zůstat,1,2,1,1,1,0,0
odvozovat,5,5,0,0,1,-1,0
dostat,1,3,2,1,1,0,0
ujít,13,2,-11,-1,1,0,0
dočkat,3,2,-1,-1,1,-1,0
navrhnout,6,4,2,1,-1,0,0
napadat,1,3,-2,-1,-1,-1,0
vytanout,3,2,-1,-1,1,0,0
získat,3,3,0,0,1,0,0
zařadit,3,4,1,1,1,0,0
vídat,3,3,0,0,-1,0,0
zapálit,3,2,-1,-1,1,0,0
chystat,8,4,-4,-1,1,0,0
přebírat,3,2,-1,-1,1,0,0
natočit,1,2,1,1,1,0,0
soustřeďovat,7,3,-4,-1,1,0,0
přijímat,1,3,2,1,1,0,0
utrpět,6,2,-4,-1,1,0,0
opustit,1,4,-3,-1,-1,0,0
vyzdvihovat,2,4,-2,-1,-1,0,0
položit,1,5,4,1,1,0,0
kritizovat,1,6,-5,-1,-1,0,0
odvézt,3,2,-1,-1,1,-1,0
potkat,1,4,-3,-1,-1,0,0
pískat,8,3,-5,-1,1,0,0
zúčastnit,6,5,1,1,-1,0,0
zaznamenat,2,3,1,1,1,0,0
vézt,5,2,3,1,-1,0,0
mít,4,4,0,0,1,0,0
porazit,2,3,1,1,1,0,0
vybudovat,5,3,2,1,-1,0,0
odhadnout,5,3,-2,-1,1,0,0
doplňovat,3,7,-4,-1,-1,0,0
odmítnout,8,5,3,1,-1,0,0
mít,3,2,1,1,-1,0,0
využívat,2,12,-10,-1,-1,0,0
složit,5,4,-1,-1,1,0,0
vést,1,12,-11,-1,-1,0,0
mít,5,5,0,0,1,0,0
zadržet,2,6,-4,-1,-1,0,0
mít,2,2,0,0,1,0,0
zřídit,6,3,-3,-1,1,0,0
najít,1,3,-2,-1,-1,0,0
připravit,7,4,-3,-1,1,0,0
hradit,1,2,-1,-1,-1,0,0
stát,8,8,0,0,1,0,0
srovnat,1,3,-2,-1,-1,0,0
nést,1,3,2,1,1,0,0
mít,12,2,-10,-1,1,-1,0
propagovat,2,3,1,1,1,0,0
mít,1,2,1,1,1,0,0
připravovat,6,2,-4,-1,1,0,0
vydat,12,2,-10,-1,1,0,0
zasáhnout,1,2,-1,-1,-1,-1,0
mít,5,2,-3,-1,1,0,0
přinést,1,6,-5,-1,-1,0,0
napadnout,1,8,-7,-1,-1,0,0
vytvořit,2,2,0,0,1,0,0
odevzdat,3,3,0,0,1,0,0
přenést,3,11,-8,-1,-1,0,0
předat,2,2,0,0,-1,0,0
dostat,1,2,-1,-1,-1,-1,0
odvrátit,8,5,3,1,-1,0,0
ostřelovat,2,3,-1,-1,-1,0,0
odevzdat,2,6,4,1,1,0,0
čekat,14,2,-12,-1,1,-1,0
muset,2,3,-1,-1,-1,0,0
zaznamenávat,3,3,0,0,1,0,0
zahnat,1,14,-13,-1,-1,0,0
mít,2,2,0,0,1,0,0
držet,1,2,1,1,1,0,0
přivézt,2,2,0,0,1,0,0
získat,4,3,-1,-1,1,0,0
pozvat,6,2,-4,-1,1,-1,0
udělat,1,11,-10,-1,-1,0,0
vzít,6,3,-3,-1,1,0,0
zastupovat,3,4,-1,-1,-1,0,0
mít,4,2,-2,-1,1,0,0
pouštět,17,3,-14,-1,1,0,0
zkontrolovat,2,4,-2,-1,-1,0,0
korigovat,5,3,-2,-1,1,0,0
vlastnit,7,5,2,1,-1,0,0
odepřít,4,3,-1,-1,1,0,0
mít,3,10,-7,-1,-1,0,0
získat,1,2,-1,-1,-1,0,0
zaujmout,2,6,-4,-1,-1,0,0
mít,2,2,0,0,1,0,0
donutit,1,3,-2,-1,-1,-1,0
přivést,1,3,-2,-1,-1,0,0
hradit,2,4,2,1,1,0,0
exportovat,2,3,-1,-1,-1,0,0
snížit,3,3,0,0,-1,0,0
čerpat,9,4,-5,-1,1,0,0
zpracovat,5,7,-2,-1,-1,0,0
očekávat,5,17,-12,-1,-1,0,0
sjezdit,3,9,6,1,1,0,0
povolit,1,8,-7,-1,-1,0,0
zrušit,2,3,1,1,1,0,0
mít,3,4,-1,-1,-1,0,0
zastavit,4,5,-1,-1,-1,0,0
získávat,7,2,-5,-1,1,0,0
získávat,5,4,-1,-1,1,0,0
najít,8,2,-6,-1,1,-1,0
přibližovat,2,3,-1,-1,-1,0,0
předvést,2,2,0,0,1,0,0
odevzdat,2,4,-2,-1,-1,0,0
hradit,2,7,-5,-1,-1,0,0
věnovat,2,5,-3,-1,-1,0,0
převést,6,3,3,1,-1,0,0
požádat,2,6,4,1,1,0,0
koupit,6,3,-3,-1,1,0,0
vyžádat,10,3,-7,-1,1,0,0
krýt,4,4,0,0,-1,0,0
zvládnout,2,4,-2,-1,-1,0,0
hrozit,1,6,-5,-1,-1,0,0
vyvézt,3,2,-1,-1,1,0,0
podlehnout,1,3,2,1,1,0,0
slibovat,2,6,4,1,1,0,0
dopustit,1,3,-2,-1,-1,0,0
čekat,3,2,-1,-1,1,0,0
uvést,1,15,-14,-1,-1,0,0
vymáhat,17,2,-15,-1,1,0,0
dostat,7,10,-3,-1,-1,0,0
pozvat,2,8,-6,-1,-1,0,0
mít,14,3,-11,-1,1,0,0
vytvořit,3,3,0,0,-1,0,0
mít,2,6,4,1,1,0,0
dělit,1,4,-3,-1,-1,0,0
mít,2,2,0,0,1,0,0
mít,4,2,-2,-1,1,0,0
mít,3,4,1,1,1,0,0
vést,2,3,1,1,1,0,0
čekat,1,3,2,1,1,0,0
přijmout,3,2,-1,-1,1,0,0
mít,4,3,-1,-1,1,0,0
prosadit,2,2,0,0,1,0,0
prokázat,4,2,-2,-1,1,0,0
mít,11,2,-9,-1,1,0,0
shánět,3,2,1,1,-1,0,0
uvolnit,2,3,-1,-1,-1,0,0
převážet,2,13,-11,-1,-1,0,0
přilákat,8,2,-6,-1,1,0,0
ponechávat,7,5,-2,-1,1,0,0
mít,1,2,1,1,1,0,0
prožít,1,3,2,1,1,0,0
předložit,4,3,1,1,-1,0,0
uznat,4,8,-4,-1,-1,0,0
zavádět,1,3,-2,-1,-1,0,0
dostávat,1,3,-2,-1,-1,0,0
ostřelovat,2,5,-3,-1,-1,0,0
říci,1,4,-3,-1,-1,0,0
brát,2,3,-1,-1,-1,0,0
spatřovat,5,7,2,1,1,0,0
vydat,10,2,-8,-1,1,0,0
svolat,5,3,-2,-1,1,0,0
nalézt,5,3,-2,-1,1,0,0
vidět,9,2,-7,-1,1,0,0
zajistit,3,9,-6,-1,-1,0,0
vzít,2,2,0,0,1,0,0
připojit,17,2,-15,-1,1,0,0
vyvolat,2,4,-2,-1,-1,0,0
přivádět,1,2,-1,-1,-1,0,0
vzít,15,2,-13,-1,1,0,0
způsobit,5,2,-3,-1,1,0,0
vyplatit,4,4,0,0,1,0,0
zvyšovat,3,3,0,0,-1,0,0
čerpat,3,4,1,1,1,0,0
otevřít,3,2,-1,-1,1,0,0
vidět,4,5,-1,-1,-1,0,0
mít,2,3,-1,-1,-1,0,0
umístit,2,3,-1,-1,-1,0,0
zřídit,3,2,-1,-1,1,0,0
nahradit,4,3,1,1,-1,0,0
upravit,9,5,4,1,-1,0,0
zahájit,2,3,-1,-1,-1,0,0
povýšit,3,4,-1,-1,-1,0,0
přivézt,14,6,-8,-1,1,0,0
uspořádat,4,15,11,1,1,0,0
ukončit,2,5,-3,-1,-1,0,0
zajišťovat,4,10,-6,-1,-1,0,0
vydat,17,5,-12,-1,1,0,0
představit,4,2,-2,-1,1,0,0
odvést,1,6,-5,-1,-1,0,0
pěstovat,2,4,2,1,1,0,0
žalovat,1,2,-1,-1,-1,-1,0
zasít,1,5,-4,-1,-1,0,0
přistihnout,1,7,-6,-1,-1,-1,0
nabízet,6,4,-2,-1,1,0,0
brát,2,2,0,0,1,0,0
mít,6,6,0,0,1,0,0
podařit,1,5,4,1,1,0,0
zaplatit,3,2,1,1,-1,0,0
zaplatit,3,2,1,1,-1,0,0
přinést,2,3,1,1,1,0,0
zvrátit,1,3,2,1,1,0,0
dostat,1,2,-1,-1,-1,0,0
dělat,1,3,2,1,1,0,0
dostat,1,3,-2,-1,-1,0,0
přinést,12,2,-10,-1,1,0,0
mít,1,2,1,1,1,0,0
mít,2,3,1,1,1,0,0
odvádět,2,3,-1,-1,-1,0,0
podniknout,20,5,-15,-1,1,0,0
přinést,3,2,-1,-1,1,0,0
moci,2,5,-3,-1,-1,0,0
doporučovat,2,3,-1,-1,-1,0,0
zaregistrovat,5,3,-2,-1,1,0,0
vznést,4,4,0,0,-1,0,0
mít,1,2,1,1,1,0,0
lákat,1,7,-6,-1,-1,0,0
nalézat,9,2,-7,-1,1,0,0
vymykat,2,2,0,0,1,0,0
mít,4,2,-2,-1,1,0,0
fandit,2,5,-3,-1,-1,0,0
vydat,10,10,0,0,-1,0,0
připlácet,3,7,-4,-1,-1,0,0
brát,2,2,0,0,1,0,0
zasazovat,1,3,-2,-1,-1,0,0
uznat,1,3,-2,-1,-1,0,0
zachránit,1,3,-2,-1,-1,0,0
odhalit,9,4,-5,-1,1,0,0
tajit,1,4,-3,-1,-1,0,0
zanechat,1,6,-5,-1,-1,0,0
způsobovat,1,2,-1,-1,-1,0,0
dostat,2,2,0,0,1,0,0
podporovat,3,2,1,1,-1,0,0
mít,2,2,0,0,1,-1,0
otevřít,4,2,2,1,-1,0,0
vyčlenit,1,15,-14,-1,-1,0,0
pronajmout,1,3,2,1,1,0,0
dostat,1,2,-1,-1,-1,0,0
vystudovat,3,3,0,0,-1,0,0
mít,10,2,-8,-1,1,-1,0
hrát,1,2,-1,-1,-1,-1,0
udržet,1,2,-1,-1,-1,-1,0
ratifikovat,2,5,-3,-1,-1,0,0
mít,6,3,-3,-1,1,0,0
pomáhat,3,2,1,1,-1,0,0
koupit,8,5,-3,-1,1,0,0
ukazovat,16,2,-14,-1,1,0,0
zavraždit,2,2,0,0,1,0,0
uskladnit,6,4,-2,-1,1,0,0
plánovat,1,3,2,1,1,0,0
garantovat,2,4,-2,-1,-1,0,0
mít,7,2,-5,-1,1,0,0
umožnit,4,8,-4,-1,-1,0,0
prosadit,4,3,-1,-1,1,0,0
přijmout,23,2,-21,-1,1,0,0
připadnout,3,6,-3,-1,-1,0,0
potřebovat,3,3,0,0,1,0,0
přitahovat,1,6,-5,-1,-1,0,0
oznámit,1,2,-1,-1,-1,0,0
stát,2,3,1,1,1,0,0
dosáhnout,3,3,0,0,1,0,0
vykázat,4,7,-3,-1,-1,0,0
zvýšit,2,3,-1,-1,-1,0,0
stáhnout,2,2,0,0,-1,0,0
půjčovat,1,3,-2,-1,-1,0,0
obdržet,9,4,-5,-1,1,0,0
znamenat,14,2,-12,-1,1,0,0
vyzývat,1,2,-1,-1,-1,0,0
zainteresovat,1,2,1,1,1,0,0
vytvořit,1,12,-11,-1,-1,0,0
dostat,2,2,0,0,-1,0,0
komponovat,2,2,0,0,-1,0,0
zmnožovat,2,3,-1,-1,-1,0,0
mít,1,3,2,1,1,0,0
zpřístupnit,2,2,0,0,-1,0,0
dostat,3,2,1,1,-1,0,0
dopravit,1,2,-1,-1,-1,0,0
dostat,2,3,1,1,1,0,0
nabízet,2,4,2,1,1,0,0
mít,1,3,-2,-1,-1,0,0
vystudovat,3,6,-3,-1,-1,0,0
projet,2,2,0,0,1,0,0
najít,7,2,-5,-1,1,0,0
přivézt,3,2,1,1,-1,0,0
poslat,4,3,1,1,-1,0,0
vycházet,2,2,0,0,1,0,0
zkomplikovat,5,3,2,1,-1,0,0
řešit,2,2,0,0,-1,0,0
zvážit,7,9,-2,-1,-1,0,0
zabezpečit,11,3,-8,-1,1,0,0
mít,2,7,5,1,1,0,0
vyhrožovat,2,2,0,0,-1,0,0
opouštět,1,13,-12,-1,-1,0,0
rovnat,1,16,-15,-1,-1,0,0
prodávat,1,7,-6,-1,-1,0,0
vykopnout,7,3,-4,-1,1,0,0
uvázat,1,2,1,1,1,0,0
mít,1,2,1,1,1,0,0
dávat,3,3,0,0,1,0,0
obsadit,4,2,-2,-1,1,0,0
mít,4,5,1,1,1,0,0
změnit,1,4,3,1,1,0,0
vyrazit,1,3,2,1,1,0,0
rozdělovat,3,2,-1,-1,1,0,0
nosit,1,2,-1,-1,-1,0,0
udržet,1,2,-1,-1,-1,0,0
stavět,1,3,-2,-1,-1,0,0
mít,9,3,-6,-1,1,0,0
mít,1,2,1,1,1,0,0
mít,3,3,0,0,1,0,0
doporučit,4,2,-2,-1,1,0,0
přijít,1,4,-3,-1,-1,0,0
instalovat,6,2,4,1,-1,0,0
stavět,2,3,-1,-1,-1,0,0
stavět,1,8,-7,-1,-1,-1,0
stavět,2,7,-5,-1,-1,0,0
nabídnout,2,3,1,1,1,0,0
mít,1,9,-8,-1,-1,0,0
připustit,14,2,-12,-1,1,0,0
spatřovat,3,2,-1,-1,1,-1,0
mít,21,2,-19,-1,1,-1,0
vzít,2,2,0,0,-1,0,0
odložit,4,7,-3,-1,-1,0,0
představit,2,18,-16,-1,-1,0,0
profilovat,1,10,-9,-1,-1,-1,0
akcentovat,3,2,-1,-1,1,0,0
vyvinout,15,3,-12,-1,1,0,0
odsunout,4,8,-4,-1,-1,0,0
postavit,1,4,-3,-1,-1,-1,0
prohlásit,1,8,-7,-1,-1,0,0
navrhovat,8,10,-2,-1,-1,0,0
měnit,10,5,-5,-1,1,0,0
otevřít,2,2,0,0,1,0,0
zřídit,3,5,2,1,1,0,0
dosáhnout,3,3,0,0,-1,0,0
použít,10,2,-8,-1,1,0,0
zahájit,21,3,-18,-1,1,0,0
připravit,4,2,2,1,-1,0,0
převést,1,3,-2,-1,-1,0,0
ponechat,1,3,-2,-1,-1,0,0
určit,3,3,0,0,-1,0,0
dostat,3,5,2,1,1,0,0
zvýšit,4,3,-1,-1,1,0,0
dosahovat,3,3,0,0,1,0,0
vyvézt,1,4,-3,-1,-1,0,0
mít,2,4,-2,-1,-1,0,0
najít,1,17,-16,-1,-1,0,0
fotografovat,2,7,-5,-1,-1,0,0
lokalizovat,2,3,-1,-1,-1,0,0
mít,8,2,-6,-1,1,0,0
kreslit,2,2,0,0,-1,0,0
uvěřit,3,22,-19,-1,-1,0,0
plnit,13,3,-10,-1,1,0,0
uvést,1,4,3,1,1,0,0
mít,5,2,-3,-1,1,0,0
utrpět,10,7,-3,-1,1,0,0
nalézt,11,3,-8,-1,1,0,0
složit,2,6,-4,-1,-1,0,0
složit,1,3,2,1,1,0,0
dát,2,2,0,0,1,0,0
získat,4,3,-1,-1,1,0,0
inkasovat,5,4,1,1,-1,0,0
vybudovat,2,3,-1,-1,-1,0,0
uvolnit,4,5,-1,-1,-1,0,0
mít,8,11,3,1,1,0,0
získat,1,3,-2,-1,-1,-1,0
očekávat,3,4,1,1,1,0,0
zúžit,3,3,0,0,-1,0,0
předpokládat,3,5,-2,-1,-1,0,0
očekávat,4,3,1,1,-1,0,0
mít,4,6,-2,-1,-1,0,0
vytvořit,6,2,-4,-1,1,0,0
vymazat,4,3,1,1,-1,0,0
ztratit,3,3,0,0,-1,0,0
shazovat,5,4,-1,-1,1,0,0
bolet,1,2,-1,-1,-1,-1,0
dostat,4,3,-1,-1,1,0,0
uložit,2,2,0,0,-1,-1,0
mít,1,2,-1,-1,-1,-1,0
využívat,4,3,-1,-1,1,0,0
hrát,1,3,-2,-1,-1,0,0
získat,1,5,-4,-1,-1,0,0
prodělat,3,3,0,0,1,0,0
mít,2,3,1,1,1,0,0
zneužít,14,8,-6,-1,1,0,0
uvést,1,14,-13,-1,-1,0,0
odpovídat,3,3,0,0,1,0,0
napadnout,5,9,4,1,1,0,0
odročit,10,7,3,1,-1,0,0
kontrolovat,4,3,-1,-1,1,0,0
vyšachovat,1,4,-3,-1,-1,0,0
přesunout,1,3,-2,-1,-1,-1,0
doplnit,2,6,-4,-1,-1,0,0
zachránit,2,2,0,0,-1,-1,0
odpoutat,1,7,-6,-1,-1,0,0
přivést,12,3,9,1,-1,0,0
zasáhnout,2,7,-5,-1,-1,0,0
uvádět,4,10,-6,-1,-1,0,0
nacházet,3,8,-5,-1,-1,0,0
mít,2,14,-12,-1,-1,0,0
uchvátit,1,2,1,1,1,0,0
obnovit,1,3,-2,-1,-1,0,0
podepsat,6,3,-3,-1,1,0,0
dát,1,26,-25,-1,-1,0,0
ukládat,14,6,-8,-1,1,0,0
prolistovat,1,4,-3,-1,-1,0,0
mít,1,2,1,1,1,0,0
vrátit,1,2,-1,-1,-1,0,0
naznačovat,4,13,-9,-1,-1,0,0
pasovat,1,2,-1,-1,-1,-1,0
udělat,2,4,2,1,1,0,0
dostrkat,3,6,-3,-1,-1,0,0
vytlačit,5,2,-3,-1,1,0,0
hlásit,3,2,-1,-1,1,0,0
zvolit,7,7,0,0,1,0,0
učinit,1,3,2,1,1,0,0
napsat,1,3,-2,-1,-1,0,0
použít,2,13,-11,-1,-1,0,0
strávit,1,16,-15,-1,-1,0,0
pořádat,1,2,1,1,1,0,0
znamenat,6,4,-2,-1,1,0,0
vynutit,1,2,1,1,1,0,0
nahrabat,1,3,2,1,1,0,0
žádat,2,2,0,0,-1,0,0
stavět,2,3,-1,-1,-1,0,0
mít,8,2,-6,-1,1,0,0
mít,8,3,-5,-1,1,0,0
vyřadit,7,2,-5,-1,1,0,0
mít,2,3,-1,-1,-1,0,0
dávat,1,2,1,1,1,0,0
mít,2,4,2,1,1,0,0
vést,10,2,-8,-1,1,0,0
mít,2,3,1,1,1,0,0
stát,2,2,0,0,1,0,0
převést,2,3,-1,-1,-1,0,0
plánovat,2,4,-2,-1,-1,0,0
připravovat,2,3,-1,-1,-1,0,0
dostat,2,4,-2,-1,-1,0,0
vyzvednout,1,5,-4,-1,-1,0,0
obdržet,1,3,2,1,1,0,0
požívat,3,4,1,1,1,0,0
přitlačit,2,2,0,0,1,0,0
klepnout,2,4,2,1,1,0,0
přinášet,8,3,-5,-1,1,0,0
vydat,5,3,-2,-1,1,0,0
vzít,2,2,0,0,-1,0,0
rozehrávat,9,7,-2,-1,1,0,0
prokazovat,10,2,-8,-1,1,-1,0
vynalézat,2,7,-5,-1,-1,0,0
vybírat,10,3,-7,-1,1,0,0
mít,1,2,-1,-1,-1,0,0
sehnat,3,2,-1,-1,1,0,0
mít,6,2,-4,-1,1,0,0
vystřídat,14,2,-12,-1,1,0,0
podat,4,17,-13,-1,-1,0,0
publikovat,15,4,-11,-1,1,0,0
stíhat,8,6,-2,-1,1,0,0
zavést,6,3,-3,-1,1,0,0
vydržovat,3,3,0,0,-1,0,0
rozdělit,1,7,-6,-1,-1,0,0
mít,2,2,0,0,1,0,0
sehrát,15,3,12,1,-1,0,0
nasbírat,4,3,-1,-1,1,0,0
mít,1,2,1,1,1,-1,0
mít,1,4,-3,-1,-1,0,0
zaběhnout,7,5,-2,-1,1,0,0
pomoci,2,9,-7,-1,-1,0,0
vložit,5,4,-1,-1,1,0,0
upevnit,1,6,-5,-1,-1,-1,0
přivézt,1,2,-1,-1,-1,-1,0
provádět,2,2,0,0,1,0,0
dopustit,3,2,1,1,-1,0,0
připravit,2,5,3,1,1,0,0
věnovat,4,3,-1,-1,1,0,0
pouštět,2,2,0,0,-1,0,0
utržit,3,4,1,1,1,0,0
zvýšit,1,4,-3,-1,-1,0,0
zvýšit,1,3,-2,-1,-1,0,0
zvýšit,1,3,-2,-1,-1,0,0
mít,3,6,-3,-1,-1,0,0
přinést,1,4,-3,-1,-1,0,0
malovat,1,2,-1,-1,-1,0,0
proclít,1,10,-9,-1,-1,0,0
zatelefonovat,2,2,0,0,-1,0,0
trávit,2,3,1,1,1,0,0
mít,2,2,0,0,1,0,0
mít,7,4,-3,-1,1,0,0
čítat,2,5,-3,-1,-1,0,0
potřebovat,1,9,-8,-1,-1,0,0
dopravit,3,2,1,1,-1,0,0
mít,8,2,-6,-1,1,0,0
pít,1,3,-2,-1,-1,0,0
mít,5,2,-3,-1,1,1,0
zapínat,1,11,-10,-1,-1,0,0
použít,1,5,-4,-1,-1,0,0
zdražit,1,6,-5,-1,-1,0,0
provádět,2,3,-1,-1,-1,0,0
vyrvat,1,3,-2,-1,-1,0,0
udělat,3,5,-2,-1,-1,0,0
odčerpávat,3,9,-6,-1,-1,0,0
zaplavovat,2,3,-1,-1,-1,0,0
vytyčit,15,2,-13,-1,1,0,0
nasytit,1,3,-2,-1,-1,-1,0
pomoci,1,3,-2,-1,-1,-1,0
uvést,10,8,-2,-1,1,0,0
vyslat,2,2,0,0,1,0,0
podepsat,5,2,-3,-1,1,0,0
dávat,1,5,-4,-1,-1,-1,0
objevit,3,3,0,0,-1,0,0
obsadit,2,6,4,1,1,0,0
dojít,1,2,1,1,1,0,0
vydat,2,4,-2,-1,-1,0,0
prožívat,37,3,-34,-1,1,0,0
najít,5,2,-3,-1,1,-1,0
odhadovat,2,3,-1,-1,-1,0,0
vzít,1,2,-1,-1,-1,0,0
znamenat,2,2,0,0,1,0,0
představovat,2,3,1,1,1,0,0
strávit,1,2,-1,-1,-1,0,0
hledat,1,2,1,1,1,0,0
mít,3,2,-1,-1,1,0,0
mít,3,3,0,0,1,0,0
převzít,1,3,-2,-1,-1,0,0
vrhnout,2,4,-2,-1,-1,0,0
mít,2,4,2,1,1,0,0
stát,6,4,2,1,-1,0,0
najít,5,4,1,1,-1,0,0
dát,2,8,6,1,1,0,0
posílit,2,3,1,1,1,0,0
zachvátit,5,6,-1,-1,-1,0,0
vybudovat,3,4,1,1,1,0,0
přitáhnout,2,3,1,1,1,0,0
nadýchat,1,8,-7,-1,-1,0,0
zajistit,11,3,-8,-1,1,0,0
vyznačit,2,3,1,1,1,0,0
kompenzovat,5,3,2,1,-1,0,0
vydělat,1,4,-3,-1,-1,0,0
transportovat,2,3,-1,-1,-1,0,0
přivézt,6,2,-4,-1,1,0,0
mít,7,4,-3,-1,1,0,0
představovat,34,3,-31,-1,1,0,0
vzdát,3,4,-1,-1,-1,0,0
vydat,2,6,-4,-1,-1,0,0
najít,1,8,-7,-1,-1,-1,0
podporovat,5,7,-2,-1,-1,0,0
mít,7,2,-5,-1,1,-1,0
zvýšit,3,3,0,0,-1,0,0
snížit,1,3,-2,-1,-1,0,0
zůstat,1,4,3,1,1,0,0
mít,6,4,-2,-1,1,0,0
uložit,1,3,-2,-1,-1,0,0
dostat,9,4,-5,-1,1,0,0
předat,3,4,-1,-1,-1,0,0
hodnotit,2,3,-1,-1,-1,0,0
vykupovat,2,13,-11,-1,-1,0,0
plnit,1,3,-2,-1,-1,0,0
nosit,1,3,-2,-1,-1,0,0
přerušit,2,3,1,1,1,0,0
snížit,1,4,-3,-1,-1,0,0
vidět,6,4,2,1,-1,0,0
zavést,2,3,1,1,1,0,0
dostat,4,2,-2,-1,1,0,0
mít,2,2,0,0,-1,0,0
očekávat,3,2,-1,-1,1,0,0
mít,19,2,-17,-1,1,-1,0
sehnat,2,10,-8,-1,-1,0,0
představovat,12,4,-8,-1,1,0,0
platit,3,3,0,0,1,0,0
vzít,1,2,1,1,1,0,0
vložit,5,2,-3,-1,1,0,0
činit,2,3,1,1,1,0,0
zařazovat,4,4,0,0,-1,0,0
hradit,5,10,-5,-1,-1,0,0
činit,4,3,-1,-1,1,0,0
vložit,5,2,-3,-1,1,0,0
překročit,6,3,-3,-1,1,0,0
činit,2,3,1,1,1,0,0
získat,1,10,-9,-1,-1,0,0
porazit,7,5,-2,-1,1,0,0
prohloubit,7,2,-5,-1,1,0,0
snášet,3,10,-7,-1,-1,0,0
vynakládat,3,4,1,1,1,0,0
udržovat,1,3,-2,-1,-1,0,0
zavraždit,5,7,-2,-1,-1,0,0
vyslat,4,3,-1,-1,1,0,0
řadit,1,22,-21,-1,-1,0,0
vrhnout,1,8,-7,-1,-1,0,0
naklást,4,2,-2,-1,1,0,0
ochránit,4,3,1,1,-1,0,0
vyvolávat,5,4,-1,-1,1,0,0
doporučit,14,2,-12,-1,1,-1,0
přijmout,7,2,-5,-1,1,0,0
vypuzovat,3,4,1,1,1,0,0
účastnit,8,4,-4,-1,1,0,0
vznášet,2,2,0,0,1,-1,0
udržovat,5,13,-8,-1,-1,0,0
dostat,7,3,-4,-1,1,0,0
napadnout,1,6,-5,-1,-1,0,0
označit,1,9,-8,-1,-1,0,0
dát,1,2,-1,-1,-1,-1,0
zatknout,6,5,-1,-1,1,0,0
předcházet,2,3,-1,-1,-1,0,0
předcházet,2,4,-2,-1,-1,0,0
vyhovovat,4,13,-9,-1,-1,0,0
získat,2,2,0,0,1,0,0
číst,2,2,0,0,1,-1,0
použít,2,3,1,1,1,0,0
vydat,16,3,-13,-1,1,0,0
mít,1,3,2,1,1,0,0
uskutečnit,3,3,0,0,1,0,0
dostat,2,4,2,1,1,0,0
podporovat,2,14,-12,-1,-1,0,0
předčit,2,6,-4,-1,-1,0,0
zvýšit,5,6,-1,-1,-1,0,0
vést,2,9,-7,-1,-1,0,0
omezovat,3,3,0,0,-1,0,0
vystudovat,1,4,-3,-1,-1,0,0
vystudovat,4,6,-2,-1,-1,0,0
vystudovat,3,4,-1,-1,-1,0,0
zanechat,4,2,-2,-1,1,-1,0
třídit,1,3,-2,-1,-1,0,0
odvézt,3,7,-4,-1,-1,0,0
vyhazovat,3,43,-40,-1,-1,0,0
zařadit,3,3,0,0,-1,0,0
zaujímat,3,2,-1,-1,1,0,0
vytvářet,4,6,-2,-1,-1,0,0
mít,3,13,-10,-1,-1,0,0
mít,4,2,-2,-1,1,-1,0
vracet,2,4,-2,-1,-1,0,0
uveřejnit,17,6,-11,-1,1,0,0
vyhledávat,3,3,0,0,-1,0,0
napadat,2,3,-1,-1,-1,0,0
stačit,1,2,-1,-1,-1,-1,0
převést,7,3,-4,-1,1,0,0
rozlišovat,1,15,-14,-1,-1,0,0
začínat,2,3,-1,-1,-1,0,0
prodlužovat,3,4,-1,-1,-1,0,0
posunovat,5,3,2,1,-1,0,0
tvořit,7,6,-1,-1,1,0,0
zaujmout,2,7,-5,-1,-1,0,0
dostat,7,3,-4,-1,1,0,0
chránit,4,4,0,0,-1,0,0
hrát,2,3,1,1,1,0,0
kategorizovat,3,6,-3,-1,-1,0,0
nacházet,2,23,-21,-1,-1,0,0
kategorizovat,4,4,0,0,-1,0,0
mít,1,6,-5,-1,-1,0,0
zaručovat,2,5,-3,-1,-1,0,0
představovat,2,3,1,1,1,0,0
přenášet,1,2,-1,-1,-1,-1,0
zaručit,3,7,-4,-1,-1,0,0
obrátit,1,5,-4,-1,-1,0,0
slyšet,6,12,-6,-1,-1,0,0
zasílat,2,3,1,1,1,0,0
řešit,5,3,2,1,-1,0,0
způsobovat,3,12,-9,-1,-1,0,0
rozlišit,1,10,-9,-1,-1,0,0
ztratit,1,4,-3,-1,-1,0,0
upravovat,1,4,-3,-1,-1,-1,0
extrahovat,7,3,-4,-1,1,0,0
řídit,9,4,-5,-1,1,0,0
rozlišovat,2,7,-5,-1,-1,0,0
využívat,6,4,-2,-1,1,0,0
vytvořit,2,2,0,0,1,0,0
zůstat,1,2,1,1,1,0,0
rozumět,2,2,0,0,-1,0,0
volit,9,3,-6,-1,1,0,0
formovat,3,15,-12,-1,-1,0,0
motivovat,1,5,-4,-1,-1,-1,0
vytvořit,2,2,0,0,1,-1,0
investovat,4,8,-4,-1,-1,0,0
vědět,1,11,-10,-1,-1,0,0
rozpálit,3,3,0,0,-1,0,0
vydat,1,2,1,1,1,0,0
stimulovat,8,3,5,1,-1,0,0
činit,1,3,-2,-1,-1,0,0
stát,2,3,1,1,1,0,0
vynášet,6,2,-4,-1,1,0,0
vytvořit,2,3,-1,-1,-1,0,0
získat,2,5,3,1,1,0,0
dostávat,2,3,1,1,1,0,0
vytěžit,8,4,-4,-1,1,0,0
studovat,11,2,-9,-1,1,0,0
odhadovat,4,4,0,0,-1,0,0
mít,3,4,1,1,1,0,0
krájet,2,6,-4,-1,-1,0,0
vyškrtnout,2,3,-1,-1,-1,0,0
potřebovat,6,3,-3,-1,1,0,0
poradit,1,3,-2,-1,-1,-1,0
publikovat,2,6,-4,-1,-1,0,0
zaměřit,3,4,-1,-1,-1,0,0
tahat,2,2,0,0,-1,0,0
nést,2,2,0,0,-1,0,0
vyučovat,3,10,-7,-1,-1,0,0
učit,2,2,0,0,1,0,0
přijmout,8,2,-6,-1,1,0,0
protiřečit,2,3,1,1,1,0,0
najít,1,11,-10,-1,-1,-1,0
najít,1,14,-13,-1,-1,-1,0
vystudovat,4,6,-2,-1,-1,0,0
znát,2,5,3,1,1,1,0
zůstávat,4,3,-1,-1,1,0,0
doporučovat,1,3,-2,-1,-1,0,0
způsobovat,3,3,0,0,1,0,0
mít,8,2,-6,-1,1,0,0
zahrnovat,7,4,-3,-1,1,0,0
předpovídat,2,5,3,1,1,0,0
mít,6,3,-3,-1,1,0,0
nacházet,3,10,-7,-1,-1,0,0
najít,11,5,-6,-1,1,0,0
vzrušovat,1,2,-1,-1,-1,0,0
vědět,1,9,-8,-1,-1,0,0
nalézat,3,2,-1,-1,1,-1,0
mít,3,3,0,0,1,0,0
využít,9,4,-5,-1,1,0,0
nabývat,2,23,-21,-1,-1,0,0
klasifikovat,2,15,-13,-1,-1,0,0
zaokrouhlit,2,5,-3,-1,-1,0,0
vychýlit,1,8,-7,-1,-1,0,0
udržovat,1,10,-9,-1,-1,-1,0
vystudovat,1,5,-4,-1,-1,0,0
mít,4,2,-2,-1,1,0,0
vystudovat,1,5,-4,-1,-1,0,0
vystudovat,1,5,-4,-1,-1,0,0
znamenat,9,12,-3,-1,-1,0,0
užívat,2,3,-1,-1,-1,0,0
uvítat,1,3,-2,-1,-1,-1,0
přitahovat,2,4,-2,-1,-1,0,0
nechat,1,12,-11,-1,-1,-1,0
znát,1,22,-21,-1,-1,-1,0
tvořit,1,3,-2,-1,-1,-1,0
znamenat,1,2,1,1,1,0,0
brát,6,2,-4,-1,1,0,0
hýbat,2,5,-3,-1,-1,0,0
položit,3,5,2,1,1,0,0
uspořádat,1,3,-2,-1,-1,0,0
klást,2,3,1,1,1,0,0
kupovat,1,7,-6,-1,-1,0,0
pěstovat,1,2,1,1,1,0,0
přenést,5,4,1,1,-1,0,0
dostávat,2,3,-1,-1,-1,0,0
dát,15,5,-10,-1,1,0,0
měnit,1,18,-17,-1,-1,-1,0
uvádět,1,5,-4,-1,-1,-1,0
asociovat,7,7,0,0,-1,0,0
popsat,2,3,-1,-1,-1,0,0
určovat,6,5,1,1,-1,0,0
naleznout,2,6,-4,-1,-1,0,0
uvrhnout,1,3,-2,-1,-1,0,0
přenést,5,9,-4,-1,-1,0,0
mít,1,6,-5,-1,-1,0,0
zavést,1,2,1,1,1,0,0
vyjmout,2,3,-1,-1,-1,0,0
dosáhnout,1,28,-27,-1,-1,0,0
vést,1,3,-2,-1,-1,0,0
citovat,1,7,-6,-1,-1,0,0
vztahovat,2,24,-22,-1,-1,0,0
mít,2,2,0,0,1,0,0
citovat,2,6,-4,-1,-1,0,0
využívat,2,4,-2,-1,-1,-1,0
vysvětlit,3,7,-4,-1,-1,0,0
zkoumat,2,3,-1,-1,-1,0,0
vést,1,10,-9,-1,-1,0,0
vypudit,1,3,-2,-1,-1,0,0
stát,3,3,0,0,-1,0,0
vidět,6,2,4,1,-1,0,0
pronásledovat,2,4,-2,-1,-1,0,0
vzít,5,2,-3,-1,1,0,0
mít,2,2,0,0,1,0,0
mít,5,2,-3,-1,1,0,0
moci,2,6,-4,-1,-1,0,0
zabudovat,2,19,-17,-1,-1,0,0
mít,3,2,-1,-1,1,0,0
ukrýt,4,5,1,1,1,0,0
rozdělit,8,8,0,0,-1,0,0
posuzovat,5,2,3,1,-1,0,0
zavírat,7,2,-5,-1,1,-1,0
rozšířit,2,5,-3,-1,-1,0,0
mít,6,3,-3,-1,1,0,0
pozorovat,2,2,0,0,1,0,0
mít,2,3,-1,-1,-1,0,0
vyvolávat,2,2,0,0,1,0,0
prostudovat,4,4,0,0,-1,0,0
používat,4,3,1,1,-1,0,0
moci,2,3,-1,-1,-1,0,0
vydávat,2,2,0,0,1,-1,0
zabývat,73,2,-71,-1,1,-1,0
pozorovat,1,5,-4,-1,-1,-1,0
provádět,2,4,2,1,1,0,0
uvádět,1,2,1,1,1,-1,0
dát,3,4,-1,-1,-1,0,0
být,1,2,-1,-1,-1,0,0
mít,3,2,-1,-1,1,0,0
použít,1,3,-2,-1,-1,0,0
dát,1,2,1,1,1,0,0
dobýt,3,6,-3,-1,-1,0,0
umožňovat,5,3,-2,-1,1,0,0
transplantovat,8,9,-1,-1,-1,0,0
najít,1,13,-12,-1,-1,-1,0
vést,1,12,-11,-1,-1,-1,0
psát,1,14,-13,-1,-1,-1,0
podnikat,3,4,-1,-1,-1,0,0
vystudovat,1,6,-5,-1,-1,0,0
vázat,2,2,0,0,-1,0,0
postavit,1,5,-4,-1,-1,0,0
připomínat,11,3,-8,-1,1,0,0
užívat,1,3,-2,-1,-1,0,0
věnovat,1,3,-2,-1,-1,0,0
přenášet,1,3,-2,-1,-1,0,0
zvýšit,6,3,3,1,-1,0,0
předpovídat,2,2,0,0,-1,0,0
představovat,2,4,2,1,1,0,0
zanechat,1,2,-1,-1,-1,-1,0
dosáhnout,5,7,-2,-1,-1,0,0
zřizovat,3,3,0,0,1,0,0
změřit,4,5,-1,-1,-1,0,0
provádět,7,2,-5,-1,1,0,0
pociťovat,6,5,-1,-1,1,0,0
vybírat,2,4,-2,-1,-1,0,0
prožít,3,3,0,0,-1,0,0
zařadit,6,11,-5,-1,-1,0,0
odpovídat,10,2,-8,-1,1,0,0
ovlivňovat,3,5,-2,-1,-1,0,0
využít,15,7,8,1,-1,0,0
navštěvovat,14,3,-11,-1,1,0,0
uveřejňovat,16,2,-14,-1,1,0,0
složit,1,2,-1,-1,-1,0,0
namítnout,2,2,0,0,-1,-1,0
mít,23,2,-21,-1,1,-1,0
vybrat,4,4,0,0,1,0,0
vést,3,14,-11,-1,-1,0,0
používat,2,3,1,1,1,0,0
zabránit,3,2,1,1,-1,0,0
potřebovat,5,3,2,1,-1,0,0
mít,2,4,-2,-1,-1,0,0
redukovat,2,6,-4,-1,-1,0,0
předpovídat,1,6,-5,-1,-1,0,0
přinést,5,3,-2,-1,1,0,0
vydat,10,2,-8,-1,1,0,0
rozlišit,4,11,-7,-1,-1,0,0
vidět,2,5,3,1,1,1,0
pozorovat,2,6,-4,-1,-1,0,0
mít,14,2,-12,-1,1,0,0
odhalit,2,3,1,1,1,0,0
odhánět,5,3,2,1,-1,0,0
usazovat,1,9,-8,-1,-1,0,0
vykládat,3,2,-1,-1,1,0,0
zavést,8,2,-6,-1,1,0,0
vidět,2,3,-1,-1,-1,0,0
naklást,1,3,-2,-1,-1,0,0
klást,1,3,-2,-1,-1,0,0
lákat,2,2,0,0,-1,0,0
mít,5,5,0,0,1,0,0
mít,3,5,-2,-1,-1,0,0
napojit,1,3,-2,-1,-1,0,0
narodit,4,2,-2,-1,1,0,0
přenést,6,2,-4,-1,1,0,0
přenést,1,3,-2,-1,-1,0,0
dát,2,2,0,0,1,0,0
využít,3,4,-1,-1,-1,0,0
pootočit,1,3,-2,-1,-1,0,0
najít,1,3,-2,-1,-1,0,0
proslovit,1,4,-3,-1,-1,0,0
mít,2,2,0,0,1,-1,0
propustit,11,3,-8,-1,1,0,0
kárat,2,8,-6,-1,-1,0,0
dostat,3,2,-1,-1,1,0,0
srovnat,1,7,-6,-1,-1,0,0
stávat,9,3,-6,-1,1,0,0
přijít,17,4,13,1,-1,0,0
využít,9,2,-7,-1,1,0,0
nosit,1,2,-1,-1,-1,0,0
nechat,2,2,0,0,1,-1,0
mít,4,2,-2,-1,1,0,0
vidět,1,7,-6,-1,-1,0,0
přivést,1,2,-1,-1,-1,0,0
mít,2,2,0,0,1,0,0
vytvořit,4,3,-1,-1,1,0,0
dodat,5,4,-1,-1,1,0,0
sestavit,2,6,-4,-1,-1,0,0
odstranit,1,2,1,1,1,0,0
lokalizovat,2,6,-4,-1,-1,0,0
detekovat,5,2,3,1,-1,0,0
vyřadit,3,2,1,1,-1,0,0
zvýšit,6,4,2,1,-1,0,0
mít,2,11,-9,-1,-1,0,0
získat,4,4,0,0,-1,0,0
vyjádřit,1,2,1,1,1,0,0
začínat,2,14,-12,-1,-1,0,0
obsahovat,6,6,0,0,-1,0,0
doporučovat,5,13,-8,-1,-1,0,0
připustit,4,9,-5,-1,-1,0,0
přinést,4,2,-2,-1,1,-1,0
padat,3,2,-1,-1,1,0,0
objevit,3,3,0,0,-1,0,0
sloužit,1,7,-6,-1,-1,0,0
mít,26,2,-24,-1,1,0,0
naleznout,1,8,-7,-1,-1,-1,0
registrovat,3,8,5,1,1,0,0
uvolnit,10,2,-8,-1,1,-1,0
dostávat,2,9,-7,-1,-1,0,0
vysílat,1,24,-23,-1,-1,0,0
modelovat,1,16,-15,-1,-1,0,0
vložit,4,2,-2,-1,1,0,0
měřit,9,4,5,1,-1,0,0
popisovat,2,4,-2,-1,-1,0,0
spočítat,2,2,0,0,-1,0,0
získat,9,3,-6,-1,1,0,0
zahrnout,8,3,-5,-1,1,0,0
používat,2,2,0,0,1,0,0
představovat,1,3,2,1,1,0,0
transformovat,2,8,-6,-1,-1,0,0
transformovat,2,8,-6,-1,-1,0,0
převádět,2,3,-1,-1,-1,0,0
poškodit,1,3,-2,-1,-1,-1,0
získat,3,4,1,1,1,0,0
mít,7,2,-5,-1,1,0,0
mít,6,2,-4,-1,1,0,0
znát,15,5,-10,-1,1,0,0
trávit,4,2,2,1,-1,0,0
regulovat,6,8,-2,-1,-1,0,0
vyšplhat,1,2,-1,-1,-1,0,0
předávat,6,4,-2,-1,1,0,0
pomáhat,1,6,-5,-1,-1,-1,0
postihnout,6,2,-4,-1,1,0,0
spatřovat,3,3,0,0,1,0,0
mít,9,3,-6,-1,1,1,0
prokázat,4,5,-1,-1,-1,0,0
seskupovat,4,6,-2,-1,-1,0,0
užít,3,2,1,1,-1,0,0
vyšetřovat,6,17,-11,-1,-1,0,0
rozlišit,12,3,-9,-1,1,0,0
užít,13,10,3,1,-1,0,0
vybírat,6,3,-3,-1,1,0,0
odečíst,6,11,-5,-1,-1,0,0
hrát,2,22,-20,-1,-1,0,0
posuzovat,2,9,-7,-1,-1,0,0
přidat,4,10,6,1,1,0,0
postrádat,2,3,1,1,1,0,0
preferovat,3,39,-36,-1,-1,0,0
protlačit,2,15,-13,-1,-1,0,0
odpírat,1,3,-2,-1,-1,0,0
vrhnout,2,2,0,0,1,0,0
vkládat,2,2,0,0,1,0,0
rozmnožovat,2,3,-1,-1,-1,0,0
uvádět,3,2,-1,-1,1,0,0
roznítit,2,4,-2,-1,-1,0,0
stávat,9,3,-6,-1,1,0,0
měřit,4,4,0,0,-1,0,0
vypracovat,6,3,-3,-1,1,0,0
nahradit,2,5,3,1,1,0,0
natahovat,1,2,1,1,1,-1,0
psát,2,2,0,0,-1,0,0
zařazovat,5,5,0,0,1,0,0
dosáhnout,13,3,-10,-1,1,0,0
obohatit,3,16,-13,-1,-1,0,0
doplňovat,1,11,-10,-1,-1,-1,0
tvořit,5,3,-2,-1,1,0,0
vykazovat,2,4,2,1,1,0,0
zhodnotit,4,3,1,1,-1,0,0
pozorovat,5,5,0,0,-1,0,0
vyvozovat,2,4,-2,-1,-1,0,0
mít,6,2,-4,-1,1,0,0
přijmout,2,2,0,0,1,0,0
redukovat,3,4,-1,-1,-1,0,0
dokázat,3,8,-5,-1,-1,0,0
přehodnotit,7,8,-1,-1,-1,0,0
označit,4,3,-1,-1,1,0,0
obrátit,1,3,-2,-1,-1,0,0
probouzet,2,3,1,1,1,0,0
zařadit,1,4,-3,-1,-1,0,0
ukázat,2,4,-2,-1,-1,0,0
zabalovat,1,4,-3,-1,-1,-1,0
krátit,2,7,-5,-1,-1,0,0
definovat,4,7,-3,-1,-1,0,0
vybudovat,2,5,-3,-1,-1,0,0
nalézt,3,14,11,1,1,0,0
udělat,1,3,-2,-1,-1,0,0
odchýlit,2,6,-4,-1,-1,0,0
dát,1,3,-2,-1,-1,0,0
srazit,1,2,-1,-1,-1,-1,0
přenášet,4,4,0,0,-1,0,0
používat,1,7,-6,-1,-1,0,0
vyslat,3,3,0,0,-1,0,0
mít,19,2,-17,-1,1,-1,0
mít,27,2,-25,-1,1,0,0
mít,13,2,-11,-1,1,0,0
nadřadit,3,2,1,1,-1,0,0
psát,2,15,-13,-1,-1,0,0
narušovat,4,6,-2,-1,-1,0,0
vyvolávat,2,11,-9,-1,-1,0,0
mít,2,4,2,1,1,0,0
ukazovat,1,10,-9,-1,-1,0,0
odříkat,2,2,0,0,1,0,0
zůstat,2,3,1,1,1,0,0
znát,1,3,-2,-1,-1,-1,0
dosáhnout,2,4,2,1,1,0,0
odtrhnout,2,4,2,1,1,0,0
zřídit,2,4,-2,-1,-1,0,0
mučit,1,15,-14,-1,-1,0,0
rozpoltit,8,3,5,1,-1,0,0
odhrabat,1,3,-2,-1,-1,0,0
vyjímat,2,2,0,0,1,0,0
naříznout,2,3,-1,-1,-1,0,0
zjišťovat,7,2,-5,-1,1,0,0
vynést,1,2,-1,-1,-1,0,0
převzít,1,5,-4,-1,-1,-1,0
chránit,1,2,-1,-1,-1,0,0
nalézt,2,12,-10,-1,-1,0,0
chránit,1,4,-3,-1,-1,0,0
chránit,1,6,-5,-1,-1,0,0
zaberanit,2,3,-1,-1,-1,0,0
nést,1,4,-3,-1,-1,0,0
opravit,2,9,-7,-1,-1,0,0
popisovat,15,5,10,1,-1,0,0
vytrhnout,1,9,-8,-1,-1,-1,0
vést,1,2,-1,-1,-1,0,0
tvořit,2,2,0,0,1,-1,0
propojit,3,8,-5,-1,-1,0,0
vést,2,3,-1,-1,-1,0,0
dávat,1,2,1,1,1,0,0
odebírat,1,2,1,1,1,0,0
mít,6,2,-4,-1,1,0,0
mít,23,2,-21,-1,1,0,0
udržet,9,2,-7,-1,1,0,0
používat,1,14,-13,-1,-1,0,0
chránit,1,4,-3,-1,-1,0,0
mít,1,3,-2,-1,-1,0,0
zapůjčit,6,2,-4,-1,1,0,0
mít,8,2,-6,-1,1,0,0
přivézt,3,2,-1,-1,1,0,0
najít,3,2,-1,-1,1,0,0
odhadnout,7,4,3,1,-1,0,0
nalézt,7,8,-1,-1,-1,0,0
uspořádat,6,19,-13,-1,-1,0,0
připravit,14,3,-11,-1,1,0,0
zvyšovat,4,4,0,0,-1,0,0
sahat,1,2,-1,-1,-1,-1,0
