Verb,NP_len,PP_len,Len_diff,Len,Arg_status,Pronominality,Order
kill,6,12,6,1,1,0,1
cause,1,4,3,1,1,0,1
manipulate,2,4,2,1,1,0,1
kidnap,1,2,1,1,1,1,1
decline,2,2,0,0,1,0,1
kill,13,2,-11,-1,1,0,1
push,3,6,3,1,1,0,1
punish,1,6,5,1,1,0,1
put,2,3,1,1,1,0,1
shoot,3,3,0,0,1,0,1
set,3,12,9,1,1,0,1
distinguish,5,3,-2,-1,1,0,1
donate,4,2,-2,-1,1,0,1
describe,2,6,4,1,1,0,1
send,5,3,-2,-1,1,0,1
remind,1,3,2,1,1,1,1
use,2,2,0,0,1,0,1
use,1,2,1,1,1,1,1
cause,6,3,-3,-1,1,0,1
report,1,2,1,1,1,1,1
treat,1,6,5,1,1,1,1
host,4,3,-1,-1,1,0,1
make,2,2,0,0,1,0,1
purge,3,8,5,1,1,0,1
defeat,2,3,1,1,1,0,1
arm,3,8,5,1,1,0,1
use,13,6,-7,-1,1,0,1
use,6,2,-4,-1,1,-1,1
put,4,3,-1,-1,1,0,1
pump,1,3,2,1,1,0,1
take,3,4,1,1,1,0,1
hoist,1,4,3,1,1,1,1
bring,1,3,2,1,1,0,1
characterize,3,3,0,0,1,0,1
make,2,10,8,1,1,0,1
confront,1,2,1,1,1,0,1
equate,1,2,1,1,1,0,1
ignore,2,9,7,1,1,0,1
give,1,7,6,1,1,0,1
make,4,3,-1,-1,1,0,1
launch,3,2,-1,-1,1,0,1
see,2,4,2,1,1,0,1
ally,1,26,25,1,1,1,1
publish,2,5,3,1,1,0,1
draw,1,21,20,1,1,0,1
beef,2,3,1,1,1,0,1
hold,7,6,-1,-1,1,0,1
precede,13,23,10,1,1,0,1
keep,3,2,-1,-1,1,0,1
have,2,2,0,0,1,0,1
tell,1,3,2,1,1,0,1
accept,3,3,0,0,1,0,1
reach,2,5,3,1,1,0,1
draw,1,21,20,1,1,0,1
gobble,1,9,8,1,1,0,1
take,3,2,-1,-1,1,0,1
divest,1,10,9,1,1,0,1
convert,1,4,3,1,1,0,1
understand,1,8,7,1,1,1,1
support,6,13,7,1,1,0,1
say,1,12,11,1,1,1,1
get,1,18,17,1,1,1,1
accept,1,4,3,1,1,0,1
back,1,9,8,1,1,0,1
leave,1,14,13,1,1,0,1
take,1,16,15,1,1,0,1
join,2,3,1,1,1,0,1
earn,2,4,2,1,1,0,1
earn,2,4,2,1,1,0,1
earn,12,5,-7,-1,1,0,1
earn,2,4,2,1,1,0,1
earn,2,4,2,1,1,0,1
bring,2,37,35,1,1,0,1
put,1,3,2,1,1,0,1
receive,2,3,1,1,1,0,1
fly,2,3,1,1,1,0,1
blame,1,7,6,1,1,0,1
do,1,5,4,1,1,1,1
regard,5,14,9,1,1,0,1
reduce,2,5,3,1,1,0,1
use,3,2,-1,-1,1,0,1
hand,3,8,5,1,1,0,1
bring,2,3,1,1,1,0,1
educate,2,5,3,1,1,0,1
abuse,6,3,-3,-1,1,0,1
describe,1,13,12,1,1,0,1
dismiss,1,16,15,1,1,0,1
replace,6,11,5,1,1,0,1
hurl,1,3,2,1,1,0,1
describe,3,6,3,1,1,-1,1
dismiss,3,7,4,1,1,0,1
see,1,9,8,1,1,1,1
assume,1,3,2,1,1,0,1
offer,6,4,-2,-1,1,0,1
have,3,3,0,0,1,0,1
root,5,10,5,1,1,0,1
share,2,5,3,1,1,0,1
answer,5,4,-1,-1,1,0,1
take,2,14,12,1,1,0,1
follow,3,3,0,0,1,0,1
harm,1,3,2,1,1,1,1
ask,2,3,1,1,1,0,1
wear,2,4,2,1,1,0,1
identify,10,3,-7,-1,1,0,1
recruit,1,4,3,1,1,1,1
run,1,4,3,1,1,0,1
open,1,4,3,1,1,1,1
sell,3,2,-1,-1,1,0,1
have,8,5,-3,-1,1,0,1
use,2,2,0,0,1,-1,1
involve,8,5,-3,-1,1,0,1
implicate,1,12,11,1,1,0,1
send,1,2,1,1,1,0,1
foresee,25,2,23,1,-1,0,1
take,3,3,0,0,1,0,1
carry,4,20,16,1,1,0,1
have,4,3,-1,-1,1,0,1
bring,1,7,6,1,1,0,1
foresee,25,2,23,1,-1,0,1
give,3,3,0,0,1,0,1
maintain,2,14,12,1,1,0,1
put,9,6,-3,-1,1,0,1
divide,12,10,-2,-1,1,0,1
feel,2,2,0,0,1,0,1
send,2,2,0,0,1,0,1
present,2,10,8,1,1,0,1
take,2,4,2,1,1,0,1
lead,3,17,14,1,1,0,1
strike,4,3,-1,-1,1,0,1
move,6,2,-4,-1,1,0,1
place,1,6,5,1,1,0,1
give,2,7,5,1,1,0,1
show,4,6,2,1,1,0,1
absent,1,2,1,1,1,0,1
give,2,2,0,0,1,-1,1
kill,8,15,7,1,1,0,1
pickle,3,5,2,1,1,0,1
scour,1,24,23,1,1,0,1
see,2,11,9,1,1,0,1
ask,1,7,6,1,1,1,1
organize,4,5,1,1,1,0,1
get,2,2,0,0,1,-1,1
take,2,5,3,1,1,0,1
broach,2,2,0,0,1,-1,1
offer,10,6,-4,-1,1,0,1
initiate,1,13,12,1,1,0,1
spend,2,2,0,0,1,-1,1
smuggle,1,2,1,1,1,0,1
take,7,2,-5,-1,1,0,1
receive,2,2,0,0,1,0,1
bang,2,3,1,1,1,0,1
contract,2,9,7,1,1,0,1
thank,6,3,-3,-1,1,0,1
send,1,2,1,1,1,1,1
bring,1,3,2,1,1,0,1
stir,4,4,0,0,1,0,1
return,1,5,4,1,1,1,1
take,1,3,2,1,1,0,1
marry,4,4,0,0,1,0,1
get,2,3,1,1,1,0,1
look,2,3,1,1,1,0,1
outsource,3,4,1,1,1,0,1
shout,1,2,1,1,1,-1,1
receive,2,4,2,1,1,0,1
absorb,2,4,2,1,1,0,1
see,2,6,4,1,1,0,1
cite,1,7,6,1,1,1,1
guide,2,5,3,1,1,0,1
put,2,2,0,0,1,-1,1
put,2,2,0,0,1,0,1
detect,7,3,-4,-1,1,0,1
grip,2,5,3,1,1,0,1
have,7,3,-4,-1,1,0,1
beat,2,3,1,1,1,0,1
hold,5,2,-3,-1,1,0,1
curate,6,3,-3,-1,1,0,1
give,7,3,-4,-1,1,0,1
make,8,7,-1,-1,1,0,1
use,3,16,13,1,1,0,1
take,7,3,4,1,-1,0,1
provide,5,3,-2,-1,1,0,1
regard,2,18,16,1,1,-1,1
share,12,2,10,1,-1,1,1
devote,4,13,9,1,1,0,1
develop,9,5,4,1,-1,0,1
blame,2,19,17,1,1,0,1
tell,1,2,1,1,1,0,1
destroy,6,4,-2,-1,1,0,1
put,3,8,5,1,1,0,1
put,1,6,5,1,1,0,1
reduce,2,10,8,1,1,0,1
win,2,4,2,1,1,0,1
provide,1,5,4,1,1,1,1
reach,2,7,5,1,1,0,1
watch,2,4,2,1,1,0,1
eat,2,4,2,1,1,0,1
solve,3,7,4,1,1,0,1
brainwash,3,5,2,1,1,0,1
blame,5,6,1,1,1,1,1
perform,1,4,3,1,1,0,1
use,3,4,1,1,1,0,1
use,1,6,5,1,1,0,1
open,1,6,5,1,1,-1,1
shout,1,4,3,1,1,0,1
carry,3,3,0,0,1,0,1
execute,4,5,1,1,1,0,1
invite,1,3,2,1,1,1,1
treat,1,4,3,1,1,1,1
have,6,5,-1,-1,1,0,1
send,4,3,-1,-1,1,0,1
knock,3,4,1,1,1,0,1
demand,1,3,2,1,1,0,1
define,5,3,-2,-1,1,0,1
adapt,1,2,1,1,1,1,1
open,1,3,2,1,1,1,1
reach,1,6,5,1,1,1,1
apply,2,4,2,1,1,0,1
incite,3,2,-1,-1,1,0,1
perform,3,16,13,1,1,0,1
include,8,3,5,1,-1,0,1
send,1,2,1,1,1,0,1
pave,2,4,2,1,1,0,1
suffer,2,8,6,1,1,0,1
seize,3,9,6,1,1,0,1
fly,3,6,3,1,1,0,1
provide,2,2,0,0,1,0,1
tell,5,3,-2,-1,1,0,1
want,1,4,3,1,1,0,1
case,2,4,2,1,1,0,1
study,2,4,2,1,1,0,1
weaponize,1,3,2,1,1,0,1
seek,3,28,25,1,1,0,1
benefit,1,4,3,1,1,1,1
strike,2,7,5,1,1,0,1
have,9,21,12,1,1,0,1
use,1,3,2,1,1,1,1
confirm,2,5,3,1,1,0,1
weaponize,1,6,5,1,1,0,1
give,1,4,3,1,1,1,1
send,6,3,-3,-1,1,0,1
collect,3,3,0,0,1,0,1
achieve,4,7,3,1,1,0,1
provide,1,13,12,1,1,0,1
perceive,1,2,1,1,1,1,1
receive,2,3,1,1,1,0,1
tell,1,11,10,1,1,0,1
allow,3,6,3,1,1,0,1
separate,1,2,1,1,1,0,1
call,1,4,3,1,1,0,1
contract,2,2,0,0,1,0,1
obtain,3,2,-1,-1,1,0,1
learn,1,5,4,1,1,0,1
view,1,2,1,1,1,1,1
express,3,19,16,1,1,0,1
have,2,2,0,0,1,0,1
expel,2,2,0,0,1,0,1
underscore,2,4,2,1,1,-1,1
treat,1,2,1,1,1,1,1
lead,2,10,8,1,1,0,1
ask,2,17,15,1,1,0,1
invoke,2,6,4,1,1,0,1
leak,12,3,9,1,-1,0,1
forward,1,2,1,1,1,0,1
receive,4,2,-2,-1,1,-1,1
send,2,2,0,0,1,0,1
request,2,2,0,0,1,-1,1
revalue,3,5,2,1,1,0,1
decline,2,2,0,0,1,0,1
hire,8,3,-5,-1,1,0,1
compare,1,2,1,1,1,0,1
compare,7,13,6,1,1,0,1
place,4,5,1,1,1,0,1
give,2,2,0,0,1,0,1
give,1,4,3,1,1,0,1
include,2,4,2,1,1,0,1
pass,6,3,-3,-1,1,-1,1
provide,2,2,0,0,1,-1,1
transmit,9,2,-7,-1,1,0,1
transmit,9,2,-7,-1,1,0,1
transmit,9,2,-7,-1,1,0,1
have,1,2,1,1,1,0,1
have,1,2,1,1,1,0,1
move,3,2,-1,-1,1,0,1
hire,2,5,3,1,1,0,1
communicate,2,2,0,0,1,-1,1
run,1,2,1,1,1,1,1
meet,2,14,12,1,1,0,1
xferr,2,3,1,1,1,0,1
see,2,2,0,0,1,0,1
xferr,2,3,1,1,1,0,1
see,2,2,0,0,1,0,1
purchase,1,7,6,1,1,0,1
add,2,3,1,1,1,0,1
purchase,2,4,2,1,1,0,1
put,1,3,2,1,1,1,1
execute,3,2,-1,-1,1,0,1
show,5,9,4,1,1,0,1
send,4,6,2,1,1,0,1
condition,5,6,1,1,1,0,1
put,1,2,1,1,1,0,1
iron,2,3,1,1,1,0,1
reference,5,6,1,1,1,0,1
write,1,5,4,1,1,1,1
write,1,4,3,1,1,1,1
run,4,3,-1,-1,1,0,1
send,2,5,3,1,1,0,1
draft,3,2,-1,-1,1,0,1
introduce,1,8,7,1,1,1,1
do,1,5,4,1,1,1,1
do,1,3,2,1,1,0,1
have,5,6,1,1,1,0,1
share,1,2,1,1,1,0,1
attribute,2,2,0,0,1,-1,1
do,3,3,0,0,1,0,1
get,2,4,2,1,1,0,1
transfer,1,2,1,1,1,0,1
watch,2,2,0,0,1,0,1
pay,1,5,4,1,1,1,1
make,2,2,0,0,1,0,1
pay,1,5,4,1,1,1,1
make,2,2,0,0,1,0,1
reconfirm,7,2,5,1,-1,0,1
pay,1,5,4,1,1,1,1
make,2,2,0,0,1,0,1
quote,2,4,2,1,1,0,1
see,1,5,4,1,1,1,1
have,4,3,-1,-1,1,0,1
receive,2,2,0,0,1,0,1
keep,1,3,2,1,1,1,1
send,6,3,-3,-1,1,0,1
delete,3,4,1,1,1,0,1
discuss,1,3,2,1,1,1,1
fax,3,8,5,1,1,0,1
achieve,1,3,2,1,1,0,1
do,7,6,-1,-1,1,0,1
send,3,2,-1,-1,1,-1,1
have,2,3,1,1,1,0,1
create,4,2,-2,-1,1,-1,1
schedule,1,5,4,1,1,0,1
thank,2,3,1,1,1,1,1
leave,1,3,2,1,1,0,1
do,1,3,2,1,1,1,1
do,1,3,2,1,1,1,1
step,1,4,3,1,1,1,1
drive,4,4,0,0,1,0,1
put,2,5,3,1,1,0,1
allocate,2,2,0,0,1,0,1
put,1,3,2,1,1,1,1
change,5,2,-3,-1,1,-1,1
prepare,1,7,6,1,1,0,1
have,3,2,-1,-1,1,0,1
watch,1,4,3,1,1,1,1
put,1,2,1,1,1,1,1
have,1,3,2,1,1,0,1
take,1,12,11,1,1,0,1
show,2,2,0,0,1,0,1
receive,2,2,0,0,1,0,1
notify,2,3,1,1,1,0,1
delete,2,3,1,1,1,0,1
have,1,3,2,1,1,0,1
head,2,2,0,0,1,0,1
call,1,2,1,1,1,1,1
transport,1,3,2,1,1,0,1
have,1,3,2,1,1,0,1
see,8,3,-5,-1,1,0,1
use,3,8,5,1,1,0,1
submit,2,3,1,1,1,0,1
call,1,2,1,1,1,1,1
procure,2,3,1,1,1,0,1
include,2,3,1,1,1,0,1
thank,1,12,11,1,1,1,1
take,2,2,0,0,1,0,1
sale,3,4,1,1,1,0,1
place,2,3,1,1,1,0,1
have,4,3,-1,-1,1,0,1
pay,2,2,0,0,1,-1,1
ck,3,6,3,1,1,0,1
send,1,2,1,1,1,1,1
address,2,4,2,1,1,0,1
have,3,2,-1,-1,1,0,1
execute,3,5,2,1,1,0,1
address,2,4,2,1,1,0,1
get,2,2,0,0,1,-1,1
have,3,2,-1,-1,1,0,1
execute,3,5,2,1,1,0,1
address,2,4,2,1,1,0,1
send,1,2,1,1,1,1,1
say,1,2,1,1,1,0,1
want,2,4,2,1,1,0,1
do,3,2,-1,-1,1,0,1
have,3,2,-1,-1,1,0,1
see,3,2,-1,-1,1,0,1
take,4,3,-1,-1,1,0,1
sign,1,3,2,1,1,0,1
trigger,2,11,9,1,1,0,1
have,2,3,1,1,1,0,1
put,5,2,3,1,-1,0,1
add,8,8,0,0,1,0,1
roll,5,7,2,1,1,0,1
execute,1,3,2,1,1,0,1
write,2,3,1,1,1,1,1
drag,1,8,7,1,1,1,1
prepare,1,21,20,1,1,1,1
get,2,3,1,1,1,0,1
see,1,2,1,1,1,1,1
see,2,4,2,1,1,0,1
pin,1,3,2,1,1,0,1
pass,2,3,1,1,1,0,1
keep,3,3,0,0,1,0,1
pay,2,2,0,0,1,0,1
assist,1,2,1,1,1,0,1
pass,2,3,1,1,1,0,1
accept,4,3,-1,-1,1,0,1
keep,7,3,-4,-1,1,0,1
take,1,4,3,1,1,0,1
add,4,7,3,1,1,0,1
tell,1,3,2,1,1,1,1
fit,4,5,1,1,1,0,1
hear,2,2,0,0,1,0,1
fly,1,2,1,1,1,0,1
forward,2,2,0,0,1,-1,1
take,1,2,1,1,1,-1,1
have,5,3,-2,-1,1,0,1
send,2,3,1,1,1,0,1
deliver,2,2,0,0,1,-1,1
leave,3,2,-1,-1,1,0,1
ok'd,4,5,1,1,1,0,1
amend,7,3,-4,-1,1,0,1
track,2,4,2,1,1,0,1
get,1,3,2,1,1,0,1
contact,6,5,-1,-1,1,0,1
contact,10,5,-5,-1,1,0,1
thank,1,3,2,1,1,1,1
raise,3,20,17,1,1,0,1
discuss,2,2,0,0,1,0,1
find,2,8,6,1,1,0,1
make,1,5,4,1,1,0,1
walk,1,2,1,1,1,1,1
take,2,2,0,0,1,0,1
make,1,5,4,1,1,0,1
walk,1,2,1,1,1,1,1
schedule,1,4,3,1,1,1,1
receive,2,3,1,1,1,0,1
need,3,10,7,1,1,0,1
contact,1,3,2,1,1,1,1
devote,5,6,1,1,1,0,1
have,2,34,32,1,1,0,1
thank,2,4,2,1,1,1,1
turn,2,5,3,1,1,0,1
use,3,5,2,1,1,0,1
proceed,2,2,0,0,1,0,1
receive,1,2,1,1,1,1,1
delete,1,3,2,1,1,1,1
disclose,2,2,0,0,1,-1,1
add,2,3,1,1,1,0,1
communicate,1,3,2,1,1,1,1
take,2,2,0,0,1,-1,1
add,6,3,-3,-1,1,0,1
add,2,3,1,1,1,0,1
deliver,3,2,-1,-1,1,0,1
discuss,2,2,0,0,-1,0,1
investigate,15,6,-9,-1,1,0,1
replace,3,4,1,1,1,0,1
reconcile,4,6,2,1,1,0,1
call,1,2,1,1,1,1,1
take,7,5,-2,-1,1,0,1
recommend,1,4,3,1,1,1,1
take,7,5,-2,-1,1,0,1
recommend,1,4,3,1,1,1,1
take,7,5,-2,-1,1,0,1
do,2,8,6,1,1,0,1
create,6,2,-4,-1,1,0,1
deduct,3,6,3,1,1,0,1
use,7,3,-4,-1,1,0,1
provide,4,3,-1,-1,1,0,1
manage,3,6,3,1,1,0,1
alert,1,8,7,1,1,1,1
complete,1,5,4,1,1,1,1
owe,8,11,3,1,1,0,1
communicate,11,2,9,1,-1,1,1
access,3,2,-1,-1,1,0,1
review,5,7,2,1,1,0,1
run,2,6,4,1,1,0,1
have,3,4,1,1,1,0,1
forward,3,2,-1,-1,1,0,1
discuss,1,2,1,1,1,0,1
send,1,2,1,1,1,1,1
visit,5,7,2,1,1,0,1
see,1,3,2,1,1,1,1
send,2,2,0,0,1,-1,1
use,2,5,3,1,1,0,1
provide,1,6,5,1,1,1,1
communicate,2,6,4,1,1,0,1
go,4,10,6,1,1,0,1
forward,20,3,17,1,-1,0,1
introduce,1,5,4,1,1,0,1
know,22,2,20,1,-1,0,1
call,1,5,4,1,1,1,1
thank,1,3,2,1,1,1,1
complete,6,5,-1,-1,1,0,1
contact,3,6,3,1,1,0,1
mail,1,3,2,1,1,1,1
mail,1,3,2,1,1,1,1
contact,7,8,1,1,1,0,1
thank,1,3,2,1,1,1,1
link,2,3,1,1,1,0,1
establish,6,4,-2,-1,1,0,1
have,4,5,1,1,1,0,1
guarantee,1,8,7,1,1,0,1
accept,1,8,7,1,1,0,1
read,4,3,-1,-1,1,0,1
return,2,3,1,1,1,0,1
need,4,3,-1,-1,1,0,1
add,4,4,0,0,1,0,1
establish,7,4,-3,-1,1,0,1
link,2,3,1,1,1,0,1
establish,6,4,-2,-1,1,0,1
have,4,5,1,1,1,0,1
leave,2,3,1,1,1,0,1
disclose,6,2,4,1,-1,0,1
use,2,4,2,1,1,0,1
see,2,6,4,1,1,0,1
take,1,2,1,1,1,0,1
take,2,2,0,0,1,0,1
contact,1,26,25,1,1,1,1
shadow,7,5,-2,-1,1,0,1
print,2,2,0,0,1,-1,1
communicate,2,4,2,1,1,0,1
establish,3,5,2,1,1,0,1
assist,1,3,2,1,1,1,1
thank,1,7,6,1,1,1,1
receive,1,2,1,1,1,1,1
delete,1,3,2,1,1,1,1
disclose,2,2,0,0,1,-1,1
reschedule,3,14,11,1,1,0,1
forward,6,2,4,1,-1,1,1
fax,1,2,1,1,1,0,1
reduce,3,3,0,0,1,0,1
replace,2,4,2,1,1,0,1
get,2,2,0,0,1,1,1
sell,1,6,5,1,1,0,1
draft,6,4,-2,-1,1,0,1
thank,1,3,2,1,1,1,1
copy,1,5,4,1,1,1,1
draft,6,4,-2,-1,1,0,1
thank,1,3,2,1,1,1,1
provide,5,4,-1,-1,1,0,1
thank,1,3,2,1,1,1,1
maintain,8,6,-2,-1,1,0,1
offer,6,3,-3,-1,1,0,1
moderate,1,4,3,1,1,0,1
provide,6,16,10,1,1,0,1
see,1,5,4,1,1,1,1
make,2,3,1,1,1,0,1
make,2,3,1,1,1,0,1
take,1,5,4,1,1,1,1
throw,4,6,2,1,1,0,1
finger,1,3,2,1,1,1,1
pose,3,2,-1,-1,1,0,1
supply,1,15,14,1,1,1,1
single,3,3,0,0,1,0,1
specify,5,3,-2,-1,1,0,1
thank,1,3,2,1,1,1,1
contact,1,3,2,1,1,1,1
mention,3,2,-1,-1,1,-1,1
involve,5,9,4,1,1,0,1
buy,2,7,5,1,1,0,1
get,6,2,-4,-1,1,0,1
collect,2,2,0,0,1,0,1
combine,6,5,-1,-1,1,0,1
highlight,3,3,0,0,1,0,1
have,1,3,2,1,1,0,1
explain,1,2,1,1,1,-1,1
accompany,1,2,1,1,1,1,1
notify,2,6,4,1,1,0,1
send,2,5,3,1,1,0,1
plan,2,4,2,1,1,0,1
forward,2,7,5,1,1,0,1
conduct,3,3,0,0,1,0,1
provide,1,3,2,1,1,1,1
insert,1,3,2,1,1,0,1
change,3,3,0,0,1,0,1
add,2,6,4,1,1,0,1
capitalize,3,8,5,1,1,0,1
add,3,9,6,1,1,0,1
insert,2,6,4,1,1,0,1
delete,2,4,2,1,1,0,1
incorporate,18,4,-14,-1,1,0,1
find,9,3,-6,-1,1,0,1
collect,9,3,-6,-1,1,0,1
reflect,1,3,2,1,1,0,1
include,3,3,0,0,1,0,1
include,18,12,-6,-1,1,0,1
cover,2,9,7,1,1,0,1
use,1,9,8,1,1,1,1
drive,2,6,4,1,1,0,1
copy,5,3,-2,-1,1,0,1
take,2,3,1,1,1,0,1
fax,12,2,10,1,-1,1,1
reconcile,2,3,1,1,1,0,1
request,13,6,-7,-1,1,0,1
pay,1,3,2,1,1,0,1
put,3,3,0,0,1,0,1
purchase,5,2,-3,-1,1,0,1
put,2,3,1,1,1,0,1
receive,4,4,0,0,1,0,1
request,13,6,-7,-1,1,0,1
pay,1,3,2,1,1,0,1
change,2,4,2,1,1,0,1
send,2,2,0,0,1,0,1
include,2,17,15,1,1,0,1
notify,1,3,2,1,1,1,1
change,2,4,2,1,1,0,1
send,2,2,0,0,1,0,1
call,1,2,1,1,1,1,1
confirm,5,2,-3,-1,1,0,1
complete,2,7,5,1,1,0,1
put,3,3,0,0,1,0,1
purchase,5,2,-3,-1,1,0,1
put,2,3,1,1,1,0,1
receive,4,4,0,0,1,0,1
abandon,1,2,1,1,1,0,1
serve,2,11,9,1,1,0,1
earn,2,3,1,1,1,0,1
push,2,5,3,1,1,0,1
make,3,3,0,0,1,0,1
take,1,4,3,1,1,0,1
provide,5,3,-2,-1,1,0,1
refer,2,5,3,1,1,0,1
file,1,6,5,1,1,0,1
sow,1,3,2,1,1,0,1
make,2,4,2,1,1,0,1
withhold,1,2,1,1,1,0,1
move,2,5,3,1,1,0,1
do,1,2,1,1,1,0,1
make,2,5,3,1,1,0,1
recreate,2,3,1,1,1,0,1
have,7,2,-5,-1,1,0,1
advise,1,2,1,1,1,0,1
change,3,3,0,0,1,0,1
spend,1,2,1,1,1,0,1
bill,5,2,-3,-1,1,0,1
get,2,2,0,0,1,0,1
receive,1,2,1,1,1,1,1
delete,1,3,2,1,1,1,1
disclose,2,2,0,0,1,-1,1
thank,1,3,2,1,1,1,1
remind,1,4,3,1,1,1,1
receive,5,2,-3,-1,1,0,1
receive,5,2,-3,-1,1,0,1
pass,31,3,28,1,-1,0,1
deliver,1,4,3,1,1,1,1
receive,2,2,0,0,1,0,1
notify,1,3,2,1,1,1,1
give,3,2,-1,-1,1,0,1
have,2,12,10,1,1,0,1
provide,1,19,18,1,1,1,1
post,2,5,3,1,1,0,1
keep,2,3,1,1,1,0,1
destroy,1,14,13,1,1,0,1
blame,2,2,0,0,1,1,1
sacrifice,1,6,5,1,1,0,1
give,1,3,2,1,1,0,1
report,1,4,3,1,1,0,1
receive,6,10,4,1,1,0,1
accept,3,4,1,1,1,0,1
treat,2,4,2,1,1,0,1
create,6,6,0,0,1,-1,1
add,3,5,2,1,1,0,1
place,3,7,4,1,1,0,1
stamp,2,3,1,1,1,0,1
start,2,6,4,1,1,0,1
attack,3,3,0,0,1,0,1
see,7,4,-3,-1,1,0,1
knock,1,3,2,1,1,1,1
throw,3,3,0,0,1,0,1
throw,1,3,2,1,1,0,1
seek,1,4,3,1,1,0,1
have,2,6,4,1,1,0,1
receive,3,2,-1,-1,1,0,1
risk,2,4,2,1,1,0,1
defend,5,6,1,1,1,0,1
throw,2,3,1,1,1,0,1
start,3,2,-1,-1,1,0,1
suggest,3,3,0,0,1,0,1
present,2,4,2,1,1,0,1
get,5,6,1,1,1,0,1
see,1,12,11,1,1,1,1
bring,1,3,2,1,1,1,1
keep,3,3,0,0,1,0,1
have,2,3,1,1,1,0,1
check,6,6,0,0,1,0,1
add,1,6,5,1,1,0,1
visit,1,3,2,1,1,1,1
prepare,2,2,0,0,1,-1,1
paste,1,3,2,1,1,1,1
take,1,5,4,1,1,1,1
write,1,3,2,1,1,1,1
serve,2,9,7,1,1,0,1
acquire,4,12,8,1,1,0,1
acquire,6,10,4,1,1,0,1
remove,1,2,1,1,1,1,1
cost,14,10,-4,-1,1,0,1
transfer,16,3,-13,-1,1,0,1
make,2,9,7,1,1,0,1
hit,2,2,0,0,1,0,1
hack,2,7,5,1,1,0,1
drop,8,3,-5,-1,1,0,1
view,2,3,1,1,1,0,1
mobilise,3,7,4,1,1,0,1
hit,6,14,8,1,1,0,1
approve,7,4,-3,-1,1,0,1
increase,6,9,3,1,1,0,1
give,3,2,-1,-1,1,0,1
donate,1,8,7,1,1,1,1
put,1,3,2,1,1,1,1
check,6,5,-1,-1,1,0,1
raise,1,2,1,1,1,-1,1
win,2,5,3,1,1,0,1
forward,1,4,3,1,1,1,1
have,4,3,-1,-1,1,0,1
contribute,3,4,1,1,1,0,1
donate,1,5,4,1,1,1,1
provide,1,5,4,1,1,0,1
prompt,6,3,-3,-1,1,0,1
buy,1,3,2,1,1,0,1
pay,2,3,1,1,1,0,1
invest,3,17,14,1,1,0,1
supply,1,7,6,1,1,1,1
refer,11,6,-5,-1,1,0,1
overtake,1,12,11,1,1,0,1
outbid,1,19,18,1,1,1,1
sell,4,9,5,1,1,0,1
wield,8,15,7,1,1,0,1
merge,2,8,6,1,1,0,1
try,1,5,4,1,1,1,1
feel,5,4,-1,-1,1,0,1
surround,1,3,2,1,1,1,1
repeat,5,3,2,1,-1,0,1
extend,7,4,-3,-1,1,0,1
collect,1,21,20,1,1,0,1
add,2,3,1,1,1,0,1
call,1,11,10,1,1,1,1
thank,1,6,5,1,1,1,1
deny,2,4,2,1,1,0,1
coerce,1,2,1,1,1,0,1
affirm,3,3,0,0,1,0,1
favor,6,2,-4,-1,1,0,1
commit,1,18,17,1,1,1,1
give,4,3,-1,-1,1,0,1
recite,1,2,1,1,1,0,1
have,2,4,2,1,1,0,1
regret,1,5,4,1,1,1,1
give,4,3,-1,-1,1,0,1
send,1,9,8,1,1,0,1
keep,1,8,7,1,1,0,1
vault,3,20,17,1,1,0,1
launch,1,2,1,1,1,0,1
develop,7,5,-2,-1,1,0,1
follow,6,8,2,1,1,0,1
send,2,29,27,1,1,0,1
follow,5,3,-2,-1,1,0,1
extend,2,2,0,0,1,0,1
leave,3,2,-1,-1,1,0,1
make,1,3,2,1,1,1,1
circle,2,2,0,0,1,0,1
get,2,6,4,1,1,0,1
put,1,2,1,1,1,1,1
sell,1,12,11,1,1,1,1
have,3,3,0,0,1,0,1
find,1,3,2,1,1,1,1
put,2,4,2,1,1,0,1
do,3,3,0,0,1,1,1
email,1,2,1,1,1,0,1
do,1,3,2,1,1,1,1
paste,2,12,10,1,1,-1,1
keep,4,2,-2,-1,1,0,1
build,2,3,1,1,1,0,1
find,1,4,3,1,1,1,1
get,1,3,2,1,1,0,1
spend,3,3,0,0,1,0,1
pay,2,3,1,1,1,0,1
put,1,4,3,1,1,1,1
place,2,6,4,1,1,0,1
mail,3,4,1,1,1,0,1
take,4,7,3,1,1,0,1
add,2,6,4,1,1,0,1
post,3,6,3,1,1,0,1
look,2,2,0,0,-1,1,1
retain,7,7,0,0,1,0,1
wrap,4,3,-1,-1,1,0,1
add,3,3,0,0,1,0,1
put,2,6,4,1,1,0,1
drag,2,6,4,1,1,0,1
select,1,4,3,1,1,0,1
copy,3,5,2,1,1,0,1
place,2,7,5,1,1,0,1
paste,5,3,-2,-1,1,0,1
add,2,3,1,1,1,0,1
save,4,4,0,0,1,0,1
do,2,3,1,1,1,0,1
post,2,4,2,1,1,0,1
select,1,4,3,1,1,0,1
dust,2,3,1,1,1,0,1
see,3,3,0,0,1,0,1
shoot,2,4,2,1,1,0,1
bring,3,2,-1,-1,1,0,1
release,1,3,2,1,1,1,1
give,2,3,1,1,1,0,1
spend,3,10,7,1,1,0,1
trigger,4,2,-2,-1,1,0,1
mean,4,2,-2,-1,1,0,1
provide,1,10,9,1,1,0,1
provide,4,3,-1,-1,1,0,1
remove,1,5,4,1,1,1,1
establish,3,4,1,1,1,0,1
attack,1,11,10,1,1,0,1
accommodate,2,3,1,1,1,0,1
extend,3,5,2,1,1,0,1
release,4,3,-1,-1,1,0,1
catch,1,4,3,1,1,1,1
alter,4,6,2,1,1,0,1
set,4,3,-1,-1,1,0,1
cock,2,3,1,1,1,0,1
restore,1,3,2,1,1,0,1
use,2,3,1,1,1,0,1
use,2,5,3,1,1,0,1
want,1,20,19,1,1,0,1
work,2,6,4,1,1,0,1
make,1,4,3,1,1,0,1
thank,1,3,2,1,1,1,1
change,2,4,2,1,1,0,1
win,3,3,0,0,1,0,1
visit,3,4,1,1,1,0,1
experience,1,3,2,1,1,0,1
prevent,1,6,5,1,1,0,1
deserve,2,2,0,0,1,1,1
fly,5,2,-3,-1,1,0,1
take,1,3,2,1,1,0,1
attract,2,3,1,1,1,0,1
have,1,2,1,1,1,0,1
bring,2,5,3,1,1,0,1
mean,2,2,0,0,1,-1,1
put,2,3,1,1,1,0,1
fill,2,4,2,1,1,0,1
change,2,3,1,1,1,0,1
hinder,1,5,4,1,1,1,1
get,7,2,-5,-1,1,0,1
apply,3,14,11,1,1,0,1
infuse,2,6,4,1,1,0,1
carry,1,11,10,1,1,1,1
bring,2,11,9,1,1,0,1
win,3,2,-1,-1,1,0,1
visit,1,2,1,1,1,0,1
write,2,7,5,1,1,0,1
enter,1,4,3,1,1,1,1
identify,1,2,1,1,1,0,1
treat,3,5,2,1,1,0,1
beat,2,6,4,1,1,0,1
play,1,5,4,1,1,0,1
include,1,3,2,1,1,0,1
defeat,3,2,-1,-1,1,0,1
beat,3,5,2,1,1,0,1
beat,2,2,0,0,1,0,1
take,3,3,0,0,1,0,1
strip,2,9,7,1,1,1,1
distinguish,1,3,2,1,1,0,1
end,1,3,2,1,1,0,1
do,1,3,2,1,1,0,1
drag,1,3,2,1,1,1,1
hold,3,4,1,1,1,0,1
plunge,2,2,0,0,1,-1,1
seal,1,4,3,1,1,1,1
send,1,7,6,1,1,1,1
kill,1,4,3,1,1,1,1
frighten,1,3,2,1,1,0,1
give,2,14,12,1,1,0,1
take,2,15,13,1,1,0,1
preach,1,3,2,1,1,1,1
cause,17,2,15,1,-1,0,1
produce,1,3,2,1,1,0,1
provide,1,3,2,1,1,0,1
show,4,4,0,0,1,0,1
see,2,3,1,1,1,0,1
tell,1,4,3,1,1,0,1
take,4,9,5,1,1,0,1
deceive,1,3,2,1,1,0,1
weaken,2,2,0,0,1,0,1
email,2,3,1,1,1,0,1
prepare,3,15,12,1,1,0,1
bring,4,2,-2,-1,1,0,1
hold,3,3,0,0,1,0,1
bunker,1,4,3,1,1,1,1
put,1,15,14,1,1,0,1
hold,3,3,0,0,1,0,1
raise,2,5,3,1,1,0,1
reach,2,3,1,1,1,0,1
throw,3,6,3,1,1,0,1
suffer,8,5,-3,-1,1,0,1
throw,20,4,-16,-1,1,0,1
bring,1,6,5,1,1,0,1
run,5,5,0,0,1,0,1
force,5,4,-1,-1,1,0,1
hold,7,6,-1,-1,1,0,1
put,2,3,1,1,1,0,1
have,3,3,0,0,1,0,1
take,1,3,2,1,1,1,1
overwhelm,2,3,1,1,1,0,1
do,2,7,5,1,1,0,1
put,3,4,1,1,1,0,1
surpass,8,4,4,1,-1,0,1
add,24,2,22,1,-1,1,1
hurl,3,5,2,1,1,0,1
envelop,3,13,10,1,1,0,1
develop,3,7,4,1,1,0,1
assist,1,3,2,1,1,0,1
bring,1,3,2,1,1,0,1
aid,1,3,2,1,1,0,1
garner,2,4,2,1,1,0,1
provide,6,11,5,1,1,0,1
risk,3,6,3,1,1,0,1
mention,9,8,-1,-1,1,0,1
cut,2,4,2,1,1,0,1
relay,2,5,3,1,1,0,1
cite,2,4,2,1,1,0,1
mention,3,8,5,1,1,0,1
mention,3,8,5,1,1,0,1
mention,7,8,1,1,1,0,1
mention,2,8,6,1,1,0,1
give,5,3,-2,-1,1,0,1
build,3,2,-1,-1,1,0,1
do,1,2,1,1,1,1,1
outfit,3,3,0,0,1,0,1
secure,2,4,2,1,1,0,1
take,1,2,1,1,1,0,1
lose,2,8,6,1,1,0,1
provide,1,3,2,1,1,0,1
reimburse,1,11,10,1,1,0,1
fight,1,2,1,1,1,0,1
wear,5,5,0,0,1,0,1
lose,3,7,4,1,1,0,1
further,6,2,-4,-1,1,0,1
further,3,2,-1,-1,1,0,1
have,7,2,-5,-1,1,0,1
use,2,3,1,1,1,0,1
find,4,3,-1,-1,1,0,1
find,3,3,0,0,1,0,1
find,3,3,0,0,1,0,1
describe,1,21,20,1,1,1,1
accept,2,4,2,1,1,0,1
interpret,2,6,4,1,1,0,1
describe,1,4,3,1,1,1,1
use,3,5,2,1,1,0,1
show,2,4,2,1,1,0,1
post,5,2,-3,-1,1,0,1
employ,3,8,5,1,1,-1,1
want,3,12,9,1,1,0,1
recommend,1,3,2,1,1,1,1
talk,1,2,1,1,1,0,1
get,1,2,1,1,1,1,1
wash,2,3,1,1,1,0,1
tick,1,3,2,1,1,1,1
push,1,3,2,1,1,1,1
keep,2,6,4,1,1,0,1
get,2,2,0,0,1,0,1
put,2,3,1,1,1,0,1
set,1,2,1,1,1,0,1
find,1,10,9,1,1,0,1
post,2,5,3,1,1,0,1
use,2,9,7,1,1,0,1
take,3,2,-1,-1,1,0,1
take,2,4,2,1,1,0,1
put,2,2,0,0,1,0,1
put,2,9,7,1,1,0,1
make,1,3,2,1,1,1,1
have,1,5,4,1,1,0,1
buy,2,2,0,0,1,0,1
take,1,3,2,1,1,1,1
put,5,2,-3,-1,1,-1,1
buy,2,5,3,1,1,0,1
put,1,4,3,1,1,1,1
take,1,5,4,1,1,0,1
move,3,5,2,1,1,0,1
move,8,4,-4,-1,1,0,1
provide,8,3,-5,-1,1,0,1
eat,2,4,2,1,1,0,1
move,3,4,1,1,1,0,1
own,1,4,3,1,1,0,1
take,2,2,0,0,1,0,1
pour,2,3,1,1,1,0,1
put,2,10,8,1,1,0,1
change,3,10,7,1,1,0,1
allot,2,2,0,0,1,0,1
have,1,9,8,1,1,0,1
put,2,4,2,1,1,0,1
accept,1,3,2,1,1,1,1
have,1,3,2,1,1,0,1
open,5,3,-2,-1,1,0,1
take,3,2,-1,-1,1,-1,1
unload,3,3,0,0,1,0,1
carry,1,2,1,1,1,1,1
have,14,4,-10,-1,1,0,1
put,1,3,2,1,1,0,1
take,3,11,8,1,1,0,1
see,1,3,2,1,1,0,1
keep,1,2,1,1,1,1,1
require,2,3,1,1,1,0,1
put,3,2,-1,-1,1,0,1
have,1,2,1,1,1,0,1
find,4,3,-1,-1,1,0,1
take,1,2,1,1,1,-1,1
feed,1,3,2,1,1,1,1
buy,2,3,1,1,1,0,1
take,1,5,4,1,1,1,1
try,1,2,1,1,1,1,1
fill,2,2,0,0,1,0,1
set,3,2,-1,-1,1,0,1
adjust,1,2,1,1,1,0,1
put,2,4,2,1,1,0,1
have,2,4,2,1,1,0,1
check,2,5,3,1,1,0,1
have,1,3,2,1,1,0,1
read,2,2,0,0,1,0,1
take,1,3,2,1,1,1,1
mash,1,3,2,1,1,1,1
take,4,4,0,0,1,0,1
keep,2,2,0,0,1,0,1
take,3,3,0,0,1,0,1
have,4,2,-2,-1,1,-1,1
have,5,4,-1,-1,1,0,1
ask,2,4,2,1,1,0,1
get,3,3,0,0,1,0,1
wash,2,3,1,1,1,0,1
wash,2,3,1,1,1,0,1
put,2,3,1,1,1,0,1
set,1,6,5,1,1,1,1
add,2,4,2,1,1,0,1
get,1,3,2,1,1,0,1
add,1,7,6,1,1,0,1
mount,1,3,2,1,1,1,1
remove,2,4,2,1,1,0,1
replace,1,5,4,1,1,1,1
mount,2,3,1,1,1,0,1
mount,3,6,3,1,1,0,1
attach,2,3,1,1,1,0,1
separate,2,8,6,1,1,0,1
feed,2,3,1,1,1,0,1
send,1,5,4,1,1,0,1
have,3,3,0,0,1,0,1
put,1,3,2,1,1,1,1
use,2,3,1,1,1,0,1
put,2,3,1,1,1,0,1
give,1,2,1,1,1,0,1
make,2,3,1,1,1,0,1
have,1,3,2,1,1,0,1
have,8,10,2,1,1,0,1
keep,3,3,0,0,1,0,1
put,1,3,2,1,1,1,1
measure,3,6,3,1,1,0,1
measure,1,2,1,1,1,0,1
check,5,11,6,1,1,0,1
check,5,3,-2,-1,1,0,1
bite,1,3,2,1,1,1,1
replace,1,5,4,1,1,1,1
put,4,2,-2,-1,1,-1,1
use,1,6,5,1,1,0,1
put,4,3,-1,-1,1,0,1
leave,1,3,2,1,1,1,1
use,7,2,-5,-1,1,-1,1
put,2,3,1,1,1,0,1
have,3,3,0,0,1,0,1
call,2,5,3,1,1,0,1
take,3,3,0,0,1,0,1
take,2,2,0,0,1,0,1
continue,2,2,0,0,1,0,1
attend,6,5,-1,-1,1,0,1
have,4,2,-2,-1,1,0,1
find,5,4,-1,-1,1,0,1
have,1,3,2,1,1,0,1
keep,1,2,1,1,1,1,1
send,5,3,-2,-1,1,0,1
create,2,3,1,1,1,0,1
save,4,6,2,1,1,0,1
have,3,2,-1,-1,1,0,1
dislike,1,10,9,1,1,0,1
order,1,3,2,1,1,0,1
have,3,2,-1,-1,1,0,1
lay,2,7,5,1,1,0,1
take,1,3,2,1,1,1,1
take,1,3,2,1,1,1,1
have,2,3,1,1,1,0,1
get,1,3,2,1,1,1,1
check,3,4,1,1,1,0,1
get,2,5,3,1,1,0,1
compare,1,2,1,1,1,0,1
take,6,4,-2,-1,1,0,1
take,2,3,1,1,1,0,1
explain,1,2,1,1,1,1,1
pay,2,6,4,1,1,0,1
push,7,16,9,1,1,0,1
fill,2,4,2,1,1,0,1
see,1,4,3,1,1,0,1
see,1,4,3,1,1,0,1
watch,5,3,-2,-1,1,0,1
see,2,2,0,0,1,0,1
see,6,2,-4,-1,1,0,1
remember,3,3,0,0,1,-1,1
try,1,3,2,1,1,1,1
affect,1,4,3,1,1,0,1
see,1,5,4,1,1,1,1
discuss,1,4,3,1,1,1,1
see,1,4,3,1,1,0,1
chase,1,4,3,1,1,0,1
transport,1,3,2,1,1,1,1
pay,8,7,-1,-1,1,0,1
share,1,4,3,1,1,0,1
keep,2,2,0,0,1,-1,1
face,5,2,-3,-1,1,0,1
request,2,2,0,0,1,0,1
see,7,2,-5,-1,1,0,1
have,5,4,-1,-1,1,0,1
get,4,7,3,1,1,-1,1
get,2,3,1,1,1,0,1
feed,5,3,-2,-1,1,0,1
put,3,3,0,0,1,0,1
cause,1,2,1,1,1,-1,1
put,3,3,0,0,1,0,1
make,2,2,0,0,1,0,1
fill,2,3,1,1,1,0,1
suround,2,2,0,0,1,0,1
pump,1,6,5,1,1,0,1
use,1,8,7,1,1,0,1
visit,1,2,1,1,1,0,1
buy,2,4,2,1,1,0,1
provide,1,5,4,1,1,0,1
slaughter,2,2,0,0,1,0,1
have,1,3,2,1,1,0,1
let,2,3,1,1,1,0,1
lay,2,2,0,0,1,-1,1
get,1,4,3,1,1,1,1
introduce,1,7,6,1,1,1,1
pester,1,2,1,1,1,0,1
take,1,4,3,1,1,0,1
take,1,4,3,1,1,0,1
find,2,18,16,1,1,0,1
buy,3,10,7,1,1,0,1
throw,1,3,2,1,1,1,1
hang,1,3,2,1,1,1,1
stick,1,3,2,1,1,1,1
have,3,2,-1,-1,1,0,1
throw,1,5,4,1,1,1,1
put,2,8,6,1,1,0,1
hold,2,3,1,1,1,0,1
hold,2,3,1,1,1,0,1
drive,2,3,1,1,1,0,1
take,2,2,0,0,1,0,1
show,9,4,-5,-1,1,0,1
correct,1,4,3,1,1,1,1
admire,1,4,3,1,1,1,1
put,1,4,3,1,1,1,1
spray,3,3,0,0,1,0,1
find,2,5,3,1,1,0,1
find,4,3,-1,-1,1,0,1
find,1,4,3,1,1,1,1
buy,3,2,-1,-1,1,-1,1
massage,1,3,2,1,1,1,1
limit,1,8,7,1,1,1,1
take,1,2,1,1,1,-1,1
do,3,3,0,0,1,0,1
register,4,7,3,1,1,0,1
register,1,13,12,1,1,1,1
do,1,3,2,1,1,1,1
need,1,3,2,1,1,1,1
have,4,3,-1,-1,1,0,1
tailor,2,13,11,1,1,0,1
live,5,6,1,1,1,0,1
have,2,3,1,1,1,0,1
put,1,3,2,1,1,1,1
mark,1,3,2,1,1,1,1
do,1,3,2,1,1,1,1
do,1,2,1,1,1,1,1
throw,2,10,8,1,1,0,1
do,1,4,3,1,1,1,1
put,2,3,1,1,1,0,1
take,1,3,2,1,1,1,1
find,7,3,-4,-1,1,0,1
take,5,10,5,1,1,0,1
take,2,3,1,1,1,0,1
make,1,5,4,1,1,1,1
stay,2,6,4,1,1,0,1
set,6,2,-4,-1,1,-1,1
mention,1,3,2,1,1,1,1
spend,3,4,1,1,1,0,1
touch,2,3,1,1,1,0,1
put,2,7,5,1,1,0,1
keep,2,4,2,1,1,0,1
put,3,3,0,0,1,0,1
help,1,2,1,1,1,1,1
feed,2,2,0,0,1,0,1
take,1,4,3,1,1,1,1
buy,1,5,4,1,1,0,1
thank,1,3,2,1,1,1,1
answer,2,2,0,0,1,0,1
have,1,2,1,1,1,-1,1
discuss,3,2,-1,-1,1,-1,1
see,2,2,0,0,1,0,1
hate,8,6,-2,-1,1,0,1
fall,1,4,3,1,1,0,1
treat,1,4,3,1,1,1,1
accept,1,8,7,1,1,1,1
seek,1,4,3,1,1,0,1
receive,4,3,-1,-1,1,0,1
compare,1,5,4,1,1,1,1
pay,6,3,-3,-1,1,0,1
stick,2,3,1,1,1,0,1
love,1,2,1,1,1,1,1
put,1,4,3,1,1,1,1
hold,2,7,5,1,1,0,1
leave,1,2,1,1,1,0,1
chase,2,5,3,1,1,0,1
leave,3,3,0,0,1,0,1
do,1,5,4,1,1,1,1
rub,2,6,4,1,1,0,1
put,1,3,2,1,1,1,1
pay,4,3,-1,-1,1,0,1
bring,2,3,1,1,1,1,1
put,2,3,1,1,1,0,1
deploy,1,2,1,1,1,0,1
leave,1,3,2,1,1,0,1
attack,2,14,12,1,1,0,1
hand,8,7,-1,-1,1,0,1
thank,1,3,2,1,1,1,1
emit,4,3,-1,-1,1,0,1
cause,7,2,-5,-1,1,0,1
maintain,2,2,0,0,1,0,1
keep,2,3,1,1,1,0,1
make,3,3,0,0,1,0,1
do,6,2,-4,-1,1,0,1
get,5,2,-3,-1,1,0,1
tame,1,3,2,1,1,1,1
help,1,3,2,1,1,1,1
get,3,4,1,1,1,0,1
place,5,3,-2,-1,1,1,1
place,2,3,1,1,1,0,1
place,2,3,1,1,1,0,1
associate,2,2,0,0,1,0,1
do,1,4,3,1,1,1,1
repeat,2,4,2,1,1,0,1
eat,3,3,0,0,1,0,1
take,3,3,0,0,1,0,1
associate,1,8,7,1,1,1,1
push,2,3,1,1,1,0,1
choose,2,3,1,1,1,0,1
take,1,2,1,1,1,-1,1
take,1,8,7,1,1,0,1
leave,1,15,14,1,1,0,1
use,2,4,2,1,1,0,1
have,1,2,1,1,1,0,1
need,6,8,2,1,1,0,1
take,1,3,2,1,1,0,1
leave,1,4,3,1,1,0,1
incubate,1,3,2,1,1,1,1
pick,1,3,2,1,1,0,1
put,1,7,6,1,1,1,1
set,2,4,2,1,1,0,1
leave,4,3,-1,-1,1,0,1
separate,2,5,3,1,1,0,1
leave,4,7,3,1,1,0,1
put,2,17,15,1,1,0,1
put,2,17,15,1,1,0,1
spend,2,4,2,1,1,0,1
keep,5,2,3,1,-1,0,1
keep,2,3,1,1,1,0,1
leave,1,7,6,1,1,0,1
take,1,2,1,1,1,1,1
use,2,2,0,0,1,0,1
gain,2,5,3,1,1,0,1
post,1,4,3,1,1,1,1
know,2,4,2,1,1,0,1
call,1,16,15,1,1,1,1
thank,1,2,1,1,1,1,1
risk,1,6,5,1,1,1,1
know,2,4,2,1,1,0,1
loose,1,3,2,1,1,0,1
do,3,10,7,1,1,-1,1
pick,6,2,-4,-1,1,0,1
send,1,3,2,1,1,1,1
lose,3,7,4,1,1,0,1
drop,1,3,2,1,1,0,1
have,1,3,2,1,1,1,1
eat,1,7,6,1,1,0,1
call,4,2,-2,-1,1,-1,1
have,2,2,0,0,1,0,1
spend,2,2,0,0,1,0,1
do,2,2,0,0,1,0,1
evaluate,1,2,1,1,1,1,1
exhibit,6,21,15,1,1,0,1
evaluate,2,15,13,1,1,0,1
go,1,3,-2,-1,-1,0,1
haul,2,2,0,0,1,0,1
have,3,5,2,1,1,0,1
get,3,4,1,1,1,0,1
do,5,7,2,1,1,0,1
get,2,3,1,1,1,0,1
test,3,4,1,1,1,0,1
put,2,2,0,0,1,0,1
consider,1,3,2,1,1,1,1
do,4,3,-1,-1,1,0,1
fix,2,4,2,1,1,0,1
have,2,2,0,0,1,0,1
recommend,2,9,7,1,1,-1,1
take,1,3,2,1,1,0,1
drop,1,4,3,1,1,1,1
provide,2,4,2,1,1,0,1
offer,4,4,0,0,1,0,1
fix,3,6,3,1,1,0,1
prepare,3,2,-1,-1,1,0,1
supply,2,6,4,1,1,0,1
send,2,2,0,0,1,0,1
get,1,5,4,1,1,-1,1
prepare,3,3,0,0,1,0,1
prepare,3,6,3,1,1,0,1
train,1,4,3,1,1,1,1
recommend,1,2,1,1,1,0,1
experience,3,12,9,1,1,0,1
take,2,2,0,0,1,-1,1
deliver,2,2,0,0,1,-1,1
have,2,3,1,1,1,0,1
explain,2,2,0,0,1,0,1
take,2,2,0,0,1,-1,1
recommend,2,7,5,1,1,-1,1
have,10,4,-6,-1,1,0,1
pay,1,5,4,1,1,0,1
have,2,2,0,0,1,0,1
practice,1,4,3,1,1,0,1
phone,2,6,4,1,1,0,1
use,1,3,2,1,1,1,1
use,1,5,4,1,1,0,1
take,1,2,1,1,1,-1,1
do,3,3,0,0,1,0,1
treat,1,3,2,1,1,1,1
put,2,3,1,1,1,0,1
recommend,1,2,1,1,1,0,1
have,3,4,1,1,1,0,1
mean,2,2,0,0,1,-1,1
buy,1,2,1,1,1,1,1
love,1,7,6,1,1,1,1
recommend,1,2,1,1,1,0,1
try,3,3,0,0,1,0,1
place,2,2,0,0,1,0,1
call,1,2,1,1,1,1,1
spend,3,3,0,0,1,0,1
access,2,18,16,1,1,0,1
get,2,3,1,1,1,0,1
remove,3,4,1,1,1,0,1
recommend,6,6,0,0,1,0,1
give,2,4,2,1,1,0,1
recommend,1,2,1,1,1,0,1
tell,1,3,2,1,1,1,1
fixed,2,3,1,1,1,0,1
fix,1,3,2,1,1,1,1
spend,4,2,-2,-1,1,-1,1
get,1,6,5,1,1,1,1
help,1,9,8,1,1,1,1
have,6,12,6,1,1,0,1
describe,2,3,1,1,1,0,1
have,1,4,3,1,1,0,1
give,3,4,1,1,1,0,1
call,1,3,2,1,1,1,1
have,5,6,1,1,1,0,1
give,3,3,0,0,1,0,1
maintain,1,10,9,1,1,1,1
have,3,2,-1,-1,1,0,1
recommend,1,9,8,1,1,1,1
bring,3,2,-1,-1,1,-1,1
recommend,1,2,1,1,1,0,1
smooth,2,4,2,1,1,0,1
do,1,2,1,1,1,0,1
prefer,6,11,5,1,1,0,1
use,2,4,2,1,1,0,1
have,2,2,0,0,1,-1,1
do,1,3,2,1,1,0,1
use,2,3,1,1,1,0,1
help,1,4,3,1,1,1,1
serve,2,4,2,1,1,0,1
enjoy,4,6,2,1,1,0,1
place,1,9,8,1,1,1,1
recommend,1,5,4,1,1,1,1
mean,2,2,0,0,1,-1,1
have,1,3,2,1,1,1,1
figure,1,4,3,1,1,1,1
take,2,3,1,1,1,0,1
pass,3,3,0,0,1,0,1
waste,2,2,0,0,1,-1,1
pay,2,4,2,1,1,0,1
chase,1,32,31,1,1,1,1
recommend,2,11,9,1,1,-1,1
try,2,10,8,1,1,0,1
prefer,3,8,5,1,1,0,1
like,2,6,4,1,1,0,1
pick,3,5,2,1,1,0,1
hear,1,5,4,1,1,0,1
suggest,2,2,0,0,1,-1,1
answer,4,3,-1,-1,1,0,1
have,3,2,-1,-1,1,0,1
purchase,2,3,1,1,1,0,1
take,1,7,6,1,1,0,1
recommend,1,10,9,1,1,-1,1
charge,2,3,1,1,1,0,1
pay,1,2,1,1,1,0,1
provide,1,3,2,1,1,1,1
pick,2,6,4,1,1,0,1
write,3,2,-1,-1,1,0,1
thank,1,9,8,1,1,1,1
recommend,1,5,4,1,1,1,1
tell,1,8,7,1,1,1,1
recommend,2,13,11,1,1,-1,1
recommend,2,2,0,0,1,-1,1
tow,2,3,1,1,1,0,1
keep,1,11,10,1,1,1,1
have,5,4,-1,-1,1,0,1
pay,2,3,1,1,1,0,1
tow,1,2,1,1,1,-1,1
use,1,6,5,1,1,1,1
complete,2,7,5,1,1,0,1
find,1,3,2,1,1,0,1
recommend,2,2,0,0,1,-1,1
purchase,2,3,1,1,1,0,1
have,2,4,2,1,1,0,1
find,2,3,1,1,1,0,1
take,1,2,1,1,1,-1,1
hate,2,2,0,0,1,0,1
recommend,1,2,1,1,1,0,1
attend,1,3,2,1,1,1,1
recommend,2,2,0,0,1,-1,1
host,2,2,0,0,1,0,1
face,3,4,1,1,1,0,1
host,3,2,-1,-1,1,0,1
get,3,4,1,1,1,0,1
trust,2,7,5,1,1,-1,1
do,5,2,-3,-1,1,0,1
get,2,3,1,1,1,-1,1
recommend,1,2,1,1,1,-1,1
charge,1,3,2,1,1,1,1
get,2,4,2,1,1,0,1
bring,2,3,1,1,1,0,1
buy,2,3,1,1,1,0,1
take,2,3,1,1,1,0,1
send,4,2,-2,-1,1,-1,1
satisfy,4,6,2,1,1,0,1
sell,4,3,-1,-1,1,0,1
attract,5,8,3,1,1,0,1
bring,3,2,-1,-1,1,0,1
say,1,3,2,1,1,0,1
recommend,4,2,-2,-1,1,-1,1
add,3,9,6,1,1,0,1
put,1,3,2,1,1,0,1
eat,1,5,4,1,1,0,1
taste,2,2,0,0,1,-1,1
separate,1,3,2,1,1,0,1
find,1,2,1,1,1,0,1
do,3,7,4,1,1,0,1
sell,2,4,2,1,1,0,1
refer,1,4,3,1,1,0,1
find,1,3,2,1,1,1,1
guide,1,16,15,1,1,1,1
have,3,2,-1,-1,1,-1,1
love,1,2,1,1,1,0,1
explain,11,2,9,1,-1,0,1
give,3,8,5,1,1,0,1
hit,2,3,1,1,1,0,1
keep,1,5,4,1,1,0,1
need,3,3,0,0,1,0,1
explain,1,3,2,1,1,1,1
get,1,8,7,1,1,0,1
ring,3,4,1,1,1,0,1
lock,2,3,1,1,1,0,1
get,1,2,1,1,1,0,1
use,2,7,5,1,1,0,1
attend,2,2,0,0,1,0,1
serve,1,5,4,1,1,1,1
meet,1,4,3,1,1,1,1
do,2,2,0,0,1,0,1
spread,2,3,1,1,1,0,1
have,8,3,-5,-1,1,0,1
tell,1,10,9,1,1,1,1
clean,2,3,1,1,1,0,1
refer,1,3,2,1,1,1,1
have,3,4,1,1,1,0,1
take,3,4,1,1,1,0,1
make,1,9,8,1,1,0,1
confuse,3,2,-1,-1,1,0,1
cancel,8,15,7,1,1,0,1
provide,2,4,2,1,1,0,1
add,1,3,2,1,1,0,1
extend,1,4,3,1,1,1,1
interview,2,4,2,1,1,0,1
take,15,2,13,1,-1,0,1
shell,6,4,-2,-1,1,0,1
put,1,2,1,1,1,1,1
take,3,2,-1,-1,1,-1,1
apply,1,3,2,1,1,0,1
charge,1,3,2,1,1,1,1
itemize,1,4,3,1,1,1,1
compensate,1,5,4,1,1,1,1
have,2,2,0,0,1,-1,1
offer,5,9,4,1,1,0,1
offer,2,3,1,1,1,0,1
fool,1,3,2,1,1,0,1
go,2,5,3,1,1,0,1
cover,5,12,7,1,1,0,1
purchase,7,3,-4,-1,1,0,1
pay,1,6,5,1,1,0,1
provide,5,4,-1,-1,1,0,1
put,1,3,2,1,1,1,1
have,3,5,2,1,1,0,1
style,2,9,7,1,1,0,1
do,1,2,1,1,1,1,1
manage,2,2,0,0,1,0,1
maintain,2,4,2,1,1,0,1
make,1,7,6,1,1,0,1
recommend,3,7,4,1,1,0,1
call,3,4,1,1,1,0,1
apply,1,7,6,1,1,1,1
pre-screen,2,6,4,1,1,0,1
have,3,6,3,1,1,0,1
put,2,3,1,1,1,0,1
have,2,5,3,1,1,0,1
take,2,2,0,0,1,0,1
recommend,3,2,-1,-1,1,0,1
recommend,5,5,0,0,1,0,1
see,2,4,2,1,1,0,1
send,5,5,0,0,1,0,1
recommend,2,11,9,1,1,-1,1
overcharge,1,4,3,1,1,0,1
drive,2,2,0,0,1,-1,1
purchase,2,3,1,1,1,0,1
see,3,5,2,1,1,0,1
explain,2,3,1,1,1,0,1
manifest,1,6,5,1,1,1,1
put,3,4,1,1,1,0,1
waste,2,5,3,1,1,0,1
strain,1,2,1,1,1,1,1
need,1,3,2,1,1,1,1
treat,1,7,6,1,1,1,1
serve,4,2,-2,-1,1,0,1
bring,1,4,3,1,1,1,1
do,1,3,2,1,1,1,1
recommend,2,13,11,1,1,-1,1
have,4,2,-2,-1,1,-1,1
pay,3,7,4,1,1,0,1
take,1,4,3,1,1,1,1
take,2,12,10,1,1,-1,1
buy,2,5,3,1,1,0,1
quote,1,2,1,1,1,-1,1
take,1,4,3,1,1,0,1
tell,1,3,2,1,1,1,1
get,3,6,3,1,1,0,1
add,1,2,1,1,1,0,1
make,1,4,3,1,1,1,1
compare,1,8,7,1,1,1,1
eat,1,4,3,1,1,0,1
recommend,1,2,1,1,1,0,1
have,1,3,2,1,1,0,1
separate,1,7,6,1,1,0,1
experience,13,4,-9,-1,1,0,1
lose,2,4,2,1,1,0,1
wear,3,3,0,0,1,0,1
play,3,2,-1,-1,1,0,1
get,2,3,1,1,1,0,1
avail,1,6,5,1,1,1,1
continue,6,3,-3,-1,1,0,1
know,2,4,2,1,1,0,1
take,3,3,0,0,1,0,1
treat,1,7,6,1,1,1,1
take,2,3,1,1,1,0,1
trust,3,4,1,1,1,0,1
put,1,3,-2,-1,-1,-1,0
have,3,3,0,0,-1,0,0
press,1,2,-1,-1,-1,0,0
get,2,3,-1,-1,-1,0,0
brief,1,3,-2,-1,-1,-1,0
total,2,3,-1,-1,-1,0,0
unload,1,3,-2,-1,-1,0,0
charge,1,26,-25,-1,-1,-1,0
squirm,2,4,-2,-1,-1,0,0
charge,1,4,-3,-1,-1,-1,0
call,2,2,0,0,-1,1,0
alert,1,3,-2,-1,-1,-1,0
use,4,3,1,1,-1,0,0
apply,1,4,-3,-1,-1,-1,0
tell,1,4,-3,-1,-1,-1,0
take,5,3,2,1,-1,0,0
add,3,3,0,0,-1,0,0
deal,2,2,0,0,-1,0,0
purchase,7,3,4,1,-1,0,0
check,2,3,-1,-1,-1,1,0
give,1,8,-7,-1,-1,-1,0
have,2,6,-4,-1,-1,0,0
take,1,2,-1,-1,-1,1,0
track,10,2,8,1,-1,0,0
bring,1,3,-2,-1,-1,-1,0
return,2,3,-1,-1,-1,0,0
approach,3,27,-24,-1,-1,0,0
push,2,3,-1,-1,-1,0,0
recommend,2,6,-4,-1,-1,0,0
leave,3,3,0,0,-1,0,0
grab,2,3,-1,-1,-1,0,0
throw,1,3,-2,-1,-1,-1,0
see,4,8,-4,-1,-1,0,0
serve,4,3,1,1,-1,0,0
introduce,4,3,1,1,-1,0,0
do,3,2,1,1,-1,0,0
expand,2,2,0,0,-1,0,0
frequent,2,9,-7,-1,-1,0,0
take,1,5,-4,-1,-1,0,0
overcharge,1,5,-4,-1,-1,-1,0
evaluate,2,4,-2,-1,-1,0,0
make,2,5,-3,-1,-1,0,0
follow,2,2,0,0,-1,0,0
force,2,4,-2,-1,-1,0,0
break,2,3,-1,-1,-1,0,0
order,3,3,0,0,-1,0,0
charge,1,4,-3,-1,-1,-1,0
change,2,2,0,0,-1,1,0
call,3,15,-12,-1,-1,0,0
tell,1,3,-2,-1,-1,0,0
express,2,3,-1,-1,-1,0,0
put,5,3,2,1,-1,0,0
ask,1,4,-3,-1,-1,0,0
put,1,3,-2,-1,-1,-1,0
use,1,3,-2,-1,-1,-1,0
recommend,2,2,0,0,-1,1,0
treat,2,4,-2,-1,-1,0,0
recommend,2,3,-1,-1,-1,0,0
get,3,3,0,0,-1,0,0
put,1,3,-2,-1,-1,0,0
pull,3,10,-7,-1,-1,0,0
fix,1,2,-1,-1,-1,-1,0
leave,1,2,-1,-1,-1,0,0
buy,7,3,4,1,-1,0,0
deliver,5,4,1,1,-1,0,0
tell,7,17,-10,-1,-1,0,0
take,1,3,-2,-1,-1,0,0
order,1,4,-3,-1,-1,0,0
spend,2,14,-12,-1,-1,0,0
pick,6,4,2,1,-1,0,0
describe,1,11,-10,-1,-1,-1,0
associate,2,3,-1,-1,-1,0,0
advise,1,3,-2,-1,-1,-1,0
see,1,4,-3,-1,-1,0,0
take,1,2,-1,-1,-1,1,0
thank,1,16,-15,-1,-1,-1,0
replace,4,5,-1,-1,-1,0,0
do,1,2,-1,-1,-1,0,0
avoid,2,6,-4,-1,-1,0,0
give,2,3,-1,-1,-1,0,0
stick,2,2,0,0,-1,1,0
put,1,3,-2,-1,-1,-1,0
leave,2,3,-1,-1,-1,0,0
charge,2,4,-2,-1,-1,0,0
put,3,3,0,0,-1,0,0
lick,2,3,-1,-1,-1,0,0
waste,2,3,-1,-1,-1,0,0
order,2,7,-5,-1,-1,0,0
give,1,2,-1,-1,-1,0,0
fill,2,4,-2,-1,-1,0,0
force,1,8,-7,-1,-1,-1,0
trust,1,14,-13,-1,-1,-1,0
visit,2,3,-1,-1,-1,0,0
wait,3,4,-1,-1,-1,0,0
pull,2,3,-1,-1,-1,0,0
split,2,7,-5,-1,-1,0,0
find,6,2,4,1,-1,0,0
have,5,2,3,1,-1,0,0
hold,1,2,-1,-1,-1,0,0
gather,1,13,-12,-1,-1,0,0
use,1,44,-43,-1,-1,0,0
approach,1,3,-2,-1,-1,0,0
assess,5,4,1,1,-1,0,0
determine,7,13,-6,-1,-1,0,0
measure,8,9,-1,-1,-1,0,0
define,4,2,2,1,-1,0,0
assemble,13,2,-11,-1,1,0,0
shed,2,10,-8,-1,-1,0,0
document,7,12,-5,-1,-1,0,0
inject,1,3,-2,-1,-1,0,0
do,2,2,0,0,-1,0,0
assemble,7,4,3,1,-1,0,0
relate,3,3,0,0,-1,0,0
present,5,3,2,1,-1,0,0
collect,2,6,-4,-1,-1,0,0
compare,1,8,-7,-1,-1,-1,0
distinguish,2,2,0,0,-1,0,0
offer,2,11,-9,-1,-1,1,0
use,1,5,-4,-1,-1,-1,0
use,4,9,-5,-1,-1,0,0
distinguish,1,3,-2,-1,-1,0,0
issue,6,2,4,1,-1,0,0
mistake,5,8,-3,-1,-1,0,0
give,2,6,-4,-1,-1,1,0
produce,4,10,-6,-1,-1,0,0
leverage,4,4,0,0,-1,0,0
endow,3,5,-2,-1,-1,0,0
publish,2,3,-1,-1,-1,0,0
add,2,12,-10,-1,-1,0,0
propose,10,6,4,1,-1,0,0
do,4,4,0,0,-1,0,0
acquire,1,7,-6,-1,-1,0,0
integrate,3,8,-5,-1,-1,0,0
integrate,3,3,0,0,-1,0,0
observe,1,3,-2,-1,-1,0,0
offer,1,9,-8,-1,-1,0,0
provide,5,3,2,1,-1,0,0
take,10,4,6,1,-1,0,0
develop,7,13,-6,-1,-1,0,0
make,1,7,-6,-1,-1,0,0
play,3,7,-4,-1,-1,0,0
pay,3,3,0,0,1,0,0
introduce,1,6,-5,-1,-1,0,0
apply,2,5,-3,-1,-1,0,0
apply,2,3,-1,-1,-1,0,0
generate,3,23,-20,-1,-1,0,0
register,3,3,0,0,-1,0,0
create,6,4,2,1,-1,0,0
see,6,6,0,0,1,0,0
introduce,1,5,-4,-1,-1,0,0
cover,1,3,-2,-1,-1,0,0
apply,1,3,-2,-1,-1,-1,0
extend,2,3,-1,-1,-1,0,0
use,3,9,-6,-1,-1,0,0
play,3,4,-1,-1,-1,0,0
alter,5,4,1,1,-1,0,0
see,6,8,-2,-1,-1,0,0
hold,15,5,-10,-1,1,0,0
make,1,18,-17,-1,-1,0,0
assess,7,15,-8,-1,-1,0,0
expect,7,2,5,1,-1,0,0
address,2,5,-3,-1,-1,0,0
gain,4,6,-2,-1,-1,0,0
span,5,18,-13,-1,-1,0,0
demonstrate,14,2,-12,-1,1,0,0
access,1,4,-3,-1,-1,0,0
document,7,7,0,0,-1,0,0
extend,2,7,-5,-1,-1,0,0
ban,1,3,-2,-1,-1,0,0
carry,2,3,-1,-1,-1,0,0
study,1,5,-4,-1,-1,0,0
earn,6,2,4,1,-1,0,0
hold,8,3,5,1,-1,0,0
point,16,4,-12,-1,1,0,0
resolve,3,8,-5,-1,-1,0,0
discover,1,5,-4,-1,-1,0,0
puncture,5,6,-1,-1,-1,0,0
stick,3,4,-1,-1,-1,0,0
exchange,3,3,0,0,-1,0,0
exchange,3,2,1,1,-1,0,0
design,21,5,16,1,-1,0,0
achieve,2,3,-1,-1,-1,0,0
redesign,6,8,-2,-1,-1,0,0
spend,1,3,-2,-1,-1,0,0
reach,1,2,-1,-1,-1,0,0
publish,2,3,-1,-1,-1,0,0
polish,2,17,-15,-1,-1,0,0
take,1,3,-2,-1,-1,0,0
write,2,10,-8,-1,-1,0,0
confide,4,2,2,1,-1,-1,0
find,1,17,-16,-1,-1,-1,0
write,1,4,-3,-1,-1,0,0
pour,3,2,1,1,-1,0,0
initiate,2,3,-1,-1,-1,0,0
obtain,2,4,-2,-1,-1,0,0
join,3,4,-1,-1,-1,0,0
distinguish,1,11,-10,-1,-1,-1,0
find,1,2,-1,-1,-1,-1,0
visit,3,2,1,1,-1,0,0
take,1,8,-7,-1,-1,0,0
head,5,3,2,1,-1,0,0
raise,1,6,-5,-1,-1,-1,0
give,2,3,-1,-1,-1,0,0
leave,12,2,-10,-1,1,-1,0
receive,4,2,2,1,-1,0,0
receive,10,4,6,1,-1,0,0
award,4,7,-3,-1,-1,0,0
study,1,6,-5,-1,-1,0,0
describe,1,8,-7,-1,-1,-1,0
smash,2,3,-1,-1,-1,0,0
write,2,8,-6,-1,-1,0,0
connect,1,4,-3,-1,-1,-1,0
treat,1,4,-3,-1,-1,-1,0
provide,1,29,-28,-1,-1,0,0
adorn,5,4,1,1,-1,0,0
bat,1,3,-2,-1,-1,0,0
earn,2,5,-3,-1,-1,0,0
attend,2,4,-2,-1,-1,0,0
lead,2,4,-2,-1,-1,0,0
share,3,4,-1,-1,-1,0,0
begin,3,13,-10,-1,-1,0,0
begin,3,9,-6,-1,-1,0,0
hit,3,4,-1,-1,-1,0,0
open,1,2,-1,-1,-1,0,0
make,4,4,0,0,-1,0,0
have,3,9,-6,-1,-1,0,0
bat,1,6,-5,-1,-1,0,0
start,3,6,-3,-1,-1,0,0
hit,1,3,-2,-1,-1,0,0
start,1,2,-1,-1,-1,0,0
make,3,4,-1,-1,-1,0,0
rob,2,3,-1,-1,-1,0,0
start,1,7,-6,-1,-1,0,0
make,3,2,1,1,-1,0,0
establish,1,9,-8,-1,-1,-1,0
achieve,1,22,-21,-1,-1,0,0
spend,1,18,-17,-1,-1,0,0
lose,3,3,0,0,-1,0,0
make,3,4,-1,-1,-1,0,0
undertake,1,6,-5,-1,-1,0,0
obtain,8,2,6,1,-1,0,0
receive,4,5,-1,-1,-1,0,0
give,1,6,-5,-1,-1,0,0
split,1,3,-2,-1,-1,0,0
give,1,5,-4,-1,-1,0,0
deny,3,4,-1,-1,-1,0,0
live,4,3,1,1,-1,0,0
recall,1,3,-2,-1,-1,-1,0
violate,3,2,1,1,-1,0,0
assert,1,5,-4,-1,-1,-1,0
live,7,2,5,1,-1,0,0
leave,2,2,0,0,-1,0,0
view,1,4,-3,-1,-1,0,0
take,2,11,-9,-1,-1,0,0
put,1,3,-2,-1,-1,-1,0
herd,1,6,-5,-1,-1,0,0
have,1,3,-2,-1,-1,0,0
take,1,4,-3,-1,-1,-1,0
pull,4,4,0,0,-1,0,0
tie,3,4,-1,-1,-1,0,0
pull,1,2,-1,-1,-1,0,0
take,1,2,-1,-1,-1,1,0
get,2,3,-1,-1,-1,0,0
take,1,4,-3,-1,-1,-1,0
watch,1,4,-3,-1,-1,-1,0
pluck,1,5,-4,-1,-1,0,0
splash,2,3,-1,-1,-1,0,0
comb,3,2,1,1,-1,0,0
shelter,2,4,-2,-1,-1,0,0
make,1,31,-30,-1,-1,0,0
ride,2,7,-5,-1,-1,0,0
prise,1,11,-10,-1,-1,-1,0
bury,2,11,-9,-1,-1,0,0
bury,2,19,-17,-1,-1,0,0
bury,4,27,-23,-1,-1,0,0
follow,2,4,-2,-1,-1,0,0
catch,1,3,-2,-1,-1,-1,0
survive,2,7,-5,-1,-1,0,0
swab,3,2,1,1,-1,0,0
take,1,2,-1,-1,-1,1,0
will,2,2,0,0,-1,0,0
punch,1,3,-2,-1,-1,-1,0
read,1,5,-4,-1,-1,-1,0
keep,3,3,0,0,-1,0,0
hit,5,6,-1,-1,-1,0,0
take,2,3,-1,-1,-1,0,0
kick,1,3,-2,-1,-1,0,0
kill,1,2,-1,-1,-1,-1,0
chase,4,6,-2,-1,-1,0,0
have,1,3,-2,-1,-1,0,0
try,1,3,-2,-1,-1,0,0
wrap,1,3,-2,-1,-1,-1,0
have,2,3,-1,-1,-1,0,0
take,2,2,0,0,-1,0,0
fill,3,4,-1,-1,-1,0,0
bike,2,15,-13,-1,-1,0,0
meet,1,5,-4,-1,-1,0,0
read,2,4,-2,-1,-1,0,0
place,3,3,0,0,-1,0,0
use,1,2,-1,-1,-1,-1,0
want,1,2,-1,-1,-1,-1,0
put,1,3,-2,-1,-1,0,0
say,3,4,-1,-1,-1,0,0
hit,2,3,-1,-1,-1,0,0
see,1,2,-1,-1,-1,1,0
put,2,2,0,0,-1,1,0
do,3,2,1,1,-1,0,0
lose,1,3,-2,-1,-1,0,0
collect,2,3,-1,-1,-1,0,0
bake,12,5,-7,-1,1,0,0
do,1,4,-3,-1,-1,0,0
touch,1,3,-2,-1,-1,-1,0
follow,1,8,-7,-1,-1,-1,0
obtain,2,5,-3,-1,-1,0,0
discuss,2,2,0,0,-1,0,0
have,2,4,-2,-1,-1,0,0
do,6,6,0,0,-1,0,0
house,2,8,-6,-1,-1,0,0
drill,2,21,-19,-1,-1,0,0
expose,2,3,-1,-1,-1,0,0
mix,4,3,1,1,-1,0,0
influence,2,3,-1,-1,-1,0,0
sell,1,2,-1,-1,-1,0,0
amass,3,2,1,1,-1,0,0
draw,2,5,-3,-1,-1,0,0
display,2,4,-2,-1,-1,0,0
ask,1,7,-6,-1,-1,0,0
expand,2,3,-1,-1,-1,0,0
expand,1,3,-2,-1,-1,0,0
use,2,3,-1,-1,-1,0,0
carry,2,5,-3,-1,-1,0,0
interview,4,3,1,1,-1,0,0
interview,10,9,1,1,-1,0,0
define,1,17,-16,-1,-1,0,0
recount,6,3,-3,-1,1,0,0
sample,4,3,1,1,-1,0,0
gain,1,9,-8,-1,-1,0,0
criticize,8,5,3,1,-1,0,0
create,2,4,-2,-1,-1,0,0
leave,1,3,-2,-1,-1,-1,0
receive,2,19,-17,-1,-1,0,0
have,2,3,-1,-1,-1,0,0
collect,2,3,-1,-1,-1,0,0
talk,1,14,-13,-1,-1,-1,0
find,1,5,-4,-1,-1,0,0
prevent,1,9,-8,-1,-1,0,0
make,1,3,-2,-1,-1,0,0
have,2,3,-1,-1,-1,0,0
embed,5,2,3,1,-1,0,0
cut,1,4,-3,-1,-1,-1,0
mount,2,3,-1,-1,-1,0,0
get,6,3,3,1,-1,0,0
compare,7,11,-4,-1,-1,1,0
compare,2,8,-6,-1,-1,1,0
grow,1,2,-1,-1,-1,-1,0
use,5,3,2,1,-1,0,0
take,1,12,-11,-1,-1,0,0
show,2,3,-1,-1,-1,0,0
donate,3,10,-7,-1,-1,0,0
use,2,10,-8,-1,-1,0,0
provide,1,4,-3,-1,-1,0,0
produce,1,15,-14,-1,-1,0,0
release,4,6,-2,-1,-1,-1,0
release,2,5,-3,-1,-1,0,0
invest,2,8,-6,-1,-1,0,0
create,1,2,-1,-1,-1,0,0
make,2,3,-1,-1,-1,0,0
have,3,2,1,1,-1,0,0
grow,2,6,-4,-1,-1,0,0
rank,1,9,-8,-1,-1,0,0
interview,18,8,10,1,-1,0,0
bring,1,25,-24,-1,-1,0,0
put,7,2,-5,-1,1,0,0
display,5,11,-6,-1,-1,0,0
have,3,5,-2,-1,-1,0,0
take,1,22,-21,-1,-1,-1,0
improve,2,5,-3,-1,-1,0,0
get,4,2,2,1,-1,0,0
get,5,3,2,1,-1,0,0
sign,3,3,0,0,-1,0,0
have,3,2,1,1,-1,0,0
experience,4,2,2,1,-1,0,0
bother,1,3,-2,-1,-1,-1,0
thank,1,3,-2,-1,-1,-1,0
coin,1,4,-3,-1,-1,-1,0
see,3,3,0,0,-1,0,0
assign,2,4,-2,-1,-1,0,0
assign,5,12,-7,-1,-1,0,0
add,3,2,1,1,-1,1,0
assign,1,9,-8,-1,-1,-1,0
target,2,3,-1,-1,-1,0,0
hit,1,4,-3,-1,-1,0,0
hit,1,9,-8,-1,-1,0,0
do,1,2,-1,-1,-1,0,0
liken,1,3,-2,-1,-1,-1,0
do,1,2,-1,-1,-1,1,0
write,1,2,-1,-1,-1,1,0
do,1,4,-3,-1,-1,-1,0
solve,6,4,2,1,-1,0,0
formulate,1,4,-3,-1,-1,-1,0
see,2,2,0,0,-1,0,0
interested,1,3,-2,-1,-1,-1,0
see,2,7,-5,-1,-1,0,0
collect,1,11,-10,-1,-1,0,0
explain,3,2,1,1,-1,1,0
collect,2,19,-17,-1,-1,0,0
convert,1,8,-7,-1,-1,-1,0
accelerate,2,4,-2,-1,-1,0,0
rate,2,7,-5,-1,-1,0,0
leave,2,2,0,0,-1,0,0
discuss,2,4,-2,-1,-1,0,0
affect,2,5,-3,-1,-1,1,0
contact,4,9,-5,-1,-1,0,0
bring,6,2,4,1,-1,0,0
meet,2,8,-6,-1,-1,0,0
meet,1,13,-12,-1,-1,0,0
take,3,7,-4,-1,-1,0,0
issue,2,2,0,0,-1,0,0
tweet,4,6,-2,-1,-1,0,0
bring,1,4,-3,-1,-1,-1,0
defeat,2,5,-3,-1,-1,0,0
lose,2,3,-1,-1,-1,0,0
defeat,13,3,10,1,-1,0,0
resign,2,3,-1,-1,-1,0,0
gain,2,4,-2,-1,-1,0,0
prefer,4,4,0,0,-1,0,0
mirror,3,7,-4,-1,-1,0,0
have,5,10,-5,-1,-1,0,0
select,5,5,0,0,-1,0,0
label,1,9,-8,-1,-1,0,0
remove,7,2,5,1,-1,0,0
remove,3,3,0,0,-1,0,0
characterize,14,32,-18,-1,-1,0,0
post,3,2,1,1,-1,0,0
declare,1,4,-3,-1,-1,0,0
replace,1,4,-3,-1,-1,-1,0
decrease,2,5,-3,-1,-1,0,0
put,2,5,-3,-1,-1,0,0
imprison,1,3,-2,-1,-1,-1,0
imprison,1,11,-10,-1,-1,-1,0
move,1,4,-3,-1,-1,-1,0
lose,2,2,0,0,-1,0,0
perform,1,4,-3,-1,-1,0,0
fire,7,14,-7,-1,-1,0,0
fire,2,4,-2,-1,-1,0,0
broadcast,2,3,-1,-1,-1,0,0
stop,3,3,0,0,-1,0,0
fire,5,3,2,1,-1,0,0
put,2,5,-3,-1,-1,0,0
light,5,9,-4,-1,-1,0,0
turn,3,22,-19,-1,-1,0,0
have,2,2,0,0,-1,1,0
visit,2,6,-4,-1,-1,0,0
take,1,7,-6,-1,-1,0,0
install,3,9,-6,-1,-1,0,0
protect,1,3,-2,-1,-1,0,0
take,1,3,-2,-1,-1,0,0
ask,1,3,-2,-1,-1,0,0
pay,6,7,-1,-1,-1,0,0
do,1,3,-2,-1,-1,-1,0
describe,4,2,2,1,-1,0,0
cultivate,2,5,-3,-1,-1,0,0
celebrate,3,15,-12,-1,-1,0,0
base,2,8,-6,-1,-1,0,0
express,1,9,-8,-1,-1,0,0
receive,1,3,-2,-1,-1,0,0
exhibit,3,2,1,1,-1,0,0
collect,2,3,-1,-1,-1,0,0
commit,2,5,-3,-1,-1,0,0
point,2,2,0,0,-1,0,0
learn,3,4,-1,-1,-1,0,0
increase,3,3,0,0,-1,0,0
have,2,6,-4,-1,-1,0,0
conduct,2,3,-1,-1,-1,0,0
use,5,3,2,1,-1,0,0
keep,1,11,-10,-1,-1,-1,0
name,8,5,3,1,-1,0,0
need,5,5,0,0,-1,0,0
provide,1,3,-2,-1,-1,-1,0
get,4,5,-1,-1,-1,0,0
cost,2,4,-2,-1,-1,0,0
obtain,3,6,-3,-1,-1,0,0
depart,2,3,-1,-1,-1,0,0
depart,1,2,-1,-1,-1,0,0
feed,2,5,-3,-1,-1,0,0
evacuate,2,4,-2,-1,-1,0,0
walk,2,3,-1,-1,-1,0,0
enjoy,4,7,-3,-1,-1,0,0
reposition,1,8,-7,-1,-1,-1,0
grant,3,8,-5,-1,-1,0,0
open,3,3,0,0,-1,0,0
leave,1,2,-1,-1,-1,0,0
redesign,1,4,-3,-1,-1,-1,0
take,2,18,-16,-1,-1,0,0
offer,2,7,-5,-1,-1,0,0
list,2,7,-5,-1,-1,0,0
start,2,6,-4,-1,-1,0,0
discover,6,4,2,1,-1,0,0
reflect,2,11,-9,-1,-1,0,0
give,1,13,-12,-1,-1,0,0
take,1,3,-2,-1,-1,0,0
provide,4,5,-1,-1,-1,1,0
provide,1,3,-2,-1,-1,0,0
consider,4,4,0,0,-1,0,0
turn,3,6,-3,-1,-1,0,0
run,3,11,-8,-1,-1,0,0
rank,7,2,5,1,-1,0,0
take,3,2,1,1,-1,0,0
reveal,2,6,-4,-1,-1,0,0
link,1,6,-5,-1,-1,0,0
visit,1,3,-2,-1,-1,0,0
leave,2,5,-3,-1,-1,0,0
cross,1,17,-16,-1,-1,0,0
sort,2,3,-1,-1,-1,0,0
pay,1,3,-2,-1,-1,0,0
get,1,2,-1,-1,-1,1,0
find,1,11,-10,-1,-1,0,0
impose,3,2,1,1,-1,0,0
take,1,10,-9,-1,-1,0,0
show,3,7,-4,-1,-1,1,0
see,6,7,-1,-1,-1,0,0
say,2,2,0,0,-1,1,0
retain,1,4,-3,-1,-1,0,0
prepare,1,3,-2,-1,-1,-1,0
create,1,3,-2,-1,-1,0,0
ask,6,5,1,1,-1,0,0
give,2,2,0,0,-1,0,0
fit,1,8,-7,-1,-1,-1,0
use,1,6,-5,-1,-1,0,0
practice,5,23,-18,-1,-1,0,0
transform,2,3,-1,-1,-1,0,0
buy,1,4,-3,-1,-1,-1,0
cover,1,5,-4,-1,-1,0,0
leave,2,4,-2,-1,-1,0,0
sprinkle,2,3,-1,-1,-1,0,0
transplant,1,4,-3,-1,-1,-1,0
make,5,6,-1,-1,-1,0,0
store,2,3,-1,-1,-1,0,0
wrap,1,3,-2,-1,-1,-1,0
place,1,9,-8,-1,-1,-1,0
freeze,1,2,-1,-1,-1,-1,0
place,2,7,-5,-1,-1,0,0
put,1,5,-4,-1,-1,-1,0
hold,2,6,-4,-1,-1,0,0
move,3,6,-3,-1,-1,0,0
draw,2,6,-4,-1,-1,0,0
draw,2,8,-6,-1,-1,0,0
reduce,1,3,-2,-1,-1,0,0
transport,2,3,-1,-1,-1,0,0
annoy,1,2,-1,-1,-1,0,0
annoy,1,3,-2,-1,-1,0,0
get,3,2,1,1,-1,1,0
conduct,1,3,-2,-1,-1,0,0
add,1,3,-2,-1,-1,0,0
build,3,6,-3,-1,-1,0,0
lay,3,3,0,0,-1,0,0
demonstrate,2,7,-5,-1,-1,0,0
ask,1,3,-2,-1,-1,-1,0
ask,2,6,-4,-1,-1,0,0
ask,15,2,13,1,-1,-1,0
offer,2,3,-1,-1,-1,0,0
work,4,5,-1,-1,-1,0,0
say,1,27,-26,-1,-1,0,0
turn,4,9,-5,-1,-1,0,0
make,1,5,-4,-1,-1,0,0
shove,2,3,-1,-1,-1,0,0
put,2,5,-3,-1,-1,0,0
put,1,3,-2,-1,-1,-1,0
replace,5,2,3,1,-1,0,0
try,9,2,7,1,-1,0,0
use,3,3,0,0,-1,0,0
combine,8,3,5,1,-1,0,0
take,2,3,-1,-1,-1,0,0
base,2,4,-2,-1,-1,0,0
base,4,6,-2,-1,-1,-1,0
make,3,7,-4,-1,-1,0,0
make,3,5,-2,-1,-1,0,0
spread,1,2,-1,-1,-1,-1,0
translate,1,4,-3,-1,-1,-1,0
spread,1,6,-5,-1,-1,-1,0
spell,3,3,0,0,-1,0,0
turn,2,3,-1,-1,-1,0,0
add,1,5,-4,-1,-1,0,0
carry,3,2,-1,-1,1,-1,0
forget,3,6,-3,-1,-1,0,0
put,1,3,-2,-1,-1,0,0
base,1,3,-2,-1,-1,0,0
try,1,5,-4,-1,-1,-1,0
use,2,3,-1,-1,-1,0,0
pack,2,3,-1,-1,-1,0,0
write,7,6,1,1,-1,0,0
fill,2,3,-1,-1,-1,0,0
stack,1,5,-4,-1,-1,0,0
balance,1,8,-7,-1,-1,0,0
include,1,12,-11,-1,-1,0,0
unpack,1,2,-1,-1,-1,0,0
label,1,2,-1,-1,-1,0,0
walk,2,2,0,0,-1,0,0
sneak,1,2,-1,-1,-1,1,0
return,2,4,-2,-1,-1,0,0
fill,2,3,-1,-1,-1,0,0
pack,4,3,1,1,-1,0,0
leave,1,7,-6,-1,-1,-1,0
link,1,4,-3,-1,-1,0,0
hook,2,14,-12,-1,-1,0,0
hook,2,3,-1,-1,-1,0,0
offer,2,9,-7,-1,-1,0,0
approach,2,6,-4,-1,-1,0,0
put,2,2,0,0,-1,1,0
break,2,3,-1,-1,-1,0,0
keep,2,2,0,0,-1,0,0
put,1,3,-2,-1,-1,-1,0
make,4,4,0,0,-1,0,0
see,1,4,-3,-1,-1,-1,0
see,1,4,-3,-1,-1,-1,0
include,2,5,-3,-1,-1,0,0
finish,2,4,-2,-1,-1,1,0
throw,2,7,-5,-1,-1,0,0
peg,1,3,-2,-1,-1,0,0
drop,2,6,-4,-1,-1,0,0
change,5,3,2,1,-1,0,0
see,3,2,1,1,-1,0,0
see,7,3,4,1,-1,0,0
play,2,3,-1,-1,-1,0,0
throw,1,5,-4,-1,-1,-1,0
treat,2,2,0,0,-1,0,0
rinse,4,2,2,1,-1,0,0
impart,3,2,1,1,-1,0,0
toast,1,3,-2,-1,-1,0,0
drizzle,5,6,-1,-1,-1,0,0
reduce,1,2,-1,-1,-1,0,0
form,3,7,-4,-1,-1,0,0
take,1,3,-2,-1,-1,-1,0
take,2,3,-1,-1,-1,0,0
use,2,5,-3,-1,-1,0,0
pour,1,3,-2,-1,-1,0,0
add,9,4,5,1,-1,0,0
Preheat,1,7,-6,-1,-1,0,0
arrange,1,6,-5,-1,-1,0,0
heat,4,3,1,1,-1,0,0
add,12,3,9,1,-1,0,0
add,4,3,1,1,-1,0,0
add,9,3,6,1,-1,0,0
transfer,1,5,-4,-1,-1,0,0
remove,3,4,-1,-1,-1,0,0
create,2,8,-6,-1,-1,0,0
set,2,4,-2,-1,-1,0,0
set,5,16,-11,-1,-1,0,0
use,1,8,-7,-1,-1,0,0
bind,6,4,2,1,-1,0,0
connect,2,5,-3,-1,-1,0,0
link,2,4,-2,-1,-1,0,0
link,2,4,-2,-1,-1,0,0
edit,3,4,-1,-1,-1,0,0
open,2,5,-3,-1,-1,0,0
create,7,11,-4,-1,-1,0,0
connect,2,3,-1,-1,-1,0,0
restructure,1,3,-2,-1,-1,0,0
add,3,5,-2,-1,-1,0,0
remove,1,3,-2,-1,-1,0,0
show,3,6,-3,-1,-1,0,0
provide,3,4,-1,-1,-1,0,0
add,1,3,-2,-1,-1,0,0
show,3,3,0,0,-1,0,0
move,2,9,-7,-1,-1,0,0
move,1,4,-3,-1,-1,0,0
drag,2,3,-1,-1,-1,0,0
move,1,6,-5,-1,-1,0,0
move,2,4,-2,-1,-1,0,0
move,2,4,-2,-1,-1,0,0
move,1,4,-3,-1,-1,0,0
move,1,4,-3,-1,-1,0,0
move,1,4,-3,-1,-1,0,0
confine,2,8,-6,-1,-1,0,0
move,3,4,-1,-1,-1,0,0
move,4,6,-2,-1,-1,0,0
remove,8,5,3,1,-1,0,0
move,2,8,-6,-1,-1,0,0
link,9,4,5,1,-1,0,0
display,3,4,-1,-1,-1,0,0
add,1,3,-2,-1,-1,0,0
transform,3,23,-20,-1,-1,0,0
export,4,4,0,0,-1,0,0
store,2,11,-9,-1,-1,0,0
export,8,3,5,1,-1,0,0
export,1,4,-3,-1,-1,0,0
export,6,4,2,1,-1,0,0
export,3,8,-5,-1,-1,0,0
save,2,2,0,0,-1,0,0
export,2,4,-2,-1,-1,0,0
export,8,4,4,1,-1,0,0
save,10,10,0,0,-1,0,0
save,2,2,0,0,-1,0,0
describe,3,2,1,1,-1,0,0
convert,3,5,-2,-1,-1,0,0
call,2,2,0,0,-1,0,0
have,3,4,-1,-1,-1,0,0
copy,3,5,-2,-1,-1,0,0
export,1,6,-5,-1,-1,0,0
export,3,2,1,1,-1,0,0
move,3,5,-2,-1,-1,0,0
export,1,2,-1,-1,-1,-1,0
copy,1,19,-18,-1,-1,0,0
filter,1,7,-6,-1,-1,0,0
apply,2,6,-4,-1,-1,0,0
match,2,4,-2,-1,-1,0,0
move,2,4,-2,-1,-1,0,0
move,3,6,-3,-1,-1,0,0
move,2,6,-4,-1,-1,0,0
copy,2,6,-4,-1,-1,0,0
contain,3,3,0,0,-1,0,0
use,1,4,-3,-1,-1,0,0
convert,3,2,1,1,-1,0,0
make,1,5,-4,-1,-1,0,0
drag,1,6,-5,-1,-1,0,0
protect,2,3,-1,-1,-1,0,0
modify,1,11,-10,-1,-1,0,0
manipulate,1,4,-3,-1,-1,-1,0
provide,3,14,-11,-1,-1,0,0
make,1,3,-2,-1,-1,0,0
make,1,2,-1,-1,-1,1,0
reference,3,15,-12,-1,-1,0,0
print,2,3,-1,-1,-1,0,0
use,2,4,-2,-1,-1,0,0
produce,2,4,-2,-1,-1,0,0
select,1,7,-6,-1,-1,0,0
produce,2,4,-2,-1,-1,0,0
mix,1,10,-9,-1,-1,0,0
change,5,4,1,1,-1,0,0
export,8,8,0,0,-1,0,0
change,5,4,1,1,-1,0,0
change,4,4,0,0,-1,0,0
find,3,4,-1,-1,-1,0,0
load,2,9,-7,-1,-1,0,0
save,2,5,-3,-1,-1,0,0
save,2,5,-3,-1,-1,0,0
convert,2,3,-1,-1,-1,0,0
analyze,1,6,-5,-1,-1,0,0
save,2,5,-3,-1,-1,0,0
make,1,7,-6,-1,-1,0,0
open,2,3,-1,-1,-1,0,0
open,2,3,-1,-1,-1,0,0
open,2,3,-1,-1,-1,0,0
sort,1,5,-4,-1,-1,0,0
produce,1,8,-7,-1,-1,-1,0
watch,1,2,-1,-1,-1,0,0
leave,1,6,-5,-1,-1,-1,0
reduce,1,4,-3,-1,-1,-1,0
put,2,5,-3,-1,-1,1,0
clear,2,4,-2,-1,-1,0,0
toss,2,3,-1,-1,-1,0,0
wear,2,8,-6,-1,-1,0,0
have,2,3,-1,-1,-1,0,0
lead,1,3,-2,-1,-1,-1,0
throw,1,2,-1,-1,-1,-1,0
describe,1,2,-1,-1,-1,0,0
see,1,2,-1,-1,-1,0,0
opened,2,2,0,0,-1,0,0
blow,2,3,-1,-1,-1,0,0
leave,2,2,0,0,-1,0,0
enter,2,2,0,0,-1,1,0
make,2,3,-1,-1,-1,0,0
reduce,1,2,-1,-1,-1,-1,0
address,2,3,-1,-1,-1,0,0
turn,2,2,0,0,-1,0,0
say,1,4,-3,-1,-1,-1,0
retrace,2,3,-1,-1,-1,0,0
lord,1,8,-7,-1,-1,-1,0
take,2,6,-4,-1,-1,0,0
be,1,5,-4,-1,-1,0,0
remain,4,2,2,1,-1,-1,0
pick,2,3,-1,-1,-1,0,0
inspect,2,4,-2,-1,-1,0,0
return,2,3,-1,-1,-1,0,0
form,3,2,1,1,-1,1,0
steal,1,4,-3,-1,-1,-1,0
pick,1,3,-2,-1,-1,0,0
lull,2,2,0,0,-1,0,0
call,1,2,-1,-1,-1,1,0
know,1,2,-1,-1,-1,-1,0
require,1,4,-3,-1,-1,0,0
use,2,5,-3,-1,-1,0,0
flood,1,2,-1,-1,-1,-1,0
drown,1,3,-2,-1,-1,0,0
follow,3,3,0,0,-1,0,0
remind,1,3,-2,-1,-1,0,0
take,2,3,-1,-1,-1,0,0
look,5,4,-1,-1,1,0,0
answer,1,3,-2,-1,-1,-1,0
ride,2,4,-2,-1,-1,0,0
suggest,1,2,-1,-1,-1,-1,0
write,1,4,-3,-1,-1,0,0
lead,1,4,-3,-1,-1,-1,0
place,1,10,-9,-1,-1,-1,0
put,1,2,-1,-1,-1,0,0
excuse,1,2,-1,-1,-1,-1,0
find,1,3,-2,-1,-1,-1,0
put,1,3,-2,-1,-1,-1,0
fasten,8,4,4,1,-1,0,0
rewind,2,3,-1,-1,-1,0,0
taunt,1,6,-5,-1,-1,-1,0
extend,2,2,0,0,-1,1,0
lengthen,2,4,-2,-1,-1,0,0
leave,2,3,-1,-1,-1,0,0
avoid,1,3,-2,-1,-1,-1,0
hold,3,3,0,0,-1,0,0
wear,5,3,2,1,-1,0,0
make,1,6,-5,-1,-1,0,0
find,8,6,2,1,-1,0,0
pay,2,2,0,0,-1,0,0
say,1,8,-7,-1,-1,-1,0
have,1,2,-1,-1,-1,1,0
give,2,3,-1,-1,-1,0,0
pack,2,2,0,0,-1,1,0
have,2,2,0,0,-1,1,0
accept,3,2,1,1,-1,1,0
sell,1,2,-1,-1,-1,-1,0
treat,6,4,2,1,-1,0,0
toast,2,2,0,0,-1,0,0
report,10,2,-8,-1,1,0,0
see,2,2,0,0,-1,1,0
kick,3,7,-4,-1,-1,0,0
add,3,6,-3,-1,-1,0,0
find,11,7,-4,-1,1,0,0
lend,8,48,-40,-1,-1,0,0
persuade,1,3,-2,-1,-1,0,0
spread,1,3,-2,-1,-1,0,0
fight,2,2,0,0,-1,0,0
buy,2,5,-3,-1,-1,0,0
borrow,1,2,-1,-1,-1,-1,0
see,1,5,-4,-1,-1,-1,0
characterize,6,12,-6,-1,-1,0,0
build,2,3,-1,-1,-1,0,0
find,3,7,-4,-1,-1,0,0
know,1,5,-4,-1,-1,-1,0
do,3,2,1,1,-1,0,0
hear,2,2,0,0,-1,1,0
drink,1,4,-3,-1,-1,0,0
ask,2,3,1,1,1,0,0
give,2,3,-1,-1,-1,0,0
get,1,4,-3,-1,-1,0,0
have,5,12,-7,-1,-1,0,0
remind,1,6,-5,-1,-1,0,0
stand,2,4,-2,-1,-1,0,0
pass,1,2,-1,-1,-1,0,0
nail,1,4,-3,-1,-1,0,0
shut,2,4,-2,-1,-1,0,0
shut,3,2,1,1,-1,1,0
hear,2,3,-1,-1,-1,0,0
lose,1,4,-3,-1,-1,0,0
have,5,8,3,1,1,0,0
drape,3,3,0,0,-1,0,0
follow,2,4,-2,-1,-1,0,0
evoke,6,7,-1,-1,-1,0,0
unfold,6,2,-4,-1,1,-1,0
keep,2,10,-8,-1,-1,0,0
lift,2,3,-1,-1,-1,0,0
be,4,6,-2,-1,-1,-1,0
show,21,3,-18,-1,1,0,0
throw,4,8,-4,-1,-1,1,0
hinder,2,3,-1,-1,-1,-1,0
lose,1,6,-5,-1,-1,-1,0
put,2,2,0,0,-1,1,0
have,12,4,8,1,-1,0,0
explain,1,2,-1,-1,-1,0,0
have,2,5,-3,-1,-1,0,0
invite,1,3,-2,-1,-1,-1,0
speak,1,6,-5,-1,-1,0,0
hang,1,3,-2,-1,-1,-1,0
balance,5,3,2,1,-1,0,0
keep,1,3,-2,-1,-1,0,0
have,3,3,0,0,-1,0,0
carry,2,3,-1,-1,-1,0,0
see,3,3,0,0,-1,0,0
fill,15,4,11,1,-1,0,0
fish,2,4,-2,-1,-1,0,0
bring,2,3,-1,-1,-1,0,0
seal,2,5,-3,-1,-1,0,0
treat,7,3,4,1,-1,0,0
pay,2,3,-1,-1,-1,0,0
mutter,4,2,-2,-1,1,-1,0
turn,5,3,2,1,-1,0,0
keep,2,6,-4,-1,-1,0,0
see,3,3,0,0,-1,-1,0
cut,1,3,-2,-1,-1,0,0
cause,2,3,-1,-1,-1,0,0
take,1,3,-2,-1,-1,-1,0
approach,2,3,-1,-1,-1,0,0
find,1,7,-6,-1,-1,-1,0
take,1,4,-3,-1,-1,0,0
ask,1,12,-11,-1,-1,-1,0
make,1,9,-8,-1,-1,1,0
hate,2,4,-2,-1,-1,-1,0
provoke,5,3,2,1,-1,0,0
bring,2,8,-6,-1,-1,0,0
have,2,2,0,0,-1,0,0
express,2,10,-8,-1,-1,0,0
put,2,4,-2,-1,-1,0,0
have,4,10,-6,-1,-1,0,0
need,2,17,-15,-1,-1,0,0
have,2,12,-10,-1,-1,0,0
give,2,17,-15,-1,-1,0,0
produce,9,2,-7,-1,1,-1,0
involve,2,3,-1,-1,-1,0,0
give,2,3,-1,-1,-1,0,0
owe,3,2,1,1,-1,1,0
focus,2,4,-2,-1,-1,0,0
include,2,3,-1,-1,-1,-1,0
limit,3,4,-1,-1,-1,0,0
take,1,12,-11,-1,-1,0,0
include,2,3,-1,-1,-1,0,0
undergo,4,5,-1,-1,-1,0,0
have,2,5,-3,-1,-1,0,0
salute,1,8,-7,-1,-1,0,0
give,2,6,-4,-1,-1,0,0
scrape,2,7,-5,-1,-1,0,0
allow,4,4,0,0,-1,0,0
give,3,2,1,1,-1,0,0
offer,3,3,0,0,-1,0,0
congratulate,2,3,-1,-1,-1,0,0
have,2,3,-1,-1,-1,0,0
give,2,4,-2,-1,-1,0,0
promote,2,4,-2,-1,-1,0,0
give,1,7,-6,-1,-1,0,0
reach,1,7,-6,-1,-1,-1,0
give,2,8,-6,-1,-1,0,0
compliment,2,3,-1,-1,-1,0,0
protect,1,4,-3,-1,-1,-1,0
take,11,2,-9,-1,1,0,0
discuss,3,10,-7,-1,-1,0,0
make,3,4,-1,-1,-1,0,0
do,4,3,1,1,-1,0,0
produce,3,3,0,0,-1,1,0
support,5,11,-6,-1,-1,0,0
secure,2,4,-2,-1,-1,0,0
place,2,5,-3,-1,-1,0,0
define,8,3,-5,-1,1,0,0
have,2,3,-1,-1,-1,0,0
overrun,1,3,-2,-1,-1,0,0
smooth,2,18,-16,-1,-1,0,0
expect,2,5,-3,-1,-1,0,0
trust,2,2,0,0,-1,0,0
link,1,3,-2,-1,-1,0,0
efface,1,11,-10,-1,-1,-1,0
offer,2,5,-3,-1,-1,1,0
bring,7,9,2,1,1,0,0
clean,2,3,-1,-1,-1,0,0
play,1,6,-5,-1,-1,0,0
make,3,4,-1,-1,-1,0,0
have,7,5,2,1,-1,0,0
take,22,3,-19,-1,1,0,0
put,1,2,-1,-1,-1,-1,0
lose,1,3,-2,-1,-1,-1,0
watch,2,4,-2,-1,-1,0,0
shine,2,2,0,0,-1,0,0
hamper,2,7,-5,-1,-1,0,0
arouse,25,2,-23,-1,1,-1,0
write,9,6,-3,-1,1,0,0
read,2,3,-1,-1,-1,0,0
catch,2,12,-10,-1,-1,0,0
wedge,1,3,-2,-1,-1,-1,0
shake,1,5,-4,-1,-1,0,0
drag,3,4,-1,-1,-1,0,0
discuss,9,2,-7,-1,1,0,0
enter,2,20,-18,-1,-1,0,0
recognize,1,2,-1,-1,-1,-1,0
do,1,3,-2,-1,-1,-1,0
say,1,3,-2,-1,-1,-1,0
introduce,5,6,-1,-1,-1,0,0
replace,1,3,-2,-1,-1,-1,0
take,1,4,-3,-1,-1,-1,0
meet,3,2,1,1,-1,0,0
say,1,2,-1,-1,-1,0,0
make,4,4,0,0,-1,0,0
start,3,8,-5,-1,-1,0,0
say,1,2,-1,-1,-1,0,0
fill,3,5,-2,-1,-1,0,0
hear,1,6,-5,-1,-1,-1,0
lift,2,4,-2,-1,-1,0,0
salute,2,3,-1,-1,-1,-1,0
take,1,3,-2,-1,-1,-1,0
draw,10,10,0,0,1,0,0
touch,4,2,2,1,-1,0,0
give,4,8,-4,-1,-1,0,0
take,1,2,-1,-1,-1,1,0
ask,1,4,-3,-1,-1,-1,0
forget,2,3,-1,-1,-1,0,0
do,3,3,0,0,-1,0,0
lean,2,2,0,0,-1,1,0
break,1,4,-3,-1,-1,0,0
signal,2,8,-6,-1,-1,0,0
see,1,3,-2,-1,-1,-1,0
take,5,5,0,0,-1,0,0
stir,2,3,-1,-1,-1,1,0
show,3,3,0,0,-1,0,0
hold,2,7,-5,-1,-1,0,0
raise,5,2,3,1,-1,1,0
put,2,3,-1,-1,-1,0,0
get,1,5,-4,-1,-1,-1,0
keep,1,2,-1,-1,-1,-1,0
take,3,3,0,0,1,0,0
kill,3,3,0,0,-1,0,0
want,8,2,6,1,-1,0,0
wear,5,3,2,1,-1,0,0
run,4,6,-2,-1,-1,0,0
put,2,4,-2,-1,-1,0,0
know,1,2,-1,-1,-1,0,0
kill,2,2,0,0,-1,0,0
have,2,2,0,0,-1,0,0
have,5,7,-2,-1,-1,0,0
offer,4,7,-3,-1,-1,0,0
sink,1,2,-1,-1,-1,0,0
take,2,3,-1,-1,-1,0,0
give,1,2,-1,-1,-1,0,0
put,1,3,-2,-1,-1,-1,0
knock,2,6,-4,-1,-1,0,0
take,1,3,-2,-1,-1,0,0
accept,1,21,-20,-1,-1,-1,0
meet,1,6,-5,-1,-1,0,0
answer,1,6,-5,-1,-1,0,0
pass,6,11,-5,-1,-1,0,0
exchange,2,4,-2,-1,-1,0,0
fall,2,8,-6,-1,-1,0,0
clap,2,3,-1,-1,-1,0,0
heave,1,3,-2,-1,-1,0,0
treat,1,18,-17,-1,-1,-1,0
padlock,4,3,1,1,-1,0,0
carry,1,6,-5,-1,-1,1,0
spend,2,3,-1,-1,-1,0,0
get,2,9,-7,-1,-1,0,0
take,2,10,-8,-1,-1,0,0
get,3,2,1,1,-1,1,0
bring,2,3,-1,-1,-1,0,0
unlock,3,2,1,1,-1,0,0
use,1,2,-1,-1,-1,0,0
turn,2,3,-1,-1,-1,-1,0
mutter,2,3,-1,-1,-1,0,0
give,3,12,-9,-1,-1,0,0
have,2,2,0,0,-1,0,0
pass,2,4,-2,-1,-1,0,0
watch,1,5,-4,-1,-1,-1,0
hear,3,3,0,0,-1,0,0
hand,1,2,-1,-1,-1,0,0
take,3,3,0,0,-1,0,0
heave,2,3,-1,-1,-1,0,0
throw,2,3,-1,-1,-1,0,0
let,2,4,-2,-1,-1,0,0
grab,1,3,-2,-1,-1,-1,0
hand,2,2,0,0,-1,0,0
use,1,5,-4,-1,-1,-1,0
hear,2,4,-2,-1,-1,0,0
serve,1,2,-1,-1,-1,1,0
put,1,2,-1,-1,-1,1,0
put,1,3,-2,-1,-1,-1,0
peck,2,3,-1,-1,-1,0,0
throw,2,3,-1,-1,-1,0,0
throw,1,4,-3,-1,-1,0,0
butter,1,2,-1,-1,-1,0,0
pull,3,6,-3,-1,-1,0,0
help,1,3,-2,-1,-1,-1,0
bear,2,2,0,0,-1,-1,0
scatter,2,3,-1,-1,-1,0,0
hold,3,4,-1,-1,-1,0,0
drum,2,3,-1,-1,-1,0,0
smooth,3,4,-1,-1,-1,0,0
take,4,4,0,0,-1,0,0
unravel,1,3,-2,-1,-1,-1,0
fix,2,3,-1,-1,-1,0,0
give,1,4,-3,-1,-1,0,0
claim,6,2,4,1,-1,0,0
see,2,5,-3,-1,-1,0,0
stretch,2,3,-1,-1,-1,0,0
wipe,2,3,-1,-1,-1,0,0
clutch,3,3,0,0,-1,0,0
watch,1,6,-5,-1,-1,-1,0
seize,1,6,-5,-1,-1,0,0
pull,2,3,-1,-1,-1,-1,0
knock,2,5,-3,-1,-1,0,0
see,5,3,2,1,-1,0,0
brush,1,2,-1,-1,-1,0,0
knock,1,10,-9,-1,-1,-1,0
pull,4,4,0,0,-1,0,0
get,2,2,0,0,-1,1,0
enjoy,3,5,-2,-1,-1,0,0
sweep,3,3,0,0,-1,0,0
block,2,2,0,0,-1,0,0
shove,3,4,-1,-1,-1,0,0
make,2,3,-1,-1,-1,0,0
see,11,3,-8,-1,1,0,0
flash,3,3,0,0,-1,0,0
take,1,15,-14,-1,-1,0,0
emit,4,4,0,0,-1,0,0
slumber,2,3,-1,-1,-1,0,0
whel,1,5,-4,-1,-1,-1,0
push,2,2,0,0,-1,-1,0
take,1,2,-1,-1,-1,-1,0
have,3,2,1,1,-1,0,0
take,1,2,-1,-1,-1,-1,0
interpret,2,8,-6,-1,-1,0,0
yowl,2,3,-1,-1,-1,0,0
split,2,2,0,0,-1,0,0
manifest,1,3,-2,-1,-1,-1,0
smoke,3,3,0,0,-1,0,0
leave,1,5,-4,-1,-1,0,0
hide,1,2,-1,-1,-1,0,0
frisk,1,4,-3,-1,-1,-1,0
express,2,8,-6,-1,-1,0,0
plan,5,15,-10,-1,-1,0,0
stuff,2,7,-5,-1,-1,1,0
put,2,3,-1,-1,-1,0,0
whir,1,4,-3,-1,-1,-1,0
interpret,2,6,-4,-1,-1,0,0
scoop,2,3,-1,-1,-1,0,0
pour,2,2,0,0,-1,0,0
drain,1,3,-2,-1,-1,-1,0
beckon,2,3,-1,-1,-1,0,0
take,1,4,-3,-1,-1,-1,0
navigate,5,5,0,0,-1,0,0
keep,5,2,-3,-1,1,0,0
ask,1,3,-2,-1,-1,-1,0
say,1,2,-1,-1,-1,0,0
kiss,1,5,-4,-1,-1,-1,0
carry,1,3,-2,-1,-1,-1,0
stack,3,3,0,0,-1,0,0
ease,2,7,-5,-1,-1,0,0
scatter,2,7,-5,-1,-1,0,0
fight,2,3,-1,-1,-1,0,0
take,2,2,0,0,-1,1,0
make,1,3,-2,-1,-1,0,0
opened,1,3,-2,-1,-1,-1,0
tell,5,41,-36,-1,-1,0,0
give,1,2,-1,-1,-1,0,0
take,1,6,-5,-1,-1,0,0
make,1,2,-1,-1,-1,1,0
throw,1,4,-3,-1,-1,-1,0
find,3,4,-1,-1,-1,0,0
give,1,2,-1,-1,-1,1,0
use,1,4,-3,-1,-1,0,0
convince,1,2,-1,-1,-1,0,0
burn,2,6,-4,-1,-1,0,0
meet,1,4,-3,-1,-1,0,0
bring,1,10,-9,-1,-1,-1,0
break,1,7,-6,-1,-1,-1,0
force,1,2,-1,-1,-1,0,0
get,2,2,0,0,-1,1,0
pin,1,3,-2,-1,-1,-1,0
have,3,3,0,0,-1,0,0
lick,2,6,-4,-1,-1,0,0
avail,1,3,-2,-1,-1,-1,0
tell,1,3,-2,-1,-1,-1,0
twist,2,3,-1,-1,-1,0,0
see,1,6,-5,-1,-1,-1,0
make,1,2,-1,-1,-1,1,0
scatter,3,3,0,0,-1,0,0
smash,1,4,-3,-1,-1,-1,0
get,1,3,-2,-1,-1,-1,0
kiss,1,5,-4,-1,-1,-1,0
say,2,3,-1,-1,-1,0,0
do,2,6,-4,-1,-1,0,0
take,2,19,-17,-1,-1,0,0
provide,2,5,-3,-1,-1,0,0
exercise,2,5,-3,-1,-1,0,0
grant,4,10,-6,-1,-1,0,0
incorporate,2,6,-4,-1,-1,0,0
perform,8,7,-1,-1,1,0,0
exercise,2,5,-3,-1,-1,0,0
distribute,2,23,-21,-1,-1,0,0
control,6,11,-5,-1,-1,0,0
require,3,5,-2,-1,-1,0,0
create,3,5,-2,-1,-1,0,0
remove,9,4,-5,-1,1,0,0
remove,9,4,-5,-1,1,0,0
distribute,3,41,-38,-1,-1,0,0
contain,4,3,1,1,-1,0,0
distribute,3,23,-20,-1,-1,0,0
control,6,11,-5,-1,-1,0,0
identify,5,4,1,1,-1,0,0
release,2,4,-2,-1,-1,0,0
constitute,6,7,-1,-1,-1,0,0
include,13,2,-11,-1,1,0,0
identify,1,3,-2,-1,-1,-1,0
use,13,8,5,1,-1,0,0
wish,4,10,-6,-1,-1,0,0
write,2,5,-3,-1,-1,0,0
ask,1,22,-21,-1,-1,-1,0
draw,2,12,-10,-1,-1,0,0
compliment,1,32,-31,-1,-1,-1,0
refer,2,5,-3,-1,-1,0,0
table,1,16,-15,-1,-1,0,0
dictate,7,5,2,1,-1,0,0
express,5,4,1,1,-1,0,0
explain,1,3,-2,-1,-1,-1,0
reject,2,10,-8,-1,-1,0,0
give,4,5,-1,-1,-1,0,0
adopt,2,4,-2,-1,-1,0,0
take,3,2,-1,-1,1,0,0
cause,2,10,-8,-1,-1,0,0
cut,3,7,-4,-1,-1,0,0
seal,2,4,-2,-1,-1,0,0
transit,1,3,-2,-1,-1,0,0
experience,2,3,-1,-1,-1,0,0
thank,2,13,-11,-1,-1,0,0
have,5,3,-2,-1,1,0,0
congratulate,1,4,-3,-1,-1,-1,0
involve,2,2,0,0,-1,0,0
support,6,28,-22,-1,-1,0,0
make,1,4,-3,-1,-1,0,0
have,6,3,3,1,-1,0,0
thank,2,10,-8,-1,-1,0,0
pay,2,2,0,0,-1,1,0
employ,3,2,1,1,-1,0,0
enforce,2,2,0,0,-1,0,0
include,6,9,-3,-1,-1,0,0
give,3,4,-1,-1,-1,0,0
prioritize,4,9,-5,-1,-1,0,0
incorporate,1,6,-5,-1,-1,-1,0
present,1,4,-3,-1,-1,-1,0
congratulate,2,14,-12,-1,-1,0,0
improve,1,9,-8,-1,-1,-1,0
congratulate,4,24,-20,-1,-1,0,0
thank,3,3,0,0,-1,0,0
consider,1,5,-4,-1,-1,0,0
hold,9,6,3,1,-1,0,0
discuss,2,8,-6,-1,-1,0,0
repeat,2,11,-9,-1,-1,0,0
amend,3,5,-2,-1,-1,0,0
enact,4,17,-13,-1,-1,0,0
amend,3,9,-6,-1,-1,0,0
increase,1,5,-4,-1,-1,0,0
keep,2,9,-7,-1,-1,0,0
take,1,17,-16,-1,-1,0,0
take,1,15,-14,-1,-1,0,0
thank,12,25,-13,-1,-1,0,0
acknowledge,1,3,-2,-1,-1,-1,0
carry,10,4,6,1,-1,0,0
find,1,10,-9,-1,-1,-1,0
grant,3,5,-2,-1,-1,0,0
see,10,3,7,1,-1,0,0
provide,3,4,-1,-1,-1,0,0
take,1,3,-2,-1,-1,0,0
see,1,65,-64,-1,-1,-1,0
locate,3,30,-27,-1,-1,0,0
draw,4,3,1,1,-1,0,0
draw,3,29,-26,-1,-1,0,0
view,3,7,-4,-1,-1,0,0
draw,1,11,-10,-1,-1,0,0
indicate,5,2,-3,-1,1,-1,0
maintain,2,31,-29,-1,-1,0,0
taking,1,23,-22,-1,-1,0,0
provide,4,3,1,1,-1,0,0
require,1,3,-2,-1,-1,0,0
bear,37,2,-35,-1,1,0,0
take,3,2,1,1,-1,0,0
maintain,2,3,-1,-1,-1,0,0
thank,4,3,1,1,-1,0,0
thank,1,51,-50,-1,-1,-1,0
take,1,6,-5,-1,-1,0,0
unite,2,5,-3,-1,-1,1,0
focus,2,7,-5,-1,-1,0,0
make,2,2,0,0,-1,0,0
get,3,7,-4,-1,-1,0,0
overcome,2,6,-4,-1,-1,0,0
bear,1,2,-1,-1,-1,-1,0
use,6,4,2,1,-1,0,0
give,4,10,-6,-1,-1,0,0
take,1,13,-12,-1,-1,0,0
attach,2,3,-1,-1,-1,0,0
improve,10,2,8,1,-1,0,0
put,2,2,0,0,1,0,0
draw,2,24,-22,-1,-1,0,0
express,2,8,-6,-1,-1,0,0
remind,1,15,-14,-1,-1,-1,0
have,3,6,-3,-1,-1,0,0
envisage,5,5,0,0,-1,0,0
re-establish,2,4,-2,-1,-1,0,0
make,6,27,-21,-1,-1,0,0
purchase,1,4,-3,-1,-1,0,0
share,3,2,1,1,-1,1,0
use,3,3,0,0,-1,0,0
see,5,4,1,1,-1,0,0
get,4,3,1,1,-1,0,0
send,1,3,-2,-1,-1,0,0
add,3,5,-2,-1,-1,0,0
enter,5,9,-4,-1,-1,0,0
add,3,3,0,0,-1,0,0
click,3,8,-5,-1,-1,0,0
add,3,3,0,0,-1,0,0
select,2,5,-3,-1,-1,0,0
build,2,3,-1,-1,-1,0,0
adjust,3,3,0,0,-1,0,0
reach,3,4,-1,-1,-1,0,0
treat,1,7,-6,-1,-1,0,0
provide,1,4,-3,-1,-1,0,0
set,17,6,11,1,-1,0,0
hone,2,11,-9,-1,-1,0,0
have,13,2,11,1,-1,0,0
turn,3,4,-1,-1,-1,0,0
acquire,2,4,-2,-1,-1,0,0
get,3,4,-1,-1,-1,0,0
limit,1,3,-2,-1,-1,0,0
reserve,2,5,-3,-1,-1,0,0
have,3,3,0,0,-1,0,0
bear,24,2,-22,-1,1,0,0
maintain,2,12,-10,-1,-1,0,0
introduce,14,19,-5,-1,-1,-1,0
inform,1,8,-7,-1,-1,0,0
reduce,5,7,-2,-1,-1,0,0
consider,10,4,-6,-1,1,0,0
facilitate,2,4,-2,-1,-1,0,0
take,1,6,-5,-1,-1,0,0
reduce,3,3,0,0,-1,0,0
facilitates,3,3,0,0,-1,0,0
asses,3,6,-3,-1,-1,0,0
encourage,4,10,-6,-1,-1,0,0
take,2,34,-32,-1,-1,0,0
exchange,11,9,2,1,-1,0,0
carry,4,10,-6,-1,-1,0,0
establish,6,10,-4,-1,-1,0,0
extend,32,6,-26,-1,1,0,0
protect,2,2,0,0,-1,0,0
set,7,3,4,1,-1,0,0
achieve,17,10,7,1,-1,0,0
play,3,3,0,0,-1,0,0
submit,3,4,-1,-1,-1,0,0
develop,3,20,-17,-1,-1,0,0
take,1,3,-2,-1,-1,0,0
organize,1,4,-3,-1,-1,0,0
establish,3,8,-5,-1,-1,0,0
show,5,8,-3,-1,-1,1,0
organize,1,12,-11,-1,-1,0,0
take,1,4,-3,-1,-1,0,0
centralize,11,8,3,1,-1,0,0
assist,4,11,-7,-1,-1,0,0
apply,2,4,-2,-1,-1,0,0
extend,3,5,-2,-1,-1,0,0
extend,2,17,-15,-1,-1,0,0
train,2,20,-18,-1,-1,0,0
promote,7,3,4,1,-1,0,0
achieve,14,7,-7,-1,1,0,0
secure,7,17,-10,-1,-1,0,0
act,1,5,-4,-1,-1,0,0
have,2,23,-21,-1,-1,0,0
grant,1,6,-5,-1,-1,-1,0
have,8,5,3,1,-1,0,0
have,8,6,2,1,-1,0,0
seek,3,3,0,0,1,0,0
take,1,6,-5,-1,-1,0,0
join,2,6,-4,-1,-1,0,0
further,6,5,1,1,-1,0,0
have,1,16,-15,-1,-1,0,0
meet,11,4,7,1,-1,0,0
imply,26,6,-20,-1,1,0,0
have,5,4,1,1,-1,0,0
pile,4,7,-3,-1,-1,0,0
absorb,1,7,-6,-1,-1,-1,0
jam,1,11,-10,-1,-1,0,0
have,1,12,-11,-1,-1,0,0
smuggle,4,2,2,1,-1,0,0
test,2,5,-3,-1,-1,0,0
enjoy,3,4,-1,-1,-1,0,0
isolate,3,6,-3,-1,-1,0,0
bear,4,2,2,1,-1,0,0
prop,4,3,1,1,-1,0,0
invest,5,3,2,1,-1,0,0
preoccupy,1,4,-3,-1,-1,0,0
close,3,4,-1,-1,-1,0,0
put,5,2,3,1,-1,0,0
create,3,4,-1,-1,-1,0,0
attack,1,27,-26,-1,-1,0,0
surprise,2,3,-1,-1,-1,0,0
have,4,3,1,1,-1,0,0
imply,1,7,-6,-1,-1,0,0
reduce,2,3,-1,-1,-1,0,0
find,3,15,-12,-1,-1,0,0
develop,6,14,-8,-1,-1,0,0
keep,3,4,-1,-1,-1,0,0
provide,1,4,-3,-1,-1,0,0
leave,3,6,-3,-1,-1,0,0
swing,4,12,-8,-1,-1,0,0
pit,4,3,1,1,-1,0,0
demand,3,2,1,1,-1,0,0
save,2,3,-1,-1,-1,0,0
integrated,2,5,-3,-1,-1,0,0
improve,3,10,-7,-1,-1,0,0
develop,3,10,-7,-1,-1,0,0
roll,2,6,-4,-1,-1,0,0
combine,1,7,-6,-1,-1,-1,0
open,3,14,-11,-1,-1,0,0
increase,2,3,-1,-1,-1,0,0
reconstruct,1,4,-3,-1,-1,0,0
cause,2,16,-14,-1,-1,0,0
need,4,3,1,1,-1,0,0
provide,2,7,-5,-1,-1,0,0
take,1,21,-20,-1,-1,0,0
lend,2,3,-1,-1,-1,0,0
draw,1,17,-16,-1,-1,0,0
pose,2,7,-5,-1,-1,0,0
lower,3,3,0,0,-1,1,0
enable,5,6,-1,-1,-1,0,0
detect,5,3,2,1,-1,0,0
award,3,6,-3,-1,-1,0,0
pride,1,3,-2,-1,-1,-1,0
attract,4,4,0,0,-1,0,0
make,2,3,-1,-1,-1,0,0
compare,2,28,-26,-1,-1,1,0
hold,5,3,2,1,-1,0,0
begin,1,6,-5,-1,-1,0,0
increase,11,2,9,1,-1,0,0
support,3,9,-6,-1,-1,0,0
empower,1,5,-4,-1,-1,0,0
make,3,20,-17,-1,-1,0,0
pursue,4,11,-7,-1,-1,0,0
owe,1,10,-9,-1,-1,0,0
increase,1,2,-1,-1,-1,0,0
create,5,2,3,1,-1,0,0
elect,7,2,5,1,-1,0,0
exceed,4,10,-6,-1,-1,1,0
create,2,2,0,0,-1,0,0
split,2,4,-2,-1,-1,0,0
offer,1,2,-1,-1,-1,0,0
create,3,4,-1,-1,-1,0,0
narrow,2,8,-6,-1,-1,0,0
foster,3,3,0,0,-1,0,0
identify,5,12,-7,-1,-1,0,0
meet,1,2,-1,-1,-1,-1,0
reduce,1,3,-2,-1,-1,0,0
turn,5,6,-1,-1,-1,0,0
have,5,4,1,1,-1,0,0
highlight,3,3,0,0,-1,0,0
devote,3,3,0,0,-1,0,0
hire,1,4,-3,-1,-1,0,0
recognize,2,8,-6,-1,-1,0,0
set,5,4,1,1,-1,0,0
take,6,2,-4,-1,1,0,0
assault,2,5,-3,-1,-1,0,0
return,6,8,-2,-1,-1,0,0
rebuild,1,4,-3,-1,-1,0,0
tie,2,11,-9,-1,-1,0,0
need,3,3,0,0,-1,0,0
rise,4,4,0,0,-1,0,0
move,1,3,-2,-1,-1,0,0
manipulate,1,3,-2,-1,-1,0,0
fear,7,9,-2,-1,-1,0,0
employ,6,2,4,1,-1,0,0
turn,2,4,-2,-1,-1,0,0
get,5,2,3,1,-1,0,0
increase,3,6,-3,-1,-1,0,0
enslave,4,5,-1,-1,-1,0,0
incorporate,6,4,2,1,-1,0,0
have,3,6,-3,-1,-1,0,0
have,2,2,0,0,-1,1,0
find,3,4,-1,-1,-1,0,0
do,2,7,-5,-1,-1,0,0
play,5,4,1,1,-1,0,0
cause,1,3,-2,-1,-1,0,0
conduct,3,7,-4,-1,-1,0,0
conduct,1,7,-6,-1,-1,0,0
emphasize,5,6,-1,-1,-1,0,0
control,1,19,-18,-1,-1,-1,0
move,1,4,-3,-1,-1,0,0
oppose,3,11,-8,-1,-1,0,0
pass,2,6,-4,-1,-1,0,0
impose,1,5,-4,-1,-1,0,0
view,4,8,-4,-1,-1,0,0
adapt,2,6,4,1,1,0,0
cause,1,3,-2,-1,-1,0,0
turn,2,5,-3,-1,-1,0,0
end,2,3,-1,-1,-1,0,0
change,2,7,-5,-1,-1,1,0
add,4,4,0,0,1,0,0
coordinate,1,3,-2,-1,-1,0,0
send,1,2,-1,-1,-1,0,0
give,3,3,0,0,-1,0,0
contact,2,8,-6,-1,-1,0,0
attribute,2,3,-1,-1,-1,0,0
commit,1,6,-5,-1,-1,-1,0
heap,3,6,-3,-1,-1,0,0
attempt,1,7,-6,-1,-1,0,0
follow,1,3,-2,-1,-1,-1,0
cause,2,4,-2,-1,-1,0,0
read,3,3,0,0,-1,0,0
write,2,9,-7,-1,-1,0,0
borrow,1,5,-4,-1,-1,0,0
cause,2,3,-1,-1,-1,0,0
give,2,3,-1,-1,-1,0,0
owe,2,3,-1,-1,-1,0,0
lose,2,4,-2,-1,-1,0,0
include,14,2,-12,-1,1,-1,0
draw,1,15,-14,-1,-1,0,0
establish,1,5,-4,-1,-1,-1,0
owe,2,3,-1,-1,-1,0,0
overthrow,2,2,0,0,-1,0,0
bear,1,9,-8,-1,-1,0,0
transpose,5,4,1,1,-1,0,0
match,4,33,-29,-1,-1,0,0
father,4,8,-4,-1,-1,0,0
make,2,2,0,0,-1,1,0
cover,3,7,-4,-1,-1,0,0
repeat,2,6,-4,-1,-1,0,0
cause,2,6,-4,-1,-1,1,0
spend,1,24,-23,-1,-1,0,0
purchase,3,5,-2,-1,-1,0,0
impress,1,3,-2,-1,-1,-1,0
take,2,5,-3,-1,-1,0,0
marry,1,2,1,1,1,0,0
write,2,2,0,0,-1,0,0
have,4,9,-5,-1,-1,0,0
feature,1,8,-7,-1,-1,0,0
stabilize,1,2,-1,-1,-1,-1,0
construct,3,4,-1,-1,-1,0,0
transfer,1,11,-10,-1,-1,-1,0
see,2,4,-2,-1,-1,0,0
give,5,3,2,1,-1,0,0
observing,1,4,-3,-1,-1,-1,0
use,9,8,1,1,-1,0,0
owe,2,5,-3,-1,-1,0,0
produce,5,4,1,1,-1,0,0
worship,1,9,-8,-1,-1,0,0
issue,3,4,-1,-1,-1,0,0
give,1,8,-7,-1,-1,0,0
flee,2,2,0,0,-1,0,0
mind,5,2,3,1,-1,0,0
name,4,3,1,1,-1,0,0
bombast,3,5,-2,-1,-1,0,0
identify,1,4,-3,-1,-1,0,0
mean,8,7,1,1,-1,0,0
change,2,5,-3,-1,-1,0,0
take,2,3,1,1,1,0,0
buy,4,4,0,0,-1,0,0
visit,1,5,-4,-1,-1,0,0
buy,2,5,-3,-1,-1,0,0
marry,4,2,2,1,-1,0,0
sign,5,4,1,1,-1,0,0
cause,4,4,0,0,-1,0,0
leave,6,5,1,1,-1,0,0
see,2,5,-3,-1,-1,0,0
compare,1,5,-4,-1,-1,-1,0
stoke,4,12,-8,-1,-1,0,0
destroy,1,2,-1,-1,-1,-1,0
add,3,4,-1,-1,-1,0,0
find,1,5,-4,-1,-1,-1,0
enter,3,5,-2,-1,-1,0,0
play,3,18,-15,-1,-1,0,0
set,1,6,-5,-1,-1,0,0
burned,2,3,-1,-1,-1,0,0
pinpoint,6,3,3,1,-1,0,0
praise,2,15,-13,-1,-1,0,0
write,1,19,-18,-1,-1,-1,0
hold,2,2,0,0,-1,0,0
adapt,3,4,-1,-1,-1,0,0
combine,2,3,-1,-1,-1,0,0
tune,4,7,-3,-1,-1,0,0
release,8,8,0,0,-1,0,0
use,1,2,-1,-1,-1,-1,0
convey,2,4,-2,-1,-1,0,0
describe,2,15,-13,-1,-1,0,0
combine,2,7,-5,-1,-1,0,0
dramatize,1,7,-6,-1,-1,0,0
preserve,5,4,1,1,-1,0,0
make,3,5,-2,-1,-1,0,0
describe,8,6,2,1,-1,0,0
influence,1,9,-8,-1,-1,0,0
owe,1,2,-1,-1,-1,0,0
translate,1,2,-1,-1,-1,0,0
find,2,4,-2,-1,-1,0,0
number,1,5,-4,-1,-1,-1,0
rate,1,6,-5,-1,-1,0,0
mix,2,3,-1,-1,-1,0,0
translate,2,6,-4,-1,-1,0,0
mock,5,2,3,1,-1,0,0
enlist,2,6,-4,-1,-1,0,0
devise,3,5,-2,-1,-1,0,0
lead,2,8,-6,-1,-1,0,0
miss,1,10,-9,-1,-1,0,0
attend,2,2,0,0,-1,0,0
read,3,10,-7,-1,-1,0,0
