Verb,NP_len,PP_len,Len_diff,Len,Arg_status,Pronominality,Order
freuen,1,4,3,1,1,1,1
machen,8,5,3,1,-1,0,1
herrschen,3,4,1,1,1,0,1
tragen,1,3,-2,-1,-1,0,1
wünschen,1,12,11,1,1,0,1
verlassen,2,4,-2,-1,-1,0,1
haben,2,3,-1,-1,-1,0,1
wünschen,3,4,-1,-1,-1,0,1
fühlen,1,7,6,1,1,1,1
drehen,2,3,1,1,1,0,1
zeigen,1,4,3,1,1,1,1
stehen,3,3,0,0,1,0,1
bekommen,3,8,-5,-1,-1,0,1
beauftragen,4,4,0,0,1,0,1
finden,7,4,3,1,-1,0,1
freuen,1,3,2,1,1,1,1
freuen,1,7,6,1,1,1,1
haben,3,3,0,0,-1,0,1
bieten,5,3,-2,-1,1,0,1
bieten,4,3,1,1,-1,0,1
freuen,1,3,2,1,1,1,1
freuen,1,3,2,1,1,1,1
haben,1,3,2,1,1,1,1
haben,2,4,2,1,1,0,1
zahlen,4,8,4,1,1,0,1
operieren,3,3,0,0,1,0,1
fühlen,1,2,1,1,1,1,1
heben,1,11,10,1,1,1,1
lassen,1,6,5,1,1,1,1
geben,2,3,-1,-1,-1,0,1
haben,1,3,2,1,1,1,1
stellen,2,3,-1,-1,-1,0,1
geben,3,3,0,0,-1,0,1
zeigen,2,3,-1,-1,-1,0,1
haben,2,3,1,1,1,0,1
lernen,2,17,15,1,1,0,1
machen,3,4,1,1,1,0,1
zeichnen,2,4,2,1,1,0,1
vermitteln,4,7,3,1,1,0,1
haben,2,6,4,1,1,0,1
haben,6,7,1,1,1,0,1
überzeugen,1,6,5,1,1,1,1
haben,3,2,-1,-1,1,-1,1
kümmern,1,4,3,1,1,1,1
verbringen,2,3,1,1,1,0,1
genießen,4,3,1,1,-1,0,1
zahlen,10,2,8,1,-1,0,1
erwarten,4,3,1,1,-1,0,1
fordern,5,2,3,1,-1,0,1
signalisieren,2,3,-1,-1,-1,0,1
entwickeln,1,6,5,1,1,1,1
erwarten,3,4,1,1,1,0,1
stellen,2,3,1,1,1,0,1
registrieren,1,3,2,1,1,0,1
übernehmen,6,5,1,1,-1,0,1
stellen,5,5,0,0,-1,0,1
verbuchen,2,8,6,1,1,0,1
schaffen,4,3,1,1,-1,0,1
machen,1,3,2,1,1,0,1
erwarten,4,2,2,1,-1,1,1
haben,4,3,-1,-1,1,1,1
präsentieren,19,3,16,1,-1,0,1
verlieren,2,3,1,1,1,0,1
haben,4,3,1,1,-1,0,1
lehnen,3,3,0,0,1,0,1
haben,2,2,0,0,1,1,1
entzünden,1,11,10,1,1,1,1
bemühen,1,4,3,1,1,1,1
haben,3,2,-1,-1,1,-1,1
ändern,1,5,4,1,1,1,1
haben,3,3,0,0,-1,0,1
brauchen,2,2,0,0,1,-1,1
stürmen,3,6,3,1,1,0,1
schreiben,2,5,-3,-1,-1,0,1
graben,13,3,10,1,-1,0,1
stellen,1,15,14,1,1,1,1
feiern,2,8,6,1,1,0,1
konzentrieren,1,11,10,1,1,1,1
machen,2,6,4,1,1,0,1
wollen,3,2,-1,-1,1,-1,1
erwarten,3,4,-1,-1,-1,0,1
kündigen,3,8,5,1,1,0,1
entlassen,2,3,1,1,1,0,1
haben,3,4,-1,-1,-1,0,1
bezeichnen,3,8,5,1,1,0,1
handeln,1,12,11,1,1,1,1
erhoffen,19,3,16,1,-1,0,1
bekommen,2,3,1,1,1,0,1
zerstören,3,4,1,1,1,0,1
begründen,2,4,2,1,1,0,1
säubern,2,2,0,0,1,0,1
haben,3,3,0,0,-1,0,1
nehmen,3,6,-3,-1,-1,0,1
bezwingen,8,6,2,1,-1,0,1
erreichen,6,5,1,1,-1,0,1
bringen,2,4,2,1,1,0,1
studieren,3,2,-1,-1,1,0,1
simulieren,4,3,-1,-1,1,0,1
erreichen,8,6,2,1,-1,0,1
bestehen,2,4,2,1,1,0,1
studieren,1,5,4,1,1,0,1
sehen,4,5,1,1,1,0,1
holen,9,2,-7,-1,1,0,1
gründen,9,8,1,1,-1,0,1
absolvieren,1,16,15,1,1,0,1
qualifizieren,1,20,19,1,1,1,1
bekommen,5,3,2,1,-1,0,1
stellen,1,2,1,1,1,0,1
entfernen,1,4,3,1,1,1,1
geben,1,10,9,1,1,0,1
haben,9,5,4,1,-1,0,1
beteiligen,1,4,3,1,1,1,1
setzen,1,5,4,1,1,1,1
entwässern,2,3,-1,-1,-1,0,1
haben,2,2,0,0,-1,0,1
gewinnen,9,6,3,1,-1,0,1
stellen,1,15,14,1,1,1,1
unterhalten,2,5,-3,-1,-1,0,1
beschäftigen,3,4,-1,-1,-1,0,1
verarbeiten,7,3,4,1,-1,0,1
gewinnen,4,7,3,1,1,0,1
widmen,1,2,1,1,1,0,1
weisen,4,4,0,0,-1,0,1
stellen,2,4,2,1,1,0,1
gewinnen,1,8,-7,-1,-1,0,1
sprechen,1,14,13,1,1,1,1
fesseln,2,8,6,1,1,0,1
suchen,3,3,0,0,-1,0,1
beginnen,2,11,9,1,1,0,1
finden,1,4,3,1,1,1,1
weisen,1,5,4,1,1,1,1
veröffentlichen,4,5,-1,-1,-1,0,1
versammeln,36,8,-28,-1,1,0,1
sammeln,1,4,3,1,1,0,1
führen,2,4,-2,-1,-1,0,1
schreiben,4,4,0,0,1,0,1
studieren,1,13,12,1,1,0,1
ermöglichen,1,15,14,1,1,1,1
schreiben,3,2,1,1,-1,0,1
richten,2,5,-3,-1,-1,0,1
bitten,1,2,1,1,1,0,1
gründen,3,2,-1,-1,1,0,1
braten,1,5,4,1,1,0,1
leihen,2,3,-1,-1,-1,0,1
überliefern,7,9,-2,-1,-1,0,1
lassen,1,6,5,1,1,1,1
handeln,1,25,24,1,1,1,1
spielen,3,3,0,0,-1,0,1
untersuchen,4,4,0,0,-1,0,1
geben,2,2,0,0,1,-1,1
studiert,2,4,2,1,1,0,1
leiten,1,5,4,1,1,1,1
zerstört,2,3,1,1,1,0,1
handeln,1,8,7,1,1,1,1
schmieden,1,2,1,1,1,0,1
erleiden,2,3,-1,-1,-1,0,1
verteidigen,2,3,1,1,1,0,1
beschäftigen,1,3,2,1,1,1,1
zeigen,6,3,3,1,-1,0,1
setzen,2,7,5,1,1,0,1
sehen,4,3,1,1,-1,0,1
leiten,5,2,3,1,-1,0,1
beschäftigen,1,7,6,1,1,1,1
führen,3,2,1,1,-1,0,1
leiten,13,3,10,1,-1,0,1
fügen,3,4,1,1,1,0,1
drängen,2,3,-1,-1,-1,0,1
fordern,12,4,8,1,-1,0,1
haben,9,4,5,1,-1,0,1
handeln,1,15,14,1,1,1,1
veröffentlichen,7,3,4,1,-1,0,1
ernähren,1,7,6,1,1,1,1
zeigen,7,4,3,1,-1,0,1
haben,2,3,1,1,1,0,1
nehmen,2,4,-2,-1,-1,0,1
beziehen,3,3,0,0,1,0,1
absolvieren,2,4,2,1,1,0,1
ermöglichen,5,8,-3,-1,-1,0,1
fordern,8,2,6,1,-1,0,1
besitzen,2,3,-1,-1,-1,0,1
betreffen,19,3,16,1,-1,1,1
beschuldigen,2,8,6,1,1,0,1
peitschen,3,4,-1,-1,-1,0,1
spielen,2,6,-4,-1,-1,0,1
bieten,4,8,4,1,1,0,1
gründen,5,6,1,1,1,0,1
sehen,11,3,8,1,-1,0,1
schließen,2,4,2,1,1,0,1
erreichen,10,3,7,1,-1,0,1
beginnen,2,6,4,1,1,0,1
durchwühlen,3,3,0,0,1,0,1
befördern,4,2,-2,-1,1,0,1
verlegen,5,5,0,0,1,0,1
besuchen,16,3,13,1,-1,0,1
treiben,1,12,11,1,1,1,1
betreiben,3,4,-1,-1,-1,0,1
übernehmen,5,3,2,1,-1,0,1
halten,2,3,1,1,1,0,1
beziehen,1,16,15,1,1,1,1
beteiligen,1,7,6,1,1,1,1
ermitteln,5,6,-1,-1,-1,0,1
halten,2,3,1,1,1,0,1
vertreten,2,4,2,1,1,0,1
absolvieren,2,6,4,1,1,0,1
bringen,5,3,-2,-1,1,0,1
erreichen,2,5,3,1,1,0,1
haben,10,6,4,1,-1,0,1
übertragen,2,4,2,1,1,0,1
geben,2,4,-2,-1,-1,0,1
bilden,4,4,0,0,-1,0,1
spielen,3,5,2,1,1,0,1
stellen,1,5,4,1,1,1,1
erklären,1,5,4,1,1,1,1
genießen,3,2,-1,-1,1,0,1
singen,2,5,3,1,1,0,1
haben,14,7,7,1,-1,0,1
absolvieren,4,2,-2,-1,1,0,1
ersetzen,1,4,3,1,1,1,1
studieren,3,4,1,1,1,0,1
befassen,1,3,2,1,1,1,1
einigen,1,19,18,1,1,1,1
zählen,8,13,5,1,1,0,1
gliedern,1,3,2,1,1,1,1
behandeln,1,2,-1,-1,-1,1,1
betragen,4,3,-1,-1,1,0,1
verkaufen,4,4,0,0,1,0,1
besuchen,6,4,-2,-1,1,0,1
geben,2,6,4,1,1,0,1
konzentrieren,2,3,1,1,1,0,1
erhalten,2,9,7,1,1,0,1
haben,2,24,22,1,1,0,1
erlernen,2,16,14,1,1,0,1
leiten,1,5,4,1,1,1,1
beenden,3,4,-1,-1,-1,0,1
umfassen,18,4,14,1,-1,0,1
führen,7,10,3,1,1,0,1
verlassen,2,3,-1,-1,-1,0,1
gewinnen,2,2,0,0,1,0,1
besiegen,3,3,0,0,1,0,1
machen,5,5,0,0,-1,0,1
säumen,4,3,1,1,-1,0,1
habilitieren,1,5,4,1,1,1,1
bescheinigen,2,7,5,1,1,0,1
orientieren,1,7,6,1,1,1,1
verkörpern,9,4,5,1,-1,0,1
setzen,1,3,2,1,1,1,1
erwerben,2,4,2,1,1,0,1
bauen,1,3,2,1,1,1,1
bilden,2,3,-1,-1,-1,0,1
beenden,3,10,7,1,1,0,1
erfahren,2,6,4,1,1,0,1
haben,21,3,18,1,-1,0,1
suchen,1,3,2,1,1,0,1
betreiben,2,2,0,0,-1,0,1
machen,4,13,9,1,1,0,1
enthalten,2,2,0,0,1,0,1
produzieren,4,9,5,1,1,0,1
weisen,2,4,-2,-1,-1,0,1
absolvieren,2,2,0,0,1,0,1
fahren,2,3,-1,-1,-1,0,1
beschreiben,4,3,1,1,-1,0,1
schließen,1,4,3,1,1,1,1
versorgen,1,2,1,1,1,1,1
übernehmen,3,2,-1,-1,1,0,1
gründen,2,5,-3,-1,-1,0,1
bewirken,13,3,10,1,-1,0,1
haben,2,2,0,0,-1,0,1
machen,3,7,-4,-1,-1,0,1
bezeichnen,13,3,10,1,-1,0,1
befassen,1,9,8,1,1,1,1
bringen,5,2,-3,-1,1,0,1
geben,2,8,6,1,1,0,1
erreichen,6,4,2,1,-1,0,1
hören,13,5,8,1,-1,0,1
erwerben,6,4,2,1,-1,0,1
finden,3,3,0,0,-1,0,1
setzen,8,7,-1,-1,1,0,1
interessieren,1,9,8,1,1,1,1
leiten,1,2,1,1,1,1,1
fördern,3,2,1,1,-1,1,1
lernen,6,5,1,1,-1,0,1
haben,2,2,0,0,-1,0,1
erregen,1,4,3,1,1,0,1
reihen,1,27,26,1,1,1,1
absolvieren,2,2,0,0,1,0,1
erzeugen,6,3,3,1,-1,0,1
beauftragt,8,10,2,1,1,0,1
gründen,19,2,17,1,-1,0,1
spielen,4,2,2,1,-1,1,1
veröffentlichen,10,4,6,1,-1,0,1
beenden,2,6,-4,-1,-1,0,1
bestehen,2,5,3,1,1,0,1
veröffentlicht,14,7,7,1,-1,0,1
beschleunigen,1,3,2,1,1,1,1
geben,3,8,5,1,1,0,1
handeln,1,18,17,1,1,1,1
beschweren,1,14,13,1,1,1,1
verbringen,2,2,0,0,1,0,1
verkaufen,3,15,12,1,1,0,1
stellen,4,9,5,1,1,0,1
haben,4,4,0,0,-1,0,1
beschäftigen,1,11,10,1,1,1,1
verbessern,4,3,-1,-1,1,0,1
verstehen,27,3,24,1,-1,0,1
beteiligen,1,19,18,1,1,1,1
gliedern,1,3,2,1,1,1,1
bekommen,3,7,-4,-1,-1,0,1
erreichen,2,3,1,1,1,0,1
interessieren,1,7,6,1,1,1,1
erreichen,4,6,-2,-1,-1,0,1
enthalten,1,10,9,1,1,0,1
belegen,10,3,7,1,-1,0,1
setzen,1,3,2,1,1,1,1
sehen,9,3,6,1,-1,0,1
erhalten,2,3,-1,-1,-1,0,1
erlangen,4,2,2,1,-1,0,1
stellen,2,3,1,1,1,0,1
geben,2,2,0,0,-1,0,1
weisen,2,3,1,1,1,0,1
haben,3,8,-5,-1,-1,0,1
stellen,5,3,2,1,-1,0,1
verlängern,2,2,0,0,1,0,1
erwerben,4,6,-2,-1,-1,0,1
finanzieren,5,7,-2,-1,-1,0,1
erzielen,8,6,2,1,-1,0,1
geben,1,6,5,1,1,0,1
erhalten,3,7,-4,-1,-1,0,1
verbringen,2,2,0,0,1,0,1
finden,1,5,4,1,1,1,1
regen,4,3,-1,-1,1,0,1
setzen,1,13,12,1,1,1,1
veranlassen,1,4,3,1,1,0,1
zeigen,15,3,12,1,-1,0,1
lassen,4,7,-3,-1,-1,0,1
halten,5,3,-2,-1,1,0,1
passen,1,3,2,1,1,1,1
zählen,2,6,4,1,1,0,1
vertreten,4,4,0,0,1,0,1
benennen,1,10,9,1,1,1,1
erreichen,2,4,-2,-1,-1,0,1
studieren,3,5,-2,-1,-1,0,1
bauen,13,2,11,1,-1,0,1
nehmen,4,2,-2,-1,1,0,1
setzen,1,6,5,1,1,1,1
streiten,1,5,4,1,1,1,1
finden,2,3,1,1,1,0,1
berufen,1,10,9,1,1,1,1
lernen,5,3,2,1,-1,0,1
tragen,10,2,8,1,-1,0,1
spielen,3,6,3,1,1,0,1
besetzen,1,10,9,1,1,1,1
befördern,1,6,5,1,1,0,1
erleben,5,2,-3,-1,1,0,1
geben,11,3,-8,-1,1,0,1
renovieren,2,4,2,1,1,0,1
erreicht,2,2,0,0,1,0,1
beschreiben,4,10,6,1,1,0,1
übernehmen,5,2,3,1,-1,0,1
trainieren,3,4,1,1,1,0,1
schicken,3,3,0,0,1,0,1
handeln,1,20,19,1,1,1,1
bilden,5,5,0,0,-1,0,1
stützen,1,13,12,1,1,1,1
reichern,1,4,3,1,1,1,1
entfernen,2,3,1,1,1,0,1
ziehen,2,2,0,0,1,0,1
überlassen,3,14,11,1,1,0,1
fahren|führen,2,4,-2,-1,-1,0,1
verbinden,1,7,6,1,1,0,1
erleiden,2,11,-9,-1,-1,0,1
absolvieren,2,5,-3,-1,-1,0,1
lackieren,3,3,0,0,1,0,1
belegen,3,5,-2,-1,-1,0,1
üben,4,6,-2,-1,-1,0,1
ermöglichen,6,5,1,1,-1,0,1
erhalten,3,5,-2,-1,-1,0,1
benutzen,10,14,4,1,1,0,1
behalten,2,4,2,1,1,0,1
dirigieren,1,7,6,1,1,0,1
bekommen,2,10,8,1,1,0,1
wenden,1,2,1,1,1,0,1
haben,15,6,-9,-1,1,0,1
verhindern,1,4,3,1,1,1,1
erhalten,4,2,2,1,-1,0,1
haben,2,2,0,0,1,0,1
haben,4,3,1,1,-1,0,1
entscheiden,1,5,4,1,1,1,1
begleiten,1,4,3,1,1,1,1
nehmen,3,2,-1,-1,1,0,1
gründen,7,5,2,1,-1,0,1
beschäftigen,1,7,6,1,1,1,1
rüsten,19,5,14,1,-1,0,1
führen,2,12,10,1,1,0,1
belegen,2,3,-1,-1,-1,0,1
fassen,4,4,0,0,1,0,1
feiern,5,3,2,1,-1,0,1
studieren,1,4,3,1,1,0,1
besuchen,2,6,4,1,1,0,1
lassen,1,3,2,1,1,1,1
besuchen,5,3,-2,-1,1,0,1
erreichen,4,3,1,1,-1,0,1
benutzen,8,2,6,1,-1,0,1
gewinnen,16,4,12,1,-1,0,1
siedeln,1,7,6,1,1,1,1
entlassen,1,4,3,1,1,0,1
spielen,2,8,6,1,1,0,1
sichern,3,3,0,0,1,0,1
erzielen,6,6,0,0,-1,0,1
setzen,2,7,5,1,1,0,1
kosten,4,2,2,1,-1,0,1
befassen,1,13,12,1,1,1,1
studieren,5,4,1,1,-1,0,1
gründen,3,4,1,1,1,0,1
thematisieren,6,4,2,1,-1,1,1
handeln,1,8,7,1,1,1,1
besuchen,2,2,0,0,1,0,1
studieren,1,9,8,1,1,0,1
eröffnen,4,2,2,1,-1,0,1
spielen,1,6,5,1,1,0,1
nehmen,1,3,2,1,1,1,1
inszenieren,9,5,4,1,-1,0,1
beginnen,2,5,3,1,1,0,1
handeln,1,14,13,1,1,1,1
genießen,8,5,3,1,-1,0,1
gründen,13,3,10,1,-1,0,1
verkaufen,5,15,10,1,1,0,1
veröffentlicht,18,4,14,1,-1,0,1
schalten,3,3,0,0,-1,0,1
beschäftigen,1,19,18,1,1,1,1
plazieren,19,6,13,1,-1,0,1
verlieren,2,7,5,1,1,0,1
beziehen,1,10,9,1,1,1,1
studieren,1,51,50,1,1,0,1
nehmen,7,2,-5,-1,1,-1,1
übernehmen,7,4,3,1,-1,0,1
nehmen,1,6,-5,-1,-1,0,1
übersetzen,16,4,-12,-1,1,0,1
diskutieren,7,4,3,1,-1,0,1
bringen,2,5,3,1,1,0,1
bringen,2,2,0,0,1,0,1
beginnen,3,4,1,1,1,0,1
geben,5,4,-1,-1,1,0,1
übernehmen,3,3,0,0,-1,0,1
vermischen,1,4,3,1,1,0,1
schicken,19,21,2,1,1,0,1
erhalten,2,5,-3,-1,-1,0,1
haben,2,4,2,1,1,0,1
beinhalten,4,2,2,1,-1,1,1
machen,2,4,2,1,1,0,1
tragen,2,3,1,1,1,0,1
beschießen,1,5,-4,-1,-1,0,1
besiegen,3,6,3,1,1,0,1
beschäftigen,1,12,11,1,1,1,1
versetzen,1,3,2,1,1,1,1
erreichen,2,4,-2,-1,-1,0,1
legen,2,3,-1,-1,-1,0,1
besitzen,5,4,-1,-1,1,0,1
publizieren,8,7,1,1,-1,0,1
besitzen,6,3,3,1,-1,0,1
lassen,2,3,-1,-1,-1,0,1
sehen,22,14,8,1,-1,0,1
haben,2,2,0,0,-1,0,1
lassen,5,5,0,0,1,0,1
finden,1,3,2,1,1,1,1
beginnen,5,2,3,1,-1,0,1
erhalten,1,6,5,1,1,0,1
schicken,2,10,8,1,1,0,1
bekommen,4,5,-1,-1,-1,0,1
vereint,4,3,-1,-1,1,0,1
geben,4,2,-2,-1,1,0,1
schaffen,4,5,1,1,1,0,1
stellen,4,3,-1,-1,1,0,1
studieren,15,3,12,1,-1,0,1
verfärben,1,3,2,1,1,1,1
handeln,1,3,2,1,1,1,1
pflegen,2,4,-2,-1,-1,0,1
verlegen,2,4,2,1,1,0,1
beginnen,2,5,3,1,1,0,1
zwingen,2,24,22,1,1,0,1
nehmen,4,2,-2,-1,1,0,1
handeln,1,13,12,1,1,1,1
verlassen,2,4,2,1,1,0,1
kündigen,1,3,-2,-1,-1,-1,1
haben,5,7,2,1,1,0,1
ändern,2,3,-1,-1,-1,-1,1
inszenieren,2,2,0,0,1,0,1
haben,3,3,0,0,-1,0,1
heiraten,21,2,19,1,-1,0,1
steigern,4,4,0,0,1,0,1
prägen,3,7,-4,-1,-1,0,1
bezeichnen,22,8,14,1,-1,0,1
haben,3,7,4,1,1,0,1
zeigen,2,3,-1,-1,-1,0,1
trennen,3,3,0,0,1,0,1
haben,19,3,16,1,-1,0,1
bringen,1,13,12,1,1,1,1
haben,7,7,0,0,-1,0,1
legen,2,4,2,1,1,0,1
haben,2,5,3,1,1,0,1
färben,1,3,2,1,1,1,1
beteiligen,1,5,4,1,1,1,1
erhalten,5,7,2,1,1,0,1
finden,2,3,1,1,1,0,1
erzielen,2,3,1,1,1,0,1
erzielen,4,7,3,1,1,0,1
zeichnen,1,12,11,1,1,1,1
benutzen,6,7,-1,-1,-1,0,1
geben,1,2,1,1,1,1,1
melden,1,2,1,1,1,0,1
stürzen,1,9,8,1,1,1,1
nehmen,6,4,2,1,-1,0,1
veranlassen,10,3,7,1,-1,0,1
verfolgen,2,6,4,1,1,0,1
studieren,1,7,6,1,1,0,1
spielen,4,2,2,1,-1,0,1
nennen,1,3,2,1,1,1,1
beziehen,1,12,11,1,1,1,1
sprechen,17,3,-14,-1,1,0,1
gründen,5,4,1,1,-1,0,1
haben,2,3,1,1,1,0,1
fragen,1,2,1,1,1,0,1
finden,1,15,14,1,1,1,1
überzeugt,1,21,20,1,1,0,1
legen,1,3,2,1,1,1,1
gründen,9,6,3,1,-1,0,1
beauftragen,2,7,5,1,1,0,1
haben,7,3,4,1,-1,0,1
finden,1,9,8,1,1,1,1
entwickeln,4,9,5,1,1,0,1
erreichen,3,3,0,0,-1,0,1
sehen,17,3,14,1,-1,0,1
beanspruchen,15,3,-12,-1,1,-1,1
bilden,3,7,-4,-1,-1,0,1
entscheiden,1,4,3,1,1,1,1
entscheiden,1,10,9,1,1,1,1
vergleichen,1,14,13,1,1,1,1
richten,2,2,0,0,-1,0,1
erleben,3,8,5,1,1,0,1
bereiten,8,5,3,1,-1,0,1
erweitern,2,5,3,1,1,0,1
verlassen,2,5,-3,-1,-1,0,1
spiegeln,1,4,3,1,1,1,1
haben,2,3,1,1,1,0,1
Empfangen,1,5,4,1,1,0,1
vertreten,4,3,-1,-1,1,0,1
setzen,1,9,8,1,1,1,1
benennen,1,17,16,1,1,1,1
kuratierte,1,51,50,1,1,0,1
verwenden,3,3,0,0,-1,0,1
werfen,3,3,0,0,1,0,1
bieten,9,4,5,1,-1,0,1
lösen,1,4,3,1,1,1,1
leiten,1,8,7,1,1,1,1
finden,1,5,4,1,1,1,1
finden,2,7,-5,-1,-1,0,1
gesellen,1,3,2,1,1,1,1
sehen,15,2,13,1,-1,0,1
produzieren,2,4,2,1,1,0,1
begeistern,1,3,2,1,1,1,1
liefern,2,12,10,1,1,0,1
wenden,1,3,2,1,1,1,1
handeln,1,6,5,1,1,0,1
lassen,1,6,5,1,1,0,1
erreichen,1,6,-5,-1,-1,0,1
haben,2,2,0,0,-1,1,1
beschäftigen,1,3,2,1,1,1,1
überschreiben,4,15,11,1,1,0,1
versagen,2,12,10,1,1,0,1
spielen,1,8,7,1,1,0,1
studieren,1,9,8,1,1,0,1
beschaffen,30,2,28,1,-1,0,1
entscheiden,1,7,6,1,1,1,1
dokumentieren,2,5,3,1,1,0,1
veröffentlichen,2,24,22,1,1,0,1
vereinigen,1,15,14,1,1,1,1
ersetzen,3,3,0,0,1,0,1
erspielen,6,2,4,1,-1,0,1
setzen,1,11,10,1,1,1,1
bezeichnen,1,18,17,1,1,1,1
haben,2,7,-5,-1,-1,0,1
kümmern,1,9,8,1,1,1,1
bereisen,4,3,1,1,-1,0,1
verstärken,16,17,-1,-1,-1,0,1
erlangen,2,2,0,0,-1,0,1
führen,10,2,-8,-1,1,-1,1
halten,2,8,6,1,1,0,1
werfen,3,7,-4,-1,-1,0,1
unterschreiben,3,4,1,1,1,0,1
besuchen,5,2,3,1,-1,0,1
betrachten,1,3,2,1,1,0,1
erklären,1,10,9,1,1,1,1
vertreten,5,6,-1,-1,-1,0,1
spielen,2,6,4,1,1,0,1
vertreten,4,6,2,1,1,0,1
beschäftigen,1,5,4,1,1,1,1
besitzen,4,10,-6,-1,-1,0,1
rekrutieren,9,4,5,1,-1,0,1
machen,2,2,0,0,-1,0,1
bauen,8,2,6,1,-1,0,1
nehmen,3,3,0,0,-1,0,1
erreichen,1,4,3,1,1,0,1
besuchen,3,2,-1,-1,1,0,1
durchlaufen,3,2,-1,-1,1,0,1
übernehmen,6,10,-4,-1,-1,0,1
beenden,2,3,1,1,1,0,1
erhalten,3,11,8,1,1,0,1
besuchen,2,5,3,1,1,0,1
erhalten,4,5,-1,-1,-1,0,1
fotografieren,2,4,2,1,1,0,1
haben,3,4,-1,-1,-1,0,1
entziehen,2,7,5,1,1,0,1
beenden,2,6,4,1,1,0,1
leisten,4,2,2,1,-1,0,1
suchen,1,8,7,1,1,0,1
kümmern,1,5,4,1,1,1,1
erfordern,2,3,1,1,1,0,1
sehen,4,13,9,1,1,0,1
bekommen,2,2,0,0,1,0,1
lassen,9,2,7,1,-1,0,1
haben,3,3,0,0,1,0,1
setzen,1,27,26,1,1,1,1
erfordern,2,3,1,1,1,0,1
verursachen,2,3,1,1,1,0,1
gründen,4,9,-5,-1,-1,0,1
heiraten,5,4,1,1,-1,0,1
schließen,10,3,-7,-1,1,0,1
besuchen,3,2,1,1,-1,0,1
beginnen,2,11,9,1,1,0,1
setzen,1,10,9,1,1,1,1
leiten,3,2,-1,-1,1,0,1
erhalten,2,4,-2,-1,-1,0,1
schreiben,2,5,3,1,1,0,1
handeln,1,17,16,1,1,1,1
ziehen,1,3,2,1,1,1,1
veröffentlichen,2,4,2,1,1,0,1
besitzen,3,6,-3,-1,-1,0,1
führen,1,4,3,1,1,1,1
érreichte,4,5,-1,-1,-1,0,1
üben,20,3,17,1,-1,0,1
machen,3,4,1,1,1,0,1
gründen,1,4,3,1,1,1,1
engagieren,1,7,6,1,1,1,1
begründen,7,4,3,1,-1,0,1
leiten,1,7,6,1,1,1,1
beginnen,2,16,14,1,1,0,1
haben,2,3,1,1,1,0,1
beeinflussen,2,6,4,1,1,0,1
erweitern,2,7,5,1,1,0,1
produzieren,7,3,4,1,-1,0,1
haben,3,10,7,1,1,0,1
übertragen,3,2,-1,-1,1,0,1
führen,1,6,5,1,1,1,1
fördern,5,5,0,0,1,0,1
singen,32,2,30,1,-1,0,1
beenden,2,21,19,1,1,0,1
unterstützen,5,3,-2,-1,1,0,1
unterscheiden,4,3,-1,-1,1,0,1
besitzen,8,4,4,1,-1,0,1
führen,1,8,7,1,1,1,1
beteiligen,1,15,14,1,1,1,1
verloben,1,2,1,1,1,1,1
verzeichnen,5,6,-1,-1,-1,0,1
verlieren,3,2,1,1,-1,0,1
erreichen,2,4,-2,-1,-1,0,1
ersetzen,3,3,0,0,1,0,1
leiten,6,4,-2,-1,1,0,1
gewinnen,3,7,4,1,1,0,1
verbringen,2,5,3,1,1,0,1
kümmern,1,2,1,1,1,0,1
versorgen,1,2,1,1,1,1,1
paaren,1,2,1,1,1,0,1
zeigen,3,3,0,0,-1,0,1
studieren,1,4,3,1,1,0,1
entfahren|entführen,2,3,1,1,1,0,1
dokumentieren,5,4,-1,-1,1,0,1
unterhalten,4,2,-2,-1,1,0,1
absolvieren,2,4,2,1,1,0,1
wenden,2,5,-3,-1,-1,0,1
bekommen,2,5,-3,-1,-1,0,1
erweitern,4,12,8,1,1,0,1
besuchen,3,2,-1,-1,1,0,1
gewinnen,18,3,15,1,-1,0,1
leiten,2,4,2,1,1,0,1
entführen,2,4,2,1,1,0,1
bringen,7,3,-4,-1,1,0,1
schicken,1,15,14,1,1,1,1
erhalten,2,3,1,1,1,0,1
betätigen,1,9,8,1,1,1,1
beziehen,8,2,6,1,-1,0,1
richten,2,2,0,0,1,-1,1
setzen,1,12,11,1,1,1,1
bilden,2,7,-5,-1,-1,0,1
belaufen,1,4,3,1,1,1,1
besuchen,5,3,2,1,-1,0,1
berufen,6,3,-3,-1,1,0,1
stellen,5,15,-10,-1,-1,0,1
gehen,3,3,0,0,-1,0,1
beliefern,4,6,2,1,1,0,1
kennen,5,2,-3,-1,1,0,1
tragen,3,3,0,0,1,0,1
teilen,3,2,-1,-1,1,0,1
kaufen,2,2,0,0,1,0,1
setzen,1,6,5,1,1,0,1
trennen,8,7,-1,-1,1,0,1
adoptieren,3,3,0,0,1,0,1
bilden,1,3,-2,-1,-1,0,1
erfahren,3,3,0,0,-1,0,1
beweisen,3,2,1,1,-1,0,1
empfinden,2,3,1,1,1,0,1
geben,5,4,1,1,-1,0,1
erschießen,1,3,2,1,1,0,1
setzen,2,4,2,1,1,0,1
entdecken,6,3,3,1,-1,0,1
studieren,1,2,1,1,1,0,1
umschließen,2,3,1,1,1,0,1
spielen,2,3,1,1,1,0,1
ziehen,1,9,8,1,1,1,1
befreien,1,5,4,1,1,0,1
lehnen,1,5,4,1,1,1,1
erlangen,13,2,11,1,-1,1,1
besitzen,3,3,0,0,1,0,1
ziehen,5,4,1,1,-1,0,1
absolvieren,2,2,0,0,1,0,1
verlieren,3,5,2,1,1,0,1
ersetzen,15,6,-9,-1,1,0,1
schlagen,1,3,2,1,1,1,1
gründen,4,7,-3,-1,-1,0,1
absolvieren,5,4,-1,-1,1,0,1
handeln,1,6,5,1,1,1,1
fordern,7,7,0,0,-1,0,1
führen,1,4,3,1,1,1,1
beschränken,1,2,1,1,1,1,1
machen,1,10,-9,-1,-1,0,1
schlagen,3,2,-1,-1,1,0,1
erzielen,2,3,-1,-1,-1,-1,1
entdecken,5,6,-1,-1,-1,0,1
gliedern,1,7,6,1,1,1,1
begrüßen,2,5,3,1,1,0,1
erhalten,3,5,-2,-1,-1,0,1
ergeben,1,17,16,1,1,1,1
lehnen,2,6,4,1,1,0,1
haben,2,3,1,1,1,0,1
richten,2,3,1,1,1,0,1
wenden,2,16,14,1,1,0,1
haben,2,5,3,1,1,0,1
setzen,1,8,7,1,1,1,1
erhalten,2,3,-1,-1,-1,0,1
fügen,3,6,3,1,1,0,1
ordnen,1,3,2,1,1,1,1
besiegen,3,12,-9,-1,-1,0,1
verfehlen,5,29,-24,-1,-1,0,1
erstellen,9,2,7,1,-1,0,1
beginnen,3,10,7,1,1,0,1
handeln,1,7,6,1,1,1,1
beziehen,1,8,7,1,1,1,1
vermitteln,5,4,-1,-1,1,0,1
erlangen,1,4,-3,-1,-1,0,1
verlegen,2,5,3,1,1,0,1
verdeutlichen,5,5,0,0,1,0,1
schaffen,5,8,-3,-1,-1,0,1
bringen,4,5,1,1,1,0,1
entwickeln,1,7,6,1,1,0,1
umfassen,3,5,2,1,1,0,1
erhalten,2,4,-2,-1,-1,0,1
beziehen,1,7,6,1,1,1,1
sichern,1,6,5,1,1,1,1
absolviert,6,3,-3,-1,1,0,1
erhalten,5,5,0,0,-1,0,1
vertreten,3,4,1,1,1,0,1
verfassen,4,6,2,1,1,0,1
verändern,2,3,1,1,1,0,1
bemühen,1,7,6,1,1,1,1
spielen,4,2,2,1,-1,0,1
schlagen,4,4,0,0,-1,0,1
versetzen,2,26,24,1,1,0,1
geben,2,6,4,1,1,0,1
beschäftigen,1,4,3,1,1,1,1
pressen,1,3,2,1,1,0,1
sprengen,2,2,0,0,-1,0,1
verlieren,8,5,3,1,-1,0,1
betragen,2,6,4,1,1,0,1
bezeichnen,23,3,20,1,-1,0,1
widmen,1,3,2,1,1,1,1
setzen,1,13,12,1,1,1,1
finden,1,5,4,1,1,0,1
erzielen,5,17,12,1,1,0,1
bilden,1,5,4,1,1,1,1
erreichen,1,3,-2,-1,-1,0,1
zeichnen,1,7,6,1,1,1,1
nehmen,1,3,-2,-1,-1,0,1
verdingen,1,2,1,1,1,1,1
erweitert,2,9,7,1,1,0,1
veröffentlichen,3,2,1,1,-1,0,1
lehren,1,5,4,1,1,0,1
mieten,2,2,0,0,1,0,1
zeigen,1,6,5,1,1,1,1
veröffentlichen,27,3,24,1,-1,0,1
kombinieren,5,14,9,1,1,0,1
überblenden,7,15,8,1,1,0,1
studieren,1,4,-3,-1,-1,0,1
schließen,2,3,1,1,1,0,1
leiten,4,2,2,1,-1,0,1
setzen,1,6,5,1,1,1,1
reißen,3,3,0,0,1,0,1
legen,2,3,-1,-1,-1,0,1
überspringen,2,3,-1,-1,-1,0,1
verlassen,2,5,-3,-1,-1,0,1
übernehmen,2,6,-4,-1,-1,0,1
umfassen,5,4,1,1,-1,0,1
legen,1,10,9,1,1,0,1
verstehen,7,4,3,1,-1,0,1
ergeben,2,3,-1,-1,-1,0,1
engagieren,1,14,13,1,1,1,1
verbringen,2,3,1,1,1,0,1
beteiligen,1,12,11,1,1,1,1
stellen,2,2,0,0,1,0,1
ergeben,1,3,2,1,1,1,1
qualifizieren,1,3,2,1,1,1,1
besuchen,4,7,3,1,1,0,1
wenden,1,10,9,1,1,1,1
retten,1,15,14,1,1,1,1
nehmen,6,3,-3,-1,1,0,1
erhalten,12,3,9,1,-1,0,1
wenden,1,3,2,1,1,1,1
enthalten,9,2,7,1,-1,0,1
binden,3,3,0,0,-1,0,1
haben,2,24,22,1,1,0,1
beginnen,2,5,3,1,1,0,1
siedeln,1,2,1,1,1,0,1
führen,2,6,4,1,1,0,1
erreichen,6,7,-1,-1,-1,0,1
halten,6,3,3,1,-1,0,1
entdecken,7,3,4,1,-1,0,1
laden,4,4,0,0,1,0,1
legen,2,3,-1,-1,-1,0,1
leiten,5,5,0,0,-1,0,1
geben,2,3,-1,-1,-1,0,1
beziehen,2,2,0,0,1,0,1
unterstützen,3,3,0,0,1,0,1
führen,3,2,1,1,-1,0,1
distanzieren,1,3,2,1,1,1,1
erhalten,3,13,10,1,1,0,1
betätigen,1,9,8,1,1,1,1
gewinnen,1,2,1,1,1,0,1
erreicht,2,2,0,0,1,0,1
bezeichnen,26,2,24,1,-1,1,1
sein,21,3,18,1,-1,0,1
realisieren,11,2,9,1,-1,0,1
weisen,5,3,2,1,-1,0,1
legen,3,4,-1,-1,-1,0,1
beschäftigen,1,12,11,1,1,1,1
haben,2,6,4,1,1,0,1
schwören,3,8,5,1,1,0,1
vermischen,2,3,1,1,1,0,1
vertreten,4,4,0,0,1,0,1
spielen,8,20,12,1,1,0,1
sehen,1,19,18,1,1,1,1
engagieren,1,21,20,1,1,1,1
nehmen,1,21,-20,-1,-1,0,1
bilden,3,5,-2,-1,-1,0,1
sehen,3,2,1,1,-1,1,1
steigern,1,3,2,1,1,1,1
stellen,3,17,-14,-1,-1,0,1
besuchen,2,2,0,0,-1,0,1
übernehmen,5,2,-3,-1,1,0,1
gründen,9,2,7,1,-1,1,1
heiraten,1,2,1,1,1,0,1
prägen,18,3,15,1,-1,0,1
legen,2,7,5,1,1,0,1
erreichen,6,4,2,1,-1,0,1
besitzen,15,2,13,1,-1,0,1
beziehen,7,4,-3,-1,1,0,1
verschrotten,1,2,1,1,1,1,1
weisen,10,8,2,1,-1,0,1
sehen,12,9,3,1,-1,0,1
erreichen,3,3,0,0,-1,0,1
veröffentlichen,2,3,-1,-1,-1,0,1
gestalten,5,3,2,1,-1,0,1
stellen,2,4,-2,-1,-1,0,1
bauen,1,3,2,1,1,1,1
halten,1,7,6,1,1,0,1
berufen,5,22,17,1,1,0,1
beschäftigen,3,4,-1,-1,-1,0,1
entwerfen,15,2,13,1,-1,1,1
positionieren,1,5,4,1,1,1,1
beginnen,7,7,0,0,-1,0,1
verbinden,5,9,4,1,1,0,1
haben,17,3,-14,-1,1,0,1
sehen,2,3,-1,-1,-1,0,1
unterstützen,4,4,0,0,-1,0,1
setzen,1,9,8,1,1,1,1
kombinieren,3,3,0,0,1,0,1
haben,1,16,15,1,1,0,1
spielen,6,11,5,1,1,0,1
werfen,2,3,1,1,1,0,1
speisen,2,5,3,1,1,0,1
sprechen,1,8,7,1,1,1,1
erlauben,2,5,3,1,1,0,1
töten,24,7,17,1,-1,0,1
verbringen,2,3,1,1,1,0,1
haben,2,2,0,0,1,0,1
besitzen,4,3,1,1,-1,0,1
loben,2,8,6,1,1,-1,1
verteilen,1,8,7,1,1,1,1
veröffentlicht,3,4,1,1,1,0,1
nehmen,2,3,1,1,1,0,1
nutzen,1,7,6,1,1,1,1
setzen,2,2,0,0,-1,0,1
handeln,1,5,4,1,1,1,1
verbessern,9,3,-6,-1,1,0,1
liefern,2,3,1,1,1,0,1
betragen,2,10,8,1,1,0,1
integrieren,6,5,-1,-1,1,0,1
haben,2,5,3,1,1,0,1
gründen,3,4,1,1,1,0,1
vertreten,2,13,11,1,1,0,1
richten,2,4,2,1,1,0,1
drucken,5,14,9,1,1,0,1
verteilen,1,6,5,1,1,1,1
feiern,2,4,-2,-1,-1,0,1
finden,1,11,10,1,1,1,1
lagern,1,2,1,1,1,0,1
bringen,4,3,-1,-1,1,0,1
besetzen,2,3,1,1,1,0,1
organisieren,12,4,8,1,-1,0,1
erstrecken,1,4,3,1,1,1,1
führen,6,2,4,1,-1,0,1
tragen,3,2,1,1,-1,0,1
veröffentlichen,21,5,16,1,-1,0,1
setzen,1,6,5,1,1,1,1
stellen,8,3,-5,-1,1,0,1
absolvieren,6,6,0,0,-1,0,1
haben,6,4,-2,-1,1,0,1
führen,2,4,2,1,1,0,1
erwerben,2,5,3,1,1,0,1
schlagen,5,5,0,0,1,0,1
zeigen,9,3,6,1,-1,0,1
bedauern,11,2,9,1,-1,1,1
sichern,4,5,1,1,1,0,1
halten,2,3,1,1,1,0,1
bieten,7,4,3,1,-1,0,1
zeichnen,1,9,8,1,1,1,1
leihen,2,7,5,1,1,0,1
legen,1,7,6,1,1,0,1
lassen,1,2,1,1,1,1,1
drehen,2,3,1,1,1,0,1
gewinnen,4,3,1,1,-1,0,1
haben,7,3,4,1,-1,0,1
vergleichen,2,4,2,1,1,-1,1
haben,9,10,-1,-1,-1,0,1
benutzen,1,3,2,1,1,1,1
erreichen,2,3,-1,-1,-1,0,1
vergeben,2,4,-2,-1,-1,0,1
verwenden,2,9,7,1,1,0,1
ändern,1,6,5,1,1,1,1
regeln,2,5,-3,-1,-1,0,1
bringen,9,3,-6,-1,1,0,1
vertreten,1,3,2,1,1,0,1
bieten,1,2,1,1,1,1,1
belegen,2,5,-3,-1,-1,0,1
fordern,2,6,4,1,1,0,1
sehen,5,10,5,1,1,0,1
spielen,1,6,5,1,1,0,1
orientieren,1,3,2,1,1,1,1
qualifizieren,1,3,2,1,1,1,1
spielen,3,4,1,1,1,0,1
veröffentlichen,17,3,14,1,-1,0,1
zeigen,5,5,0,0,-1,0,1
bringen,1,5,4,1,1,1,1
erreichen,3,7,4,1,1,0,1
leiten,1,11,10,1,1,1,1
holen,2,3,-1,-1,-1,0,1
tragen,26,4,22,1,-1,0,1
verkaufen,18,4,-14,-1,1,0,1
spielen,5,3,2,1,-1,0,1
erhalten,2,3,-1,-1,-1,0,1
verurteilen,2,3,1,1,1,1,1
gewinnen,42,3,39,1,-1,0,1
bekommen,1,3,2,1,1,0,1
spielen,3,4,-1,-1,-1,0,1
ergänzen,7,10,3,1,1,0,1
formieren,6,3,3,1,-1,0,1
drängen,1,3,2,1,1,1,1
beenden,2,2,0,0,1,0,1
streben,2,3,-1,-1,-1,0,1
bekommen,5,6,-1,-1,-1,0,1
übernehmen,7,4,3,1,-1,0,1
setzen,1,3,2,1,1,1,1
studieren,2,4,2,1,1,0,1
studieren,1,4,3,1,1,0,1
legen,13,3,10,1,-1,0,1
beteiligen,1,20,19,1,1,1,1
studieren,1,9,8,1,1,0,1
nutzen,2,4,2,1,1,0,1
unterqueren,6,3,3,1,-1,0,1
erweitern,5,3,-2,-1,1,0,1
pflegen,4,5,-1,-1,-1,0,1
lernen,2,6,-4,-1,-1,0,1
gewinnen,5,6,-1,-1,-1,0,1
gewinnen,7,5,2,1,-1,0,1
starten,3,9,-6,-1,-1,0,1
vertreten,2,12,10,1,1,0,1
verteidigen,3,9,6,1,1,0,1
machen,3,3,0,0,-1,0,1
stocken,5,3,-2,-1,1,0,1
betonen,11,7,4,1,-1,0,1
lassen,8,3,5,1,-1,0,1
übertragen,6,3,-3,-1,1,0,1
finden,1,6,-5,-1,-1,0,1
betragen,3,4,-1,-1,-1,0,1
wiegen,3,3,0,0,-1,0,1
verraten,1,3,2,1,1,0,1
stellen,4,5,-1,-1,-1,0,1
erringen,2,11,9,1,1,0,1
erschaffen,3,4,1,1,1,0,1
nutzen,2,5,3,1,1,0,1
beauftragt,24,6,-18,-1,1,0,1
veröffentlichen,22,4,18,1,-1,0,1
setzen,1,16,15,1,1,1,1
zeigen,1,16,15,1,1,1,1
haben,2,3,-1,-1,-1,0,1
finden,1,2,-1,-1,-1,1,1
kündigen,4,5,1,1,1,0,1
verlieren,3,3,0,0,-1,0,1
treffen,2,5,3,1,1,0,1
beantragen,3,3,0,0,-1,0,1
bekommen,5,2,3,1,-1,0,1
sperren,4,2,2,1,-1,0,1
bestehen,22,4,18,1,-1,0,1
handeln,1,17,16,1,1,1,1
bringen,2,4,2,1,1,0,1
veröffentlichen,6,2,4,1,-1,0,1
erfordern,1,4,3,1,1,0,1
nehmen,4,5,-1,-1,-1,0,1
stoßen,2,9,-7,-1,-1,0,1
streichen,4,4,0,0,-1,0,1
kaufen,7,4,3,1,-1,0,1
summieren,1,4,3,1,1,1,1
übernehmen,4,4,0,0,1,0,1
bestätigen,4,3,1,1,-1,0,1
umfassen,3,4,-1,-1,-1,0,1
bieten,15,2,13,1,-1,0,1
bieten,3,3,0,0,-1,0,1
nehmen,10,2,8,1,-1,0,1
handeln,1,17,16,1,1,1,1
stoßen,4,4,0,0,-1,0,1
vertreten,19,3,16,1,-1,0,1
stoßen,2,3,-1,-1,-1,0,1
sehen,3,3,0,0,1,0,1
hoffen,9,7,2,1,-1,0,1
melden,8,10,-2,-1,-1,0,1
begründen,2,2,0,0,1,-1,1
bezeichnen,2,3,1,1,1,0,1
wandeln,1,2,1,1,1,0,1
belaufen,1,5,4,1,1,1,1
sorgen,2,5,-3,-1,-1,0,1
ziehen,6,2,-4,-1,1,0,1
dementieren,2,3,1,1,1,0,1
planen,16,7,9,1,-1,0,1
vereinen,6,4,-2,-1,1,-1,1
begrüßen,2,8,6,1,1,0,1
finden,9,12,3,1,1,0,1
erfassen,3,4,-1,-1,-1,0,1
deaktivieren,2,4,-2,-1,-1,0,1
geben,2,3,-1,-1,-1,0,1
bieten,11,3,8,1,-1,0,1
bieten,15,7,8,1,-1,0,1
handeln,1,4,3,1,1,1,1
benötigen,1,3,2,1,1,0,1
erfreuen,2,2,0,0,-1,0,1
holen,3,2,-1,-1,1,0,1
führen,8,2,6,1,-1,0,1
nennen,13,2,11,1,-1,0,1
bieten,22,2,20,1,-1,0,1
bekommen,3,3,0,0,-1,0,1
verteidigen,3,3,0,0,-1,0,1
stehen,2,2,0,0,1,0,1
bestätigen,2,3,1,1,1,0,1
bestätigen,1,2,1,1,1,1,1
begründen,2,3,-1,-1,-1,0,1
werfen,2,5,3,1,1,0,1
stoßen,3,11,-8,-1,-1,0,1
trennen,3,2,-1,-1,1,0,1
rechnen,6,4,2,1,-1,0,1
geben,2,12,10,1,1,0,1
bieten,7,4,-3,-1,1,0,1
zeigen,1,4,3,1,1,1,1
lassen,1,3,2,1,1,1,1
koppeln,8,7,-1,-1,1,0,1
widersprechen,1,4,3,1,1,0,1
betrachten,16,3,-13,-1,1,0,1
weisen,3,3,0,0,-1,0,1
mischen,1,2,1,1,1,1,1
drängen,1,13,-12,-1,-1,0,1
handeln,1,6,5,1,1,1,1
begründen,2,3,1,1,1,0,1
kosten,3,4,-1,-1,-1,0,1
erhöhen,2,4,-2,-1,-1,0,1
erzielen,3,2,1,1,-1,0,1
zeigen,1,3,2,1,1,1,1
zeigen,1,3,2,1,1,1,1
offerieren,4,3,-1,-1,1,0,1
geben,1,2,1,1,1,0,1
geben,12,3,-9,-1,1,0,1
handeln,1,8,7,1,1,1,1
enthalten,10,7,3,1,-1,0,1
betragen,4,3,1,1,-1,0,1
kosten,2,3,-1,-1,-1,0,1
schlagen,2,4,-2,-1,-1,0,1
verschicken,10,10,0,0,-1,0,1
halten,2,3,1,1,1,0,1
ermöglichen,2,9,7,1,1,0,1
sorgen,2,10,-8,-1,-1,0,1
geben,2,25,-23,-1,-1,0,1
ergänzen,2,3,1,1,1,0,1
kritisieren,8,3,5,1,-1,0,1
bestätigen,1,2,1,1,1,1,1
bündeln,1,3,2,1,1,0,1
erzielen,7,8,-1,-1,-1,0,1
führen,14,7,7,1,-1,0,1
halten,11,7,4,1,-1,0,1
handeln,1,11,10,1,1,1,1
treiben,4,2,-2,-1,1,0,1
stützen,2,13,11,1,1,0,1
begründen,2,3,1,1,1,0,1
legen,3,3,0,0,-1,0,1
bestätigen,16,3,13,1,-1,0,1
beziehen,1,10,9,1,1,0,1
äußern,1,4,3,1,1,1,1
handeln,1,19,18,1,1,1,1
handeln,1,22,21,1,1,1,1
greifen,3,6,3,1,1,0,1
bieten,6,4,2,1,-1,0,1
bestätigen,2,2,0,0,-1,0,1
stellen,2,3,1,1,1,0,1
ändern,4,5,1,1,1,0,1
bilden,4,3,1,1,-1,0,1
bieten,7,2,5,1,-1,0,1
handeln,1,20,19,1,1,1,1
nennen,2,2,0,0,-1,0,1
erzielen,5,2,3,1,-1,0,1
bieten,4,8,4,1,1,0,1
besitzen,2,3,-1,-1,-1,0,1
betragen,4,2,2,1,-1,0,1
geben,17,2,15,1,-1,0,1
erwarten,6,3,3,1,-1,0,1
führen,4,3,1,1,-1,0,1
verlangen,2,5,-3,-1,-1,0,1
öffnen,2,3,1,1,1,0,1
hinterlegen,2,3,1,1,1,0,1
schätzen,5,4,-1,-1,1,0,1
nehmen,5,2,-3,-1,1,0,1
erhalten,11,3,8,1,-1,0,1
verzichten,3,2,1,1,-1,0,1
besitzen,2,3,-1,-1,-1,0,1
handeln,1,8,7,1,1,0,1
halten,2,5,3,1,1,0,1
weisen,2,3,1,1,1,0,1
häufen,1,3,2,1,1,1,1
dienen,4,4,0,0,-1,0,1
stellen,5,2,-3,-1,1,0,1
stellen,1,2,1,1,1,0,1
weisen,2,2,0,0,1,0,1
planen,2,2,0,0,-1,0,1
rechnen,2,3,1,1,1,0,1
beherrschen,5,6,1,1,1,0,1
sehen,7,2,5,1,-1,0,1
stellen,2,4,-2,-1,-1,0,1
setzen,15,3,12,1,-1,0,1
betragen,3,11,8,1,1,0,1
äußern,1,20,19,1,1,0,1
formulieren,28,6,22,1,-1,0,1
gehören,1,3,-2,-1,-1,0,1
streiten,1,6,5,1,1,1,1
bedauern,3,3,0,0,-1,0,1
verzögern,2,4,-2,-1,-1,0,1
verlangen,1,3,2,1,1,0,1
handeln,1,22,21,1,1,1,1
widersprechen,2,3,-1,-1,-1,0,1
begründen,1,3,2,1,1,1,1
begründen,2,3,-1,-1,-1,0,1
kommentieren,9,3,-6,-1,1,0,1
begründen,1,21,20,1,1,1,1
führen,2,8,6,1,1,0,1
verweisen,5,2,3,1,-1,0,1
nutzen,9,2,7,1,-1,0,1
stoßen,3,3,0,0,-1,0,1
geben,8,2,6,1,-1,0,1
stecken,1,2,1,1,1,0,1
machen,5,3,2,1,-1,0,1
machen,1,4,-3,-1,-1,0,1
handeln,1,9,8,1,1,1,1
kündigen,5,3,-2,-1,1,0,1
streben,2,2,0,0,-1,0,1
machen,2,2,0,0,-1,0,1
zwingen,2,2,0,0,1,0,1
kaufen,3,3,0,0,1,0,1
produzieren,1,2,-1,-1,-1,1,1
begründen,2,2,0,0,1,0,1
verändern,1,2,1,1,1,1,1
handeln,1,22,21,1,1,1,1
schieben,1,6,5,1,1,1,1
häufen,1,3,2,1,1,1,1
verteidigen,1,11,10,1,1,1,1
erhalten,9,2,7,1,-1,0,1
schweigen,1,6,5,1,1,1,1
stoppen,1,2,-1,-1,-1,0,1
erhalten,13,5,8,1,-1,0,1
zeigen,8,2,6,1,-1,0,1
führen,2,6,4,1,1,0,1
erzielen,5,2,3,1,-1,0,1
gewinnen,2,8,6,1,1,0,1
bringen,1,2,1,1,1,0,1
präsentieren,18,6,12,1,-1,0,1
erreichen,4,4,0,0,1,0,1
umwerben,3,3,0,0,1,0,1
belohnen,1,4,3,1,1,0,1
berücksichtigen,5,14,-9,-1,-1,0,1
spielen,2,3,-1,-1,-1,0,1
gehören,2,4,-2,-1,-1,0,1
übernehmen,9,4,5,1,-1,0,1
entwickeln,8,5,3,1,-1,0,1
bieten,18,4,14,1,-1,0,1
äußern,1,4,3,1,1,1,1
reagieren,2,2,0,0,-1,0,1
lesen,1,13,12,1,1,0,1
laden,2,9,7,1,1,0,1
zeigen,3,3,0,0,1,0,1
nutzen,5,3,2,1,-1,0,1
betreffen,6,4,2,1,-1,0,1
veröffentlichen,6,3,3,1,-1,0,1
kosten,2,6,-4,-1,-1,0,1
bieten,3,5,-2,-1,-1,0,1
erheben,4,8,4,1,1,0,1
spiegeln,1,25,24,1,1,1,1
setzen,2,4,2,1,1,0,1
verlieren,1,2,-1,-1,-1,0,1
gestatten,6,5,1,1,-1,0,1
bieten,10,2,8,1,-1,0,1
präsentieren,3,5,-2,-1,-1,0,1
nutzen,4,2,2,1,-1,0,1
führen,2,3,1,1,1,0,1
erhalten,9,7,2,1,-1,0,1
halten,3,5,-2,-1,-1,0,1
setzen,3,4,-1,-1,-1,0,1
handeln,1,16,15,1,1,1,1
schreiben,1,6,5,1,1,0,1
erwerben,6,2,4,1,-1,1,1
kosten,8,6,2,1,-1,0,1
bieten,27,3,24,1,-1,0,1
bringen,1,3,2,1,1,0,1
erwirtschaften,7,5,2,1,-1,0,1
erwarten,2,3,1,1,1,0,1
veranstalten,5,6,-1,-1,-1,0,1
stellen,9,2,-7,-1,1,0,1
zeigen,2,2,0,0,-1,0,1
sehen,1,10,9,1,1,1,1
zahlen,4,2,2,1,-1,0,1
zahlen,4,4,0,0,-1,0,1
veranstalten,3,3,0,0,-1,0,1
präsentieren,6,6,0,0,-1,0,1
erhalten,1,20,19,1,1,0,1
errichten,3,2,1,1,-1,0,1
gehören,15,2,13,1,-1,0,1
betrachten,1,2,1,1,1,0,1
überreichen,4,4,0,0,1,0,1
nutzen,3,4,-1,-1,-1,0,1
ermöglichen,1,11,10,1,1,1,1
feiern,1,2,-1,-1,-1,0,1
bieten,6,8,-2,-1,-1,0,1
richten,1,4,3,1,1,1,1
verdienen,2,15,13,1,1,0,1
stellen,2,4,2,1,1,0,1
schließen,2,3,-1,-1,-1,0,1
senden,1,3,2,1,1,0,1
kaufen,4,5,1,1,1,0,1
geben,9,2,-7,-1,1,0,1
erwägen,16,6,10,1,-1,0,1
informieren,3,10,7,1,1,0,1
kaufen,1,2,1,1,1,0,1
führen,2,8,6,1,1,0,1
erhoffen,5,7,-2,-1,-1,0,1
stellen,4,3,1,1,-1,0,1
betreffen,7,2,5,1,-1,1,1
führen,6,3,3,1,-1,0,1
stellen,1,3,2,1,1,1,1
stellen,10,3,7,1,-1,0,1
wiegen,3,2,1,1,-1,0,1
geben,1,12,11,1,1,1,1
erreichen,5,3,2,1,-1,0,1
beliefern,5,3,-2,-1,1,0,1
enthalten,13,4,9,1,-1,0,1
richten,2,10,8,1,1,0,1
bekommen,11,2,9,1,-1,1,1
handeln,1,19,18,1,1,1,1
bringen,2,3,1,1,1,0,1
zeigen,2,3,-1,-1,-1,0,1
erwerben,6,5,1,1,-1,0,1
stoßen,4,2,2,1,-1,0,1
stellen,12,2,-10,-1,1,0,1
verkünden,5,7,-2,-1,-1,0,1
präsentieren,7,3,4,1,-1,0,1
handeln,1,6,5,1,1,1,1
sprechen,1,3,-2,-1,-1,0,1
finden,2,5,-3,-1,-1,0,1
verbinden,3,6,3,1,1,0,1
ändern,2,2,0,0,-1,0,1
erhalten,8,8,0,0,-1,0,1
richten,1,11,10,1,1,1,1
bieten,4,6,-2,-1,-1,0,1
suchen,3,4,-1,-1,-1,0,1
erwerben,8,4,4,1,-1,0,1
zwingen,4,3,-1,-1,1,0,1
bieten,4,5,-1,-1,-1,0,1
speichern,3,3,0,0,-1,0,1
statten,2,14,12,1,1,0,1
erhalten,2,2,0,0,-1,0,1
erwarten,9,5,4,1,-1,0,1
stellen,7,8,-1,-1,-1,0,1
definieren,3,3,0,0,1,0,1
speichern,7,4,3,1,-1,0,1
dauern,3,2,1,1,-1,0,1
übernehmen,16,4,12,1,-1,0,1
bieten,10,4,6,1,-1,0,1
schlagen,2,8,-6,-1,-1,0,1
bringen,3,4,1,1,1,0,1
liefern,3,2,1,1,-1,0,1
gefallen,3,2,-1,-1,1,0,1
erwarten,13,3,10,1,-1,0,1
liefern,3,3,0,0,-1,0,1
lassen,1,3,2,1,1,1,1
weisen,7,3,4,1,-1,0,1
bieten,2,4,-2,-1,-1,0,1
übernehmen,5,3,2,1,-1,0,1
erreichen,4,3,1,1,-1,0,1
bringen,2,3,1,1,1,0,1
unterstützen,2,3,1,1,1,0,1
speichern,2,3,1,1,1,0,1
speichern,2,3,1,1,1,0,1
speichern,3,3,0,0,-1,0,1
speichern,4,3,-1,-1,1,0,1
bringen,2,9,7,1,1,0,1
speichern,2,4,2,1,1,0,1
verraten,1,8,7,1,1,1,1
bringen,2,4,2,1,1,0,1
geben,8,2,6,1,-1,0,1
handeln,1,11,10,1,1,1,1
erzielen,2,4,-2,-1,-1,0,1
setzen,4,5,1,1,1,0,1
laden,5,3,-2,-1,1,0,1
richten,1,2,1,1,1,1,1
zeigen,6,3,3,1,-1,0,1
versprechen,6,3,3,1,-1,0,1
machen,1,4,3,1,1,1,1
verstecken,10,3,-7,-1,1,0,1
zeichnen,1,9,8,1,1,1,1
erhalten,1,3,-2,-1,-1,0,1
präsentieren,20,3,17,1,-1,0,1
erhöhen,4,2,2,1,-1,1,1
überraschen,4,9,5,1,1,0,1
folgen,6,2,4,1,-1,0,1
übertragen,2,3,1,1,1,0,1
bringen,1,3,2,1,1,1,1
handeln,1,28,27,1,1,1,1
speichern,2,2,0,0,-1,0,1
bringen,2,4,2,1,1,0,1
erzielen,7,2,5,1,-1,0,1
liegen,4,3,-1,-1,1,0,1
sehen,5,7,2,1,1,0,1
erwarten,6,4,-2,-1,1,0,1
rechnen,4,3,1,1,-1,0,1
handeln,1,12,11,1,1,1,1
sparen,1,2,-1,-1,-1,0,1
kosten,9,7,2,1,-1,0,1
betragen,2,6,4,1,1,0,1
speichern,2,4,-2,-1,-1,0,1
speichern,10,4,6,1,-1,0,1
handeln,1,15,14,1,1,1,1
stellen,2,2,0,0,1,0,1
verlangen,2,5,3,1,1,0,1
sprechen,1,2,-1,-1,-1,0,1
erweitern,2,6,4,1,1,0,1
bringen,3,13,10,1,1,0,1
rufen,5,5,0,0,1,0,1
bringen,4,2,2,1,-1,0,1
lassen,1,2,1,1,1,1,1
rüsten,3,3,0,0,1,0,1
liegen,2,3,1,1,1,0,1
geben,7,2,5,1,-1,0,1
überprüfen,4,3,1,1,-1,0,1
entwickeln,9,7,2,1,-1,0,1
machen,1,2,-1,-1,-1,0,1
verbuchen,7,3,4,1,-1,0,1
ermöglichen,2,4,2,1,1,0,1
sehen,2,6,4,1,1,0,1
betreiben,5,2,3,1,-1,0,1
liefern,1,6,5,1,1,0,1
bieten,6,4,-2,-1,1,0,1
suchen,3,3,0,0,1,0,1
zeichnen,1,3,2,1,1,1,1
kündigen,2,3,-1,-1,-1,0,1
kritisieren,17,2,15,1,-1,1,1
eröffnen,3,2,-1,-1,1,0,1
senden,4,5,1,1,1,0,1
bieten,2,8,-6,-1,-1,0,1
beliefern,1,3,2,1,1,0,1
geben,4,4,0,0,1,0,1
zeigen,1,4,3,1,1,1,1
bieten,24,3,21,1,-1,0,1
melden,1,2,1,1,1,0,1
befürchten,4,3,1,1,-1,0,1
erhalten,7,2,5,1,-1,0,1
finden,2,6,4,1,1,0,1
geben,1,4,-3,-1,-1,-1,1
ernennen,1,2,1,1,1,0,1
leiten,6,2,4,1,-1,0,1
finden,2,3,1,1,1,0,1
öffnen,2,3,1,1,1,0,1
besitzen,27,2,25,1,-1,0,1
legen,2,6,4,1,1,0,1
machen,1,6,5,1,1,0,1
erhoffen,5,4,1,1,-1,0,1
unterstützen,4,4,0,0,-1,0,1
integrieren,3,7,4,1,1,0,1
bieten,2,4,2,1,1,0,1
reichen,1,3,-2,-1,-1,0,1
loben,5,2,3,1,-1,1,1
planen,3,17,14,1,1,0,1
kaufen,2,2,0,0,1,1,1
saugen,2,15,13,1,1,0,1
justieren,1,4,3,1,1,1,1
stellen,5,4,1,1,-1,0,1
erhalten,1,3,-2,-1,-1,0,1
halten,6,2,-4,-1,1,0,1
rechnen,23,3,20,1,-1,0,1
starten,2,2,0,0,1,0,1
geben,18,3,15,1,-1,0,1
rekrutieren,2,3,1,1,1,0,1
unterstreichen,1,14,13,1,1,1,1
veranstalten,2,5,3,1,1,0,1
bauen,1,3,2,1,1,0,1
fördern,7,2,-5,-1,1,0,1
verbinden,2,3,1,1,1,0,1
geben,3,3,0,0,-1,0,1
gießen,2,10,8,1,1,0,1
bedampfen,3,2,-1,-1,1,0,1
zerlegen,2,11,9,1,1,0,1
bringen,2,2,0,0,1,0,1
begegnen,2,9,7,1,1,0,1
machen,1,2,-1,-1,-1,0,1
lassen,1,3,2,1,1,0,1
schreiben,2,3,1,1,1,0,1
zeigen,5,5,0,0,-1,0,1
setzen,4,4,0,0,-1,0,1
schicken,2,2,0,0,1,-1,1
vergleichen,2,3,1,1,1,0,1
bieten,1,2,1,1,1,0,1
bieten,13,3,10,1,-1,0,1
erhalten,2,2,0,0,-1,0,1
versprechen,11,3,8,1,-1,0,1
bringen,1,4,3,1,1,1,1
senden,2,3,1,1,1,0,1
ziehen,6,2,-4,-1,1,-1,1
brauchen,13,5,8,1,-1,0,1
erneuern,2,4,2,1,1,0,1
freuen,11,2,9,1,-1,1,1
kennen,1,7,6,1,1,1,1
nehmen,1,7,-6,-1,-1,0,1
bieten,7,2,5,1,-1,0,1
versorgen,2,4,2,1,1,0,1
lassen,1,9,8,1,1,1,1
führen,2,3,-1,-1,-1,0,1
nehmen,3,2,-1,-1,1,0,1
präsentieren,4,3,1,1,-1,0,1
führen,4,8,4,1,1,0,1
helfen,6,4,2,1,-1,0,1
sehen,2,5,3,1,1,0,1
nehmen,2,3,1,1,1,0,1
lassen,2,3,1,1,1,0,1
sammeln,1,7,-6,-1,-1,0,1
erhalten,5,3,2,1,-1,0,1
kombinieren,4,7,-3,-1,-1,0,1
geben,11,3,8,1,-1,0,1
ziehen,2,3,1,1,1,0,1
zeigen,1,2,1,1,1,1,1
reagieren,11,3,8,1,-1,0,1
unknown,32,2,30,1,-1,0,1
finden,4,5,1,1,1,0,1
leiten,2,3,1,1,1,0,1
fügen,2,8,6,1,1,0,1
versprechen,2,3,1,1,1,0,1
bringen,4,3,-1,-1,1,1,1
geben,10,6,4,1,-1,0,1
passen,4,4,0,0,1,0,1
liefern,23,3,-20,-1,1,0,1
fordern,5,5,0,0,-1,0,1
fürchten,4,9,-5,-1,-1,0,1
verdanken,6,2,4,1,-1,0,1
erhalten,4,2,2,1,-1,0,1
treten,2,4,-2,-1,-1,0,1
liefern,1,3,2,1,1,0,1
umfassen,4,2,2,1,-1,0,1
schnappen,2,4,2,1,1,0,1
lassen,2,4,2,1,1,0,1
sehen,5,8,3,1,1,0,1
vermuten,3,6,-3,-1,-1,0,1
glauben,2,4,2,1,1,0,1
verkürzen,4,3,-1,-1,1,0,1
beschuldigen,2,5,-3,-1,-1,0,1
erstrecken,1,4,3,1,1,1,1
filtern,1,5,4,1,1,0,1
sehen,9,3,6,1,-1,0,1
treiben,2,2,0,0,1,0,1
starten,7,2,5,1,-1,0,1
handeln,1,9,8,1,1,1,1
geben,6,3,3,1,-1,0,1
nennen,10,2,8,1,-1,0,1
vermuten,21,3,18,1,-1,0,1
handeln,1,19,18,1,1,1,1
zeigen,2,7,5,1,1,0,1
zeigen,2,4,2,1,1,0,1
verabschieden,1,2,1,1,1,1,1
geben,5,3,2,1,-1,0,1
bieten,14,4,10,1,-1,0,1
zeichnen,5,2,-3,-1,1,0,1
geben,6,4,2,1,-1,0,1
berichten,5,3,2,1,-1,0,1
vergleichen,2,14,12,1,1,0,1
machen,1,3,-2,-1,-1,0,1
gehen,11,2,9,1,-1,0,1
machen,1,5,-4,-1,-1,0,1
untersuchen,3,7,-4,-1,-1,0,1
sagen,10,2,8,1,-1,0,1
machen,1,2,1,1,1,0,1
machen,1,8,7,1,1,0,1
greifen,3,5,2,1,1,0,1
integrieren,8,4,4,1,-1,0,1
betreiben,1,3,2,1,1,0,1
loben,4,3,1,1,-1,0,1
deklarieren,2,3,1,1,1,0,1
sehen,3,3,0,0,1,0,1
erwirtschaften,6,6,0,0,-1,0,1
stellen,4,8,-4,-1,-1,0,1
verschicken,1,3,2,1,1,0,1
nutzen,4,3,1,1,-1,0,1
entrichten,2,2,0,0,1,0,1
bestellen,4,3,-1,-1,1,0,1
hängen,8,2,6,1,-1,1,1
feiern,1,2,1,1,1,0,1
feiern,2,2,0,0,-1,0,1
erklären,1,2,1,1,1,0,1
stellen,4,2,-2,-1,1,0,1
kommen,1,2,1,1,1,0,1
versprechen,5,2,3,1,-1,0,1
schließen,1,5,4,1,1,1,1
geben,3,3,0,0,-1,0,1
stecken,2,2,0,0,1,0,1
liefern,2,9,7,1,1,0,1
weisen,6,7,-1,-1,-1,0,1
führen,3,4,-1,-1,-1,0,1
führen,5,4,1,1,-1,0,1
übertreffen,4,5,1,1,1,1,1
erhalten,4,3,1,1,-1,0,1
benutzen,3,6,3,1,1,0,1
reagieren,14,3,11,1,-1,0,1
spielen,1,3,2,1,1,0,1
erwarten,9,2,7,1,-1,0,1
richten,1,5,4,1,1,1,1
sehen,5,3,-2,-1,1,0,1
erwarten,5,5,0,0,-1,0,1
sehen,1,2,1,1,1,1,1
äußern,1,3,2,1,1,1,1
führen,3,2,-1,-1,1,-1,1
belaufen,1,7,6,1,1,1,1
halten,1,2,1,1,1,0,1
vergleichen,4,9,5,1,1,0,1
weisen,3,4,-1,-1,-1,0,1
bringen,1,2,1,1,1,0,1
weisen,18,2,16,1,-1,1,1
verbreiten,6,3,3,1,-1,0,1
streben,2,4,-2,-1,-1,0,1
arbeiten,4,4,0,0,-1,0,1
betragen,3,4,-1,-1,-1,0,1
geben,5,7,-2,-1,-1,0,1
bringen,13,9,4,1,-1,0,1
korrigieren,2,2,0,0,1,0,1
rechnen,5,3,2,1,-1,0,1
melden,1,4,3,1,1,0,1
betragen,3,6,3,1,1,0,1
nutzen,1,2,1,1,1,0,1
erklären,2,25,23,1,1,0,1
schicken,2,2,0,0,1,0,1
bezahlen,5,11,6,1,1,0,1
bieten,2,14,12,1,1,0,1
geben,1,4,3,1,1,0,1
erhalten,1,3,2,1,1,0,1
handeln,1,16,15,1,1,1,1
beschäftigen,34,3,31,1,-1,0,1
sehen,3,12,-9,-1,-1,0,1
umfassen,2,4,-2,-1,-1,0,1
sprechen,1,5,4,1,1,1,1
reagieren,4,3,1,1,-1,0,1
protestieren,9,4,5,1,-1,0,1
wenden,1,2,1,1,1,0,1
verweisen,1,3,-2,-1,-1,0,1
stellen,6,3,-3,-1,1,-1,1
erwirtschaften,4,6,2,1,1,0,1
geben,11,2,-9,-1,1,0,1
erhoffen,8,3,5,1,-1,0,1
beschreiben,11,4,7,1,-1,0,1
handeln,1,4,3,1,1,1,1
kommentieren,3,2,-1,-1,1,0,1
geraten,3,3,0,0,-1,0,1
liefern,9,3,6,1,-1,0,1
vergleichen,5,7,2,1,1,0,1
stellen,6,2,-4,-1,1,0,1
bauen,16,5,11,1,-1,0,1
bringen,7,3,-4,-1,1,0,1
betreiben,2,13,11,1,1,0,1
zeigen,1,2,1,1,1,1,1
sehen,23,3,20,1,-1,0,1
unterstützen,2,14,12,1,1,0,1
besitzen,3,9,6,1,1,0,1
kosten,2,4,-2,-1,-1,0,1
lassen,1,4,3,1,1,1,1
stellen,8,8,0,0,-1,0,1
bieten,7,5,2,1,-1,0,1
zahlen,3,2,1,1,-1,0,1
reagieren,11,3,8,1,-1,0,1
liefern,10,3,-7,-1,1,0,1
nennen,14,4,10,1,-1,0,1
liefern,24,3,21,1,-1,0,1
betragen,3,5,2,1,1,0,1
fordern,3,4,-1,-1,-1,0,1
stellen,4,2,-2,-1,1,0,1
bezeichnen,2,2,0,0,1,0,1
unterstützen,1,5,4,1,1,0,1
stellen,2,3,-1,-1,-1,0,1
stellen,6,2,-4,-1,1,0,1
gehören,2,4,-2,-1,-1,0,1
bieten,10,2,8,1,-1,1,1
kommentieren,6,4,-2,-1,1,0,1
kosten,5,5,0,0,-1,0,1
geben,14,2,12,1,-1,0,1
bezeichnen,3,3,0,0,1,0,1
kündigen,5,4,1,1,-1,0,1
fällen,2,17,15,1,1,0,1
stellen,13,2,11,1,-1,0,1
befürchten,8,2,6,1,-1,1,1
realisieren,5,4,-1,-1,1,0,1
stellen,4,3,-1,-1,1,0,1
bauen,7,4,3,1,-1,0,1
weisen,6,5,1,1,-1,0,1
fassen,22,3,-19,-1,1,0,1
handeln,1,13,12,1,1,1,1
erhalten,2,6,4,1,1,0,1
ergehen,3,6,3,1,1,0,1
machen,5,2,-3,-1,1,0,1
beruhigen,2,3,1,1,1,0,1
ziehen,11,15,-4,-1,-1,0,1
erreichen,4,15,-11,-1,-1,0,1
legen,1,2,1,1,1,1,1
fahren,1,2,-1,-1,-1,1,1
reichen,3,4,-1,-1,-1,0,1
bringen,7,3,-4,-1,1,0,1
handeln,1,10,9,1,1,1,1
profitieren,5,2,3,1,-1,0,1
handeln,1,4,3,1,1,1,1
schätzen,10,4,-6,-1,1,0,1
setzen,28,3,25,1,-1,0,1
erlauben,10,5,5,1,-1,0,1
erhoffen,11,3,8,1,-1,0,1
betragen,3,3,0,0,-1,0,1
entsprechen,8,4,4,1,-1,0,1
beruhen,16,2,14,1,-1,1,1
verlangen,9,3,6,1,-1,0,1
setzen,7,2,5,1,-1,0,1
bieten,4,2,2,1,-1,1,1
offerieren,7,4,3,1,-1,0,1
veranschlagen,3,6,-3,-1,-1,0,1
geben,6,3,-3,-1,1,0,1
betragen,4,4,0,0,-1,0,1
beinhalten,14,4,10,1,-1,0,1
offerieren,7,3,4,1,-1,0,1
führen,3,14,11,1,1,0,1
suchen,1,2,1,1,1,0,1
handeln,2,4,-2,-1,-1,0,1
unknown,5,9,4,1,1,0,1
vertreten,20,6,14,1,-1,0,1
lizensieren,2,4,2,1,1,0,1
heben,8,12,4,1,1,0,1
melden,5,3,-2,-1,1,0,1
sehen,5,3,2,1,-1,0,1
kommen,2,2,0,0,-1,1,1
schütten,19,3,-16,-1,1,0,1
verschicken,1,6,-5,-1,-1,0,1
sehen,9,14,-5,-1,-1,0,1
fordern,3,3,0,0,1,0,1
erwirtschaften,4,8,-4,-1,-1,0,1
handeln,1,8,7,1,1,1,1
verkünden,13,3,10,1,-1,0,1
belegen,2,14,-12,-1,-1,0,1
erreichen,3,3,0,0,-1,0,1
führen,2,4,2,1,1,0,1
richten,1,10,9,1,1,1,1
unknown,4,12,8,1,1,1,1
setzen,4,3,1,1,-1,0,1
geben,11,2,9,1,-1,0,1
reagieren,5,7,2,1,1,0,1
reichen,31,4,27,1,-1,0,1
fordern,2,3,-1,-1,-1,0,1
rechnen,2,3,1,1,1,0,1
verfügen,3,2,1,1,-1,0,1
legen,1,3,-2,-1,-1,0,1
bieten,2,3,1,1,1,0,1
stellen,1,2,1,1,1,0,1
setzen,7,4,-3,-1,1,0,1
überprüfen,2,4,2,1,1,0,1
übermitteln,2,6,4,1,1,0,1
rechnen,1,7,-6,-1,-1,0,1
bestätigen,2,10,-8,-1,-1,0,1
kommentieren,4,3,-1,-1,1,0,1
vermeiden,5,5,0,0,-1,0,1
richten,1,5,4,1,1,1,1
beschreiben,3,2,-1,-1,1,-1,1
bekommen,2,5,-3,-1,-1,0,1
versprechen,1,2,1,1,1,1,1
führen,2,12,10,1,1,0,1
kündigen,7,3,-4,-1,1,0,1
quittieren,3,3,0,0,1,0,1
bringen,3,6,-3,-1,-1,0,1
rechnen,2,3,-1,-1,-1,0,1
geben,26,3,23,1,-1,0,1
erhalten,15,2,13,1,-1,0,1
erklären,1,12,11,1,1,1,1
geben,4,2,2,1,-1,0,1
geben,5,7,-2,-1,-1,0,1
stellen,5,5,0,0,1,0,1
stellen,2,5,3,1,1,0,1
integrieren,3,3,0,0,1,0,1
bestehen,1,2,-1,-1,-1,1,1
stehen,2,5,3,1,1,0,1
schreiben,2,3,-1,-1,-1,0,1
kaufen,3,6,-3,-1,-1,0,1
gehören,3,3,0,0,-1,0,1
lassen,1,2,1,1,1,1,1
greifen,2,5,-3,-1,-1,0,1
verlangen,7,3,4,1,-1,0,1
geben,13,4,9,1,-1,0,1
bieten,4,4,0,0,-1,0,1
bieten,9,22,-13,-1,-1,0,1
äußern,4,9,5,1,1,0,1
begründen,6,3,-3,-1,1,0,1
deuten,3,3,0,0,1,0,1
nehmen,2,2,0,0,1,0,1
geben,1,6,-5,-1,-1,0,1
mischen,1,5,4,1,1,1,1
erwarten,4,4,0,0,1,0,1
bringen,5,2,-3,-1,1,0,1
planen,4,7,-3,-1,-1,0,1
stürzen,2,3,1,1,1,0,1
stellen,6,2,-4,-1,1,0,1
kosten,2,2,0,0,-1,0,1
gewinnen,2,12,-10,-1,-1,0,1
stellen,5,3,2,1,-1,0,1
versprechen,10,6,4,1,-1,0,1
verschaffen,2,3,1,1,1,0,1
stellen,1,5,4,1,1,0,1
versprechen,2,3,-1,-1,-1,0,1
erwägen,1,2,1,1,1,0,1
teilen,1,4,-3,-1,-1,-1,1
betragen,3,3,0,0,-1,0,1
benötigen,1,3,2,1,1,0,1
verkaufen,4,4,0,0,1,0,1
machen,3,6,-3,-1,-1,0,1
räumen,2,2,0,0,1,0,1
projizieren,4,8,4,1,1,0,1
geben,26,5,21,1,-1,0,1
bringen,1,3,2,1,1,1,1
gehen,2,5,3,1,1,0,1
erwirtschaften,7,3,-4,-1,1,0,1
zählen,4,3,1,1,-1,0,1
erreichen,10,2,8,1,-1,0,1
erreichen,7,2,5,1,-1,0,1
korrigieren,1,2,1,1,1,0,1
erwarten,9,3,6,1,-1,0,1
kosten,2,3,-1,-1,-1,0,1
setzen,3,7,4,1,1,0,1
rechnen,11,4,7,1,-1,0,1
führen,1,9,8,1,1,1,1
verschenken,1,2,1,1,1,0,1
machen,1,2,1,1,1,0,1
machen,1,3,2,1,1,0,1
erklären,1,9,8,1,1,1,1
bringen,3,3,0,0,1,0,1
konstruieren,4,3,1,1,-1,0,1
fassen,5,4,-1,-1,1,0,1
sehen,8,3,5,1,-1,0,1
weisen,23,3,20,1,-1,0,1
sehen,9,3,6,1,-1,0,1
verfolgen,8,6,2,1,-1,0,1
bieten,4,3,-1,-1,1,0,1
prüfen,2,7,5,1,1,0,1
führen,1,7,6,1,1,1,1
betreiben,3,2,1,1,-1,0,1
rechnen,3,3,0,0,-1,0,1
schließen,3,7,4,1,1,0,1
rechnen,9,5,4,1,-1,0,1
erzielen,2,6,-4,-1,-1,0,1
verlieren,2,2,0,0,1,0,1
genügen,3,5,2,1,1,0,1
berichten,9,3,6,1,-1,0,1
raten,8,2,6,1,-1,1,1
geben,12,3,9,1,-1,0,1
halten,8,6,2,1,-1,0,1
äußern,10,4,6,1,-1,0,1
sehen,4,8,-4,-1,-1,0,1
wirken,1,2,1,1,1,0,1
unknown,5,6,1,1,1,0,1
kaufen,1,4,3,1,1,1,1
betragen,4,4,0,0,-1,0,1
konzipieren,3,3,0,0,1,0,1
bündeln,2,7,5,1,1,0,1
sehen,7,3,4,1,-1,-1,1
untersuchen,5,3,-2,-1,1,0,1
treffen,3,5,-2,-1,-1,0,1
führen,1,9,8,1,1,0,1
werben,3,4,-1,-1,-1,0,1
versetzen,3,4,1,1,1,0,1
senden,1,3,2,1,1,1,1
wandeln,3,2,-1,-1,1,0,1
fügen,1,7,6,1,1,1,1
filtern,2,3,1,1,1,0,1
bieten,3,4,1,1,1,0,1
stellen,5,2,-3,-1,1,0,1
räumen,2,2,0,0,-1,0,1
kontern,4,7,-3,-1,-1,0,1
bieten,13,6,-7,-1,1,0,1
spekulieren,16,3,13,1,-1,0,1
schmieden,2,5,-3,-1,-1,0,1
bringen,4,3,-1,-1,1,0,1
reichen,3,4,1,1,1,0,1
schlagen,2,4,-2,-1,-1,0,1
üben,3,10,7,1,1,0,1
stellen,4,2,-2,-1,1,0,1
übernehmen,12,8,4,1,-1,0,1
melden,11,4,7,1,-1,0,1
kündigen,7,4,3,1,-1,0,1
bieten,8,2,6,1,-1,0,1
stören,1,2,1,1,1,0,1
stiften,1,2,1,1,1,0,1
legen,2,24,22,1,1,0,1
bieten,11,4,7,1,-1,0,1
verlieren,1,3,2,1,1,1,1
bringen,1,2,1,1,1,0,1
erwerben,5,4,1,1,-1,0,1
erwerben,35,4,31,1,-1,0,1
kaufen,7,4,3,1,-1,0,1
geben,7,3,-4,-1,1,0,1
führen,5,13,8,1,1,0,1
loben,1,6,5,1,1,0,1
loben,2,5,3,1,1,0,1
untermauern,2,3,1,1,1,0,1
entwerfen,12,4,8,1,-1,0,1
betragen,4,4,0,0,-1,0,1
halten,3,2,-1,-1,1,0,1
pendeln,1,3,2,1,1,1,1
legen,2,3,1,1,1,0,1
betragen,3,7,-4,-1,-1,0,1
betreiben,2,4,2,1,1,0,1
erwarten,3,8,-5,-1,-1,0,1
machen,3,4,1,1,1,0,1
verdienen,2,3,-1,-1,-1,-1,1
bringen,1,6,5,1,1,0,1
kündigen,8,3,5,1,-1,0,1
widmen,10,3,7,1,-1,0,1
setzen,3,2,1,1,-1,1,1
verlieren,3,3,0,0,-1,0,1
kosten,2,2,0,0,-1,0,1
gehören,4,3,1,1,-1,0,1
betragen,2,6,4,1,1,0,1
bleiben,2,4,2,1,1,0,1
führen,3,9,6,1,1,0,1
nennen,6,3,3,1,-1,0,1
brauchen,3,3,0,0,1,0,1
stehen,1,3,2,1,1,0,1
lassen,1,5,-4,-1,-1,0,1
unterstützen,9,8,-1,-1,1,0,1
sehen,13,18,-5,-1,-1,0,1
führen,2,13,11,1,1,0,1
suchen,7,3,4,1,-1,0,1
verweisen,2,5,3,1,1,0,1
halten,4,3,1,1,-1,0,1
bringen,1,2,1,1,1,0,1
treffen,2,4,2,1,1,0,1
zeigen,2,3,1,1,1,0,1
bringen,1,2,1,1,1,0,1
stellen,11,2,9,1,-1,0,1
äußern,1,12,11,1,1,1,1
erfreuen,2,2,0,0,-1,0,1
verlangen,6,2,4,1,-1,0,1
prüfen,2,8,6,1,1,0,1
übernehmen,4,8,4,1,1,0,1
betragen,3,7,-4,-1,-1,0,1
korrigieren,4,2,-2,-1,1,0,1
verwandeln,1,3,2,1,1,1,1
werben,3,26,23,1,1,0,1
weisen,2,2,0,0,1,-1,1
sehen,1,2,1,1,1,0,1
optimieren,2,2,0,0,1,0,1
geben,9,4,5,1,-1,0,1
starten,1,2,1,1,1,0,1
rechnen,13,4,9,1,-1,0,1
rechnen,12,3,9,1,-1,0,1
handeln,1,6,5,1,1,1,1
denken,13,3,10,1,-1,0,1
nähern,2,4,-2,-1,-1,0,1
vertreiben,2,3,1,1,1,0,1
sehen,5,3,2,1,-1,0,1
lassen,16,3,13,1,-1,0,1
üben,3,12,-9,-1,-1,0,1
kosten,14,3,11,1,-1,0,1
geben,4,5,-1,-1,-1,1,1
erreichen,5,3,2,1,-1,0,1
erreichen,5,5,0,0,-1,0,1
machen,10,8,2,1,-1,0,1
spiegeln,1,6,5,1,1,1,1
zeigen,7,3,4,1,-1,0,1
machen,1,3,2,1,1,0,1
sehen,6,3,3,1,-1,0,1
führen,1,5,4,1,1,1,1
spenden,3,4,-1,-1,-1,0,1
kommentieren,3,3,0,0,1,0,1
prangern,2,3,1,1,1,0,1
unterstützen,2,3,1,1,1,0,1
geben,1,3,-2,-1,-1,0,1
geben,16,7,9,1,-1,0,1
gestalten,1,2,1,1,1,1,1
suchen,1,2,1,1,1,0,1
begrüßen,12,11,1,1,-1,0,1
danken,2,4,2,1,1,0,1
goutieren,5,3,-2,-1,1,0,1
legen,2,3,-1,-1,-1,0,1
sehen,18,5,13,1,-1,0,1
rechnen,10,4,6,1,-1,0,1
beschränken,2,4,2,1,1,0,1
erhoffen,15,5,10,1,-1,0,1
sichern,18,2,16,1,-1,0,1
präsentieren,8,4,4,1,-1,0,1
führen,1,13,12,1,1,1,1
zahlen,8,13,5,1,1,0,1
erwirtschaften,4,5,-1,-1,-1,0,1
bleiben,4,9,5,1,1,0,1
bedeuten,17,2,15,1,-1,0,1
erwerben,3,4,-1,-1,-1,0,1
erwerben,3,7,-4,-1,-1,0,1
brauchen,5,18,-13,-1,-1,0,1
betreiben,2,2,0,0,-1,0,1
zahlen,3,3,0,0,1,0,1
geraten,8,3,5,1,-1,0,1
lassen,8,2,-6,-1,1,0,1
bilden,3,3,0,0,-1,0,1
geben,11,3,8,1,-1,0,1
drücken,1,3,2,1,1,1,1
führen,9,3,6,1,-1,0,1
beruhen,22,3,19,1,-1,0,1
bedeuten,22,3,19,1,-1,0,1
führen,6,12,6,1,1,0,1
erwarten,23,3,20,1,-1,0,1
sehen,7,6,1,1,-1,0,1
nennen,2,3,-1,-1,-1,0,1
sehen,5,10,5,1,1,0,1
nehmen,8,7,-1,-1,1,0,1
ersetzen,2,4,2,1,1,0,1
bedeuten,5,6,-1,-1,-1,0,1
betragen,3,4,-1,-1,-1,0,1
belaufen,1,4,3,1,1,1,1
verbuchen,21,3,18,1,-1,0,1
erwarten,2,3,1,1,1,0,1
sehen,5,2,3,1,-1,0,1
bestätigen,6,2,4,1,-1,0,1
verfolgen,3,2,-1,-1,1,0,1
ersteigern,2,4,2,1,1,0,1
brauchen,2,3,-1,-1,-1,0,1
versprechen,4,3,1,1,-1,0,1
schließen,27,2,25,1,-1,0,1
genehmigen,9,13,4,1,1,0,1
notieren,2,4,-2,-1,-1,0,1
geraten,2,3,-1,-1,-1,0,1
erhöhen,7,3,-4,-1,1,0,1
zitieren,4,3,-1,-1,1,0,1
verdrängen,1,2,1,1,1,0,1
-,14,5,9,1,-1,0,1
erhoffen,14,5,9,1,-1,0,1
sehen,7,4,3,1,-1,0,1
erwarten,4,2,2,1,-1,0,1
machen,6,4,-2,-1,1,0,1
rechnen,15,4,11,1,-1,0,1
machen,8,7,1,1,-1,0,1
schließen,13,3,10,1,-1,0,1
bringen,2,5,3,1,1,0,1
betreuen,10,3,7,1,-1,0,1
pendeln,1,4,3,1,1,1,1
machen,2,6,4,1,1,0,1
verlangen,4,11,-7,-1,-1,0,1
halten,3,3,0,0,-1,0,1
bieten,20,2,18,1,-1,0,1
belohnen,7,3,4,1,-1,-1,1
verschmelzen,1,5,4,1,1,1,1
zahlen,4,2,-2,-1,1,0,1
halten,2,2,0,0,1,0,1
legen,2,15,13,1,1,0,1
bringen,4,3,-1,-1,1,0,1
stocken,2,8,6,1,1,0,1
erwirtschaften,4,9,-5,-1,-1,0,1
erwarten,7,3,4,1,-1,0,1
fließen,2,3,-1,-1,-1,0,1
geben,2,2,0,0,-1,0,1
sehen,3,2,-1,-1,1,0,1
rechnen,11,6,5,1,-1,0,1
kosten,4,4,0,0,-1,0,1
übernehmen,8,5,-3,-1,1,0,1
geben,4,3,1,1,-1,0,1
treffen,3,3,0,0,-1,0,1
besitzen,3,3,0,0,-1,0,1
fordern,3,3,0,0,-1,0,1
beantworten,2,3,1,1,1,0,1
handeln,1,8,7,1,1,1,1
kritisieren,21,3,18,1,-1,0,1
führen,13,2,11,1,-1,1,1
beschließen,2,3,1,1,1,0,1
erwähnen,9,3,-6,-1,1,0,1
unterstützen,2,4,2,1,1,0,1
definieren,1,6,5,1,1,1,1
kaufen,6,2,-4,-1,1,-1,1
betragen,3,4,1,1,1,0,1
kaufen,6,4,-2,-1,1,0,1
streben,7,4,3,1,-1,0,1
bedeuten,4,3,1,1,-1,0,1
komplettieren,2,2,0,0,-1,0,1
geraten,2,7,-5,-1,-1,0,1
kosten,2,4,-2,-1,-1,0,1
suchen,4,3,1,1,-1,0,1
leiten,2,32,30,1,1,0,1
stellen,2,3,1,1,1,0,1
geben,3,3,0,0,-1,0,1
bedeuten,2,6,-4,-1,-1,0,1
zahlen,4,6,-2,-1,-1,0,1
erhoffen,13,4,9,1,-1,0,1
gehen,1,4,-3,-1,-1,0,1
unterstützen,1,7,6,1,1,1,1
schließen,1,3,2,1,1,1,1
tun,1,17,16,1,1,1,1
gehören,1,3,2,1,1,0,1
streben,6,4,-2,-1,1,0,1
stellen,5,20,-15,-1,-1,0,1
planen,4,4,0,0,-1,0,1
fassen,2,3,1,1,1,0,1
stehen,2,2,0,0,1,0,1
knüpfen,2,16,14,1,1,0,1
geben,4,2,2,1,-1,0,1
übernehmen,17,2,15,1,-1,0,1
vereinbaren,1,3,-2,-1,-1,0,1
zahlen,9,4,5,1,-1,0,1
kaufen,14,8,6,1,-1,0,1
erwirtschaften,4,3,1,1,-1,0,1
zahlen,4,10,6,1,1,0,1
verteidigen,2,19,17,1,1,0,1
verlieren,5,4,1,1,-1,0,1
erwarten,2,2,0,0,-1,0,1
trauen,6,2,4,1,-1,0,1
tragen,2,8,6,1,1,0,1
feiern,13,3,10,1,-1,0,1
bauen,4,4,0,0,-1,0,1
geben,20,3,17,1,-1,1,1
beschäftigen,9,4,5,1,-1,0,1
räumen,3,24,-21,-1,-1,0,1
ziehen,11,2,-9,-1,1,-1,1
verklagen,1,2,1,1,1,0,1
fordern,2,4,-2,-1,-1,0,1
begründen,4,5,1,1,1,0,1
suchen,10,17,-7,-1,-1,0,1
formulieren,27,3,24,1,-1,0,1
geben,2,4,2,1,1,0,1
werben,3,5,2,1,1,0,1
handeln,1,19,18,1,1,1,1
begrüßen,3,3,0,0,-1,0,1
beanspruchen,3,3,0,0,1,0,1
zitieren,1,3,2,1,1,0,1
streben,7,4,3,1,-1,0,1
zahlen,3,10,-7,-1,-1,0,1
beschäftigen,3,3,0,0,1,0,1
erwirtschaften,6,4,2,1,-1,0,1
verlassen,2,3,1,1,1,0,1
öffnen,2,2,0,0,-1,0,1
greifen,5,14,-9,-1,-1,0,1
sehen,6,6,0,0,-1,0,1
legen,2,3,1,1,1,0,1
machen,1,6,5,1,1,1,1
verlieren,5,9,-4,-1,-1,0,1
gehen,7,6,1,1,-1,0,1
rechnen,3,4,-1,-1,-1,0,1
danken,1,6,5,1,1,0,1
bedeuten,18,2,16,1,-1,0,1
vertreten,19,4,15,1,-1,0,1
beruhigen,1,2,1,1,1,0,1
führen,1,15,14,1,1,1,1
kündigen,7,5,2,1,-1,0,1
nennen,4,2,2,1,-1,0,1
verzeichnen,7,3,4,1,-1,0,1
übernehmen,11,7,4,1,-1,0,1
erreichen,6,3,3,1,-1,0,1
verhalten,1,5,4,1,1,1,1
schließen,4,8,4,1,1,0,1
bedeuten,9,10,1,1,1,0,1
bringen,3,5,2,1,1,0,1
handeln,1,14,13,1,1,1,1
machen,9,3,6,1,-1,0,1
erwarten,17,3,14,1,-1,0,1
setzen,10,2,-8,-1,1,0,1
sehen,6,4,-2,-1,1,0,1
planen,4,6,-2,-1,-1,0,1
liefern,6,6,0,0,-1,0,1
machen,11,2,9,1,-1,0,1
begründen,4,10,-6,-1,-1,0,1
erwarten,8,5,-3,-1,1,0,1
erwarten,5,4,1,1,-1,0,1
setzen,8,4,4,1,-1,0,1
kommentieren,7,2,-5,-1,1,0,1
umgeben,1,3,2,1,1,1,1
berechtigen,6,7,1,1,1,0,1
zahlen,3,3,0,0,-1,0,1
stellen,7,2,-5,-1,1,0,1
stellen,6,2,4,1,-1,0,1
beschließen,2,3,1,1,1,0,1
übersteigen,4,3,1,1,-1,0,1
eröffnen,2,10,-8,-1,-1,0,1
erreichen,6,5,1,1,-1,0,1
handeln,1,25,24,1,1,1,1
führen,4,9,-5,-1,-1,0,1
setzen,5,2,3,1,-1,1,1
entsprechen,5,5,0,0,-1,0,1
melden,14,5,-9,-1,1,0,1
holen,4,2,-2,-1,1,0,1
tätigen,1,6,5,1,1,0,1
versprechen,2,3,-1,-1,-1,0,1
halten,2,3,1,1,1,0,1
gehören,14,4,10,1,-1,0,1
geben,2,4,-2,-1,-1,0,1
gleichen,4,3,1,1,-1,0,1
bewerten,2,9,7,1,1,0,1
geben,12,5,7,1,-1,0,1
betragen,5,4,1,1,-1,0,1
bieten,2,3,-1,-1,-1,0,1
öffnen,2,2,0,0,1,0,1
zeichnen,2,2,0,0,1,0,1
drohen,1,5,4,1,1,1,1
sehen,2,5,3,1,1,0,1
sehen,7,3,4,1,-1,0,1
schützen,2,3,1,1,1,0,1
betrachten,2,3,1,1,1,0,1
sehen,13,3,10,1,-1,0,1
sehen,1,5,4,1,1,1,1
zahlen,1,3,2,1,1,0,1
verteilen,2,3,1,1,1,0,1
geben,2,8,6,1,1,0,1
danken,1,3,2,1,1,1,1
entdecken,2,14,-12,-1,-1,0,1
wechseln,2,5,-3,-1,-1,0,1
stoßen,3,4,-1,-1,-1,0,1
geben,3,2,-1,-1,1,0,1
toppen,1,2,1,1,1,0,1
berichten,7,3,4,1,-1,0,1
führen,5,7,2,1,1,0,1
profitieren,4,6,-2,-1,-1,0,1
bekommen,7,3,-4,-1,1,0,1
assoziieren,1,4,3,1,1,0,1
nutzen,3,2,1,1,-1,0,1
nutzen,2,2,0,0,1,0,1
sehen,10,3,7,1,-1,0,1
erwarten,27,5,22,1,-1,0,1
sehen,2,17,-15,-1,-1,0,1
erhöhen,6,5,-1,-1,1,0,1
bestätigen,7,4,3,1,-1,0,1
führen,2,5,3,1,1,0,1
erwägen,5,7,-2,-1,-1,0,1
führen,8,5,3,1,-1,0,1
machen,4,4,0,0,-1,0,1
bringen,1,2,1,1,1,0,1
beschreiben,4,3,-1,-1,1,0,1
besitzen,2,3,1,1,1,0,1
melden,2,3,-1,-1,-1,0,1
bringen,3,3,0,0,1,0,1
beschreiben,4,6,-2,-1,-1,0,1
bieten,2,4,2,1,1,0,1
kündigen,7,3,4,1,-1,0,1
halten,7,2,5,1,-1,0,1
drücken,3,2,-1,-1,1,0,1
bauen,2,2,0,0,-1,1,1
überziehen,1,3,2,1,1,0,1
bieten,1,4,3,1,1,0,1
drucken,7,3,4,1,-1,0,1
übernehmen,6,2,4,1,-1,0,1
geben,1,2,1,1,1,0,1
sorgen,2,7,-5,-1,-1,0,1
reagieren,6,6,0,0,-1,0,1
geben,2,4,2,1,1,0,1
rechnen,5,4,1,1,-1,0,1
ermitteln,8,3,5,1,-1,0,1
statten,3,6,3,1,1,0,1
sehen,9,9,0,0,-1,0,1
halten,9,3,6,1,-1,0,1
belegen,3,8,5,1,1,0,1
diversifizieren,2,4,-2,-1,-1,0,1
bieten,6,2,4,1,-1,0,1
bieten,6,3,3,1,-1,0,1
pressen,2,4,2,1,1,0,1
wischen,7,2,-5,-1,1,0,1
folgen,34,4,30,1,-1,0,1
übernehmen,8,3,5,1,-1,0,1
vertreiben,1,6,5,1,1,0,1
überziehen,1,2,1,1,1,0,1
schließen,4,3,1,1,-1,0,1
stellen,2,3,1,1,1,0,1
erwarten,6,4,2,1,-1,0,1
kassieren,1,6,5,1,1,0,1
halten,1,13,12,1,1,0,1
halten,2,4,2,1,1,0,1
schwemmen,5,3,-2,-1,1,0,1
stellen,2,5,3,1,1,0,1
stellen,5,3,2,1,-1,0,1
führen,1,3,-2,-1,-1,0,1
erreichen,6,4,2,1,-1,0,1
senken,2,10,8,1,1,0,1
erwarten,3,6,-3,-1,-1,0,1
belichten,5,7,2,1,1,0,1
sorgen,9,3,6,1,-1,0,1
versprechen,6,3,3,1,-1,0,1
nehmen,3,2,-1,-1,1,0,1
mahnen,1,8,-7,-1,-1,0,1
lizenzieren,4,3,1,1,-1,0,1
schlucken,3,6,-3,-1,-1,0,1
kaufen,4,4,0,0,1,0,1
unterstützen,1,6,5,1,1,0,1
liefern,3,6,-3,-1,-1,0,1
setzen,1,2,1,1,1,0,1
setzen,1,9,8,1,1,0,1
bieten,3,3,0,0,-1,0,1
stellen,3,2,1,1,-1,0,1
bieten,3,3,0,0,1,0,1
bestellen,2,4,2,1,1,0,1
kosten,3,7,-4,-1,-1,0,1
liefern,1,10,9,1,1,1,1
bieten,1,8,7,1,1,0,1
kosten,2,5,-3,-1,-1,0,1
liefern,7,2,5,1,-1,0,1
fertigen,1,2,1,1,1,0,1
erhalten,2,2,0,0,1,0,1
nutzen,3,2,-1,-1,1,0,1
untersuchen,2,4,2,1,1,0,1
stellen,7,4,3,1,-1,0,1
laden,2,4,-2,-1,-1,0,1
senken,6,5,-1,-1,1,0,1
bieten,10,7,3,1,-1,0,1
verlangen,3,14,-11,-1,-1,0,1
schätzen,8,6,-2,-1,1,0,1
erwirtschaften,7,5,2,1,-1,0,1
suchen,1,2,-1,-1,-1,0,1
verkaufen,5,5,0,0,1,0,1
sichern,2,2,0,0,-1,0,1
übernehmen,14,4,10,1,-1,0,1
betragen,5,2,3,1,-1,0,1
vermarkten,3,4,1,1,1,0,1
rüsten,2,3,1,1,1,0,1
führen,1,2,-1,-1,-1,0,1
führen,1,3,-2,-1,-1,0,1
prognostizieren,5,2,3,1,-1,0,1
machen,6,2,4,1,-1,0,1
beschäftigen,1,5,4,1,1,0,1
zeichnen,1,7,6,1,1,1,1
sichern,2,3,-1,-1,-1,0,1
verkaufen,2,4,2,1,1,1,1
bündeln,2,3,1,1,1,0,1
erreichen,1,7,6,1,1,0,1
verkraften,3,2,1,1,-1,0,1
unterstützen,3,2,-1,-1,1,0,1
bieten,1,2,1,1,1,0,1
versprechen,5,3,2,1,-1,0,1
entdecken,3,5,-2,-1,-1,0,1
geben,3,4,-1,-1,-1,0,1
benötigen,3,3,0,0,-1,0,1
versprechen,7,6,1,1,-1,0,1
führen,8,4,4,1,-1,0,1
stellen,2,7,-5,-1,-1,0,1
betreiben,10,3,7,1,-1,0,1
entbehren,2,4,-2,-1,-1,0,1
melden,7,6,1,1,-1,0,1
verkaufen,1,2,1,1,1,0,1
verfolgen,3,3,0,0,-1,0,1
verkaufen,3,3,0,0,-1,0,1
betragen,9,3,6,1,-1,0,1
erklären,3,11,8,1,1,0,1
setzen,2,2,0,0,-1,0,1
bevorzugen,1,8,7,1,1,0,1
machen,3,4,1,1,1,0,1
zahlen,3,3,0,0,-1,0,1
schlagen,2,5,-3,-1,-1,0,1
bringen,3,3,0,0,1,0,1
führen,1,13,12,1,1,1,1
erhalten,2,2,0,0,1,0,1
wappnen,1,3,2,1,1,1,1
schrauben,6,3,-3,-1,1,0,1
veröffentlichen,15,3,12,1,-1,0,1
entsprechen,4,2,2,1,-1,0,1
bieten,6,3,3,1,-1,0,1
erhalten,2,4,-2,-1,-1,0,1
durchsuchen,13,5,8,1,-1,0,1
nutzen,6,6,0,0,1,0,1
übernehmen,12,3,9,1,-1,0,1
erzielen,2,4,-2,-1,-1,0,1
setzen,14,3,11,1,-1,0,1
erreichen,2,2,0,0,1,0,1
setzen,4,3,1,1,-1,0,1
verkaufen,5,4,-1,-1,1,0,1
präsentieren,6,3,3,1,-1,0,1
kaufen,1,2,1,1,1,1,1
werfen,2,4,2,1,1,0,1
präsentieren,3,7,-4,-1,-1,0,1
sorgen,2,2,0,0,1,0,1
kündigen,6,8,-2,-1,-1,0,1
erweitern,4,5,-1,-1,-1,0,1
beherrschen,3,4,-1,-1,-1,0,1
sorgen,2,3,-1,-1,-1,0,1
rechnen,7,2,5,1,-1,0,1
beherbergen,3,2,-1,-1,1,0,1
bieten,14,4,10,1,-1,0,1
beschäftigen,4,8,-4,-1,-1,0,1
verdoppeln,2,5,3,1,1,0,1
präsentieren,3,3,0,0,-1,0,1
korrigieren,10,2,-8,-1,1,0,1
rechnen,7,3,4,1,-1,0,1
drücken,2,13,11,1,1,0,1
fertigen,1,4,3,1,1,0,1
betragen,3,2,1,1,-1,0,1
teilen,4,3,-1,-1,1,0,1
bringen,4,3,-1,-1,1,0,1
erreichen,7,9,-2,-1,-1,0,1
verlangen,2,2,0,0,-1,0,1
kosten,2,7,-5,-1,-1,0,1
kündigen,10,3,7,1,-1,0,1
verkaufen,20,6,14,1,-1,0,1
spülen,2,3,1,1,1,0,1
speichern,1,4,3,1,1,0,1
liefern,6,4,2,1,-1,0,1
bieten,3,4,1,1,1,0,1
verlangen,3,7,-4,-1,-1,0,1
listen,2,6,4,1,1,0,1
zeigen,4,4,0,0,1,0,1
liefern,6,3,3,1,-1,0,1
bieten,6,5,1,1,-1,0,1
schlagen,2,4,-2,-1,-1,0,1
sehen,4,3,1,1,-1,0,1
greifen,1,2,-1,-1,-1,0,1
enthüllen,6,8,-2,-1,-1,0,1
beherrschen,2,4,-2,-1,-1,0,1
setzen,2,6,-4,-1,-1,0,1
lassen,1,6,5,1,1,1,1
gehören,8,3,5,1,-1,0,1
verstärken,5,4,-1,-1,1,0,1
tragen,3,6,-3,-1,-1,0,1
erwarten,5,7,2,1,1,0,1
bringen,2,3,1,1,1,0,1
präsentieren,11,3,8,1,-1,0,1
reichen,4,5,1,1,1,0,1
besitzen,4,9,-5,-1,-1,0,1
betreiben,7,9,-2,-1,-1,0,1
übernehmen,3,5,-2,-1,-1,0,1
liefern,1,3,2,1,1,0,1
verlangen,2,3,-1,-1,-1,0,1
bieten,3,2,1,1,-1,0,1
beginnen,1,3,-2,-1,-1,0,1
stufen,5,3,-2,-1,1,0,1
fordern,10,3,7,1,-1,0,1
stecken,1,2,1,1,1,0,1
stellen,2,2,0,0,-1,0,1
liefern,4,3,1,1,-1,0,1
einigen,10,3,7,1,-1,0,1
stehen,2,2,0,0,1,0,1
bauen,3,3,0,0,-1,0,1
handeln,1,9,8,1,1,0,1
erzielen,8,4,4,1,-1,0,1
bieten,6,3,3,1,-1,0,1
schlagen,2,4,-2,-1,-1,1,1
bewerben,1,8,7,1,1,0,1
bieten,6,3,3,1,-1,0,1
hängen,3,3,0,0,-1,0,1
bündeln,4,9,5,1,1,0,1
investieren,3,3,0,0,-1,0,1
räumen,2,7,5,1,1,0,1
liefern,3,16,13,1,1,0,1
ermöglichen,6,10,4,1,1,0,1
benötigen,4,5,-1,-1,-1,0,1
kosten,8,3,5,1,-1,0,1
befinden,1,2,1,1,1,0,1
befolgen,2,17,15,1,1,0,1
präsentieren,10,3,7,1,-1,0,1
erreichen,10,2,8,1,-1,0,1
tun,1,6,5,1,1,1,1
zerteilen,6,3,-3,-1,1,0,1
verklagen,1,8,7,1,1,0,1
verbinden,2,2,0,0,1,0,1
horten,2,4,2,1,1,0,1
schrecken,9,2,-7,-1,1,0,1
erwarten,3,2,1,1,-1,0,1
liefern,6,3,3,1,-1,0,1
unterstützen,5,2,3,1,-1,0,1
bieten,10,6,4,1,-1,0,1
räumen,2,4,2,1,1,0,1
fühlen,3,3,0,0,1,0,1
richten,1,2,1,1,1,1,1
zitieren,6,3,-3,-1,1,0,1
verdonnern,2,11,9,1,1,0,1
leiten,2,3,1,1,1,0,1
leiten,2,2,0,0,1,0,1
erwarten,4,3,-1,-1,1,0,1
bringen,5,3,-2,-1,1,0,1
setzen,2,4,-2,-1,-1,0,1
stecken,3,2,-1,-1,1,0,1
erhalten,2,4,-2,-1,-1,0,1
bieten,2,3,-1,-1,-1,0,1
bieten,2,4,-2,-1,-1,0,1
bekommen,2,7,5,1,1,0,1
setzen,2,9,7,1,1,0,1
gründen,3,4,1,1,1,0,1
verklagen,4,9,5,1,1,0,1
bieten,2,2,0,0,1,0,1
senken,2,5,3,1,1,0,1
handeln,1,14,13,1,1,1,1
verkünden,9,7,-2,-1,1,0,1
stellen,7,3,4,1,-1,0,1
bieten,5,4,1,1,-1,0,1
verbraten,3,6,-3,-1,-1,0,1
entwickeln,7,2,5,1,-1,0,1
erwarten,7,4,3,1,-1,0,1
finanzieren,2,3,1,1,1,0,1
geben,8,5,-3,-1,1,0,1
rufen,1,3,2,1,1,0,1
senken,4,2,2,1,-1,0,1
sehen,1,7,6,1,1,1,1
erwarten,2,3,1,1,1,0,1
richten,1,5,4,1,1,1,1
beziffern,2,7,5,1,1,0,1
kassieren,1,9,-8,-1,-1,0,1
warnen,2,2,0,0,1,0,1
halbieren,3,6,3,1,1,0,1
stellen,2,20,18,1,1,0,1
ernennen,9,5,-4,-1,1,0,1
verdonnern,6,8,2,1,1,0,1
stellen,7,2,5,1,-1,1,1
stellen,4,3,1,1,-1,0,1
erreichen,3,4,-1,-1,-1,0,1
tragen,2,3,1,1,1,0,1
bringen,6,3,-3,-1,1,0,1
machen,2,3,1,1,1,0,1
sorgen,4,3,1,1,-1,0,1
erzielen,3,3,0,0,-1,0,1
rechnen,10,4,6,1,-1,0,1
bringen,5,2,-3,-1,1,0,1
kündigen,2,8,6,1,1,0,1
planen,6,2,4,1,-1,0,1
erwarten,8,4,4,1,-1,0,1
schließen,11,4,7,1,-1,0,1
berechnen,8,3,5,1,-1,0,1
kosten,3,3,0,0,-1,0,1
verklagen,6,5,-1,-1,1,0,1
nutzen,1,7,6,1,1,1,1
setzen,2,2,0,0,1,0,1
reduzieren,2,15,13,1,1,0,1
verklagen,2,2,0,0,1,0,1
führen,5,3,2,1,-1,0,1
finden,3,8,-5,-1,-1,0,1
betragen,2,5,-3,-1,-1,0,1
passen,2,4,2,1,1,0,1
bleiben,2,2,0,0,1,0,1
verlassen,1,4,3,1,1,0,1
bestehen,14,2,12,1,-1,0,1
erhoffen,4,22,18,1,1,0,1
steigern,5,2,-3,-1,1,0,1
bringen,9,2,-7,-1,1,1,1
stellen,5,2,3,1,-1,0,1
lassen,6,2,4,1,-1,0,1
beleben,1,7,6,1,1,0,1
fertigen,14,3,11,1,-1,0,1
bauen,3,12,9,1,1,0,1
stürzen,1,3,2,1,1,0,1
fangen,4,3,1,1,-1,0,1
nennen,7,5,2,1,-1,0,1
erwarten,5,3,2,1,-1,0,1
kosten,3,9,-6,-1,-1,0,1
besitzen,1,2,1,1,1,0,1
lösen,4,5,-1,-1,-1,0,1
nehmen,5,4,1,1,-1,0,1
erwarten,9,2,7,1,-1,0,1
nehmen,2,4,-2,-1,-1,0,1
melden,6,7,-1,-1,-1,0,1
steigern,2,3,1,1,1,0,1
eröffnen,12,4,8,1,-1,0,1
erzielen,1,2,1,1,1,0,1
sortieren,5,4,-1,-1,1,0,1
gehen,17,2,15,1,-1,0,1
liefern,3,11,-8,-1,-1,0,1
betragen,2,12,10,1,1,0,1
vereinen,6,3,-3,-1,1,0,1
entwickeln,8,2,6,1,-1,0,1
heben,9,2,7,1,-1,0,1
kaufen,2,2,0,0,-1,0,1
sorgen,7,2,5,1,-1,0,1
treffen,2,5,3,1,1,0,1
erreichen,2,13,11,1,1,0,1
prognostizieren,7,4,-3,-1,1,0,1
übernehmen,8,5,-3,-1,1,0,1
erwarten,3,6,3,1,1,0,1
bezeichnen,9,6,3,1,-1,0,1
liefern,1,4,3,1,1,0,1
erwarten,2,4,2,1,1,0,1
kosten,3,3,0,0,-1,0,1
nutzen,5,7,-2,-1,-1,0,1
betragen,14,3,11,1,-1,0,1
schaffen,2,2,0,0,1,0,1
sichern,4,4,0,0,-1,0,1
planen,6,7,-1,-1,-1,0,1
verdienen,2,8,6,1,1,0,1
treiben,8,2,-6,-1,1,0,1
schließen,1,21,20,1,1,0,1
berappen,5,2,-3,-1,1,0,1
erwarten,10,4,6,1,-1,0,1
erfahren,2,3,1,1,1,0,1
stampfen,2,3,1,1,1,0,1
investieren,3,2,-1,-1,1,0,1
präsentieren,8,3,5,1,-1,0,1
einigen,15,11,4,1,-1,0,1
bringen,1,9,8,1,1,0,1
benötigen,5,4,1,1,-1,0,1
präsentieren,4,7,-3,-1,-1,0,1
erwarten,6,2,4,1,-1,0,1
bieten,1,18,17,1,1,0,1
verlegen,2,4,2,1,1,0,1
handeln,1,14,13,1,1,1,1
fertigen,2,2,0,0,1,0,1
verwandeln,2,4,2,1,1,0,1
planen,12,4,8,1,-1,0,1
sparen,3,3,0,0,-1,0,1
besitzen,10,2,8,1,-1,0,1
belaufen,1,4,3,1,1,1,1
verkaufen,3,3,0,0,-1,0,1
stellen,5,2,3,1,-1,0,1
erwarten,10,4,6,1,-1,0,1
fördern,4,5,1,1,1,0,1
fördern,4,3,1,1,-1,0,1
sichern,8,15,-7,-1,-1,0,1
planen,2,4,-2,-1,-1,0,1
erwarten,7,3,4,1,-1,0,1
versprechen,4,4,0,0,-1,0,1
stellen,5,2,3,1,-1,0,1
sehen,3,4,1,1,1,0,1
kaufen,4,4,0,0,1,0,1
erwarten,8,4,4,1,-1,0,1
gehen,7,4,3,1,-1,0,1
teilen,6,4,-2,-1,1,0,1
lassen,4,3,1,1,-1,0,1
zeigen,5,3,2,1,-1,0,1
starten,3,4,1,1,1,0,1
kündigen,6,3,-3,-1,1,0,1
erwarten,8,2,6,1,-1,0,1
betragen,2,3,1,1,1,0,1
kosten,5,7,-2,-1,-1,0,1
erlauben,11,4,-7,-1,1,0,1
nehmen,4,4,0,0,-1,0,1
melden,5,3,2,1,-1,0,1
verkaufen,1,3,2,1,1,1,1
führen,3,17,14,1,1,0,1
dämpfen,2,3,-1,-1,-1,0,1
investieren,4,3,-1,-1,1,0,1
besitzen,4,7,-3,-1,-1,0,1
lassen,6,3,3,1,-1,0,1
führen,7,5,2,1,-1,0,1
benötigen,4,4,0,0,-1,0,1
geben,6,7,-1,-1,-1,0,1
bestehen,5,2,3,1,-1,0,1
bieten,7,8,-1,-1,-1,0,1
betragen,2,3,-1,-1,-1,0,1
betragen,4,2,2,1,-1,0,1
handeln,1,8,7,1,1,1,1
beziehen,1,2,1,1,1,0,1
bedeuten,2,8,6,1,1,0,1
erwarten,6,3,3,1,-1,0,1
ziehen,7,2,-5,-1,1,-1,1
betragen,19,3,16,1,-1,0,1
setzen,4,3,1,1,-1,0,1
ziehen,3,3,0,0,-1,0,1
werten,2,4,2,1,1,0,1
-,1,2,1,1,1,1,1
schließen,4,3,-1,-1,1,0,1
bieten,14,5,-9,-1,1,0,1
listen,12,4,8,1,-1,0,1
bereiten,1,6,5,1,1,1,1
geben,1,4,3,1,1,0,1
wechseln,2,4,-2,-1,-1,0,1
zeigen,2,7,-5,-1,-1,0,1
fördern,4,4,0,0,1,0,1
bauen,3,5,-2,-1,-1,0,1
bieten,11,2,9,1,-1,0,1
liefern,2,5,3,1,1,0,1
zeigen,8,3,5,1,-1,0,1
zeigen,14,3,11,1,-1,0,1
verzögern,4,3,-1,-1,1,0,1
verbraten,5,4,1,1,-1,0,1
geben,2,3,1,1,1,0,1
setzen,2,3,-1,-1,-1,0,1
setzen,4,8,-4,-1,-1,0,1
gehen,3,5,2,1,1,0,1
geben,10,3,-7,-1,1,0,1
betragen,3,3,0,0,-1,0,1
melden,4,4,0,0,-1,0,1
stellen,13,7,6,1,-1,0,1
stellen,6,2,-4,-1,1,0,1
erwarten,3,5,-2,-1,-1,0,1
stellen,8,4,4,1,-1,0,1
erreichen,8,4,4,1,-1,0,1
berichten,3,3,0,0,-1,0,1
stecken,1,2,1,1,1,0,1
geben,7,2,5,1,-1,0,1
erwarten,2,3,-1,-1,-1,0,1
geben,6,8,-2,-1,-1,0,1
stellen,1,3,2,1,1,0,1
entwickeln,9,8,1,1,-1,0,1
übertragen,2,4,2,1,1,0,1
verbessern,2,2,0,0,-1,0,1
zeigen,6,5,-1,-1,1,0,1
mehren,1,4,3,1,1,1,1
stellen,5,3,2,1,-1,0,1
fertigen,7,2,-5,-1,1,0,1
kaufen,4,6,-2,-1,-1,0,1
übernehmen,7,4,3,1,-1,0,1
machen,7,3,4,1,-1,0,1
fertigen,3,2,1,1,-1,0,1
fertigen,1,2,1,1,1,0,1
belegen,2,3,-1,-1,-1,0,1
reißen,2,3,1,1,1,0,1
gehen,2,2,0,0,-1,0,1
setzen,4,3,1,1,-1,0,1
kühlen,1,2,1,1,1,1,1
spiegeln,1,6,5,1,1,1,1
verlieren,3,5,-2,-1,-1,0,1
erweitern,5,5,0,0,1,0,1
bauen,1,4,-3,-1,-1,0,1
beklagen,5,3,2,1,-1,0,1
erreichen,10,3,7,1,-1,0,1
erwarten,13,8,-5,-1,1,0,1
erwarten,6,3,3,1,-1,0,1
beruhen,3,3,0,0,-1,0,1
lassen,2,4,2,1,1,0,1
führen,6,4,2,1,-1,0,1
fassen,7,3,-4,-1,1,0,1
stellen,7,4,3,1,-1,0,1
setzen,3,2,1,1,-1,0,1
binden,2,3,1,1,1,0,1
benötigen,15,3,12,1,-1,0,1
nennen,2,5,3,1,1,0,1
verbessern,1,7,6,1,1,1,1
melden,7,6,1,1,-1,0,1
zeigen,1,7,6,1,1,1,1
erbringen,7,2,5,1,-1,0,1
verkaufen,1,3,2,1,1,0,1
kühlen,1,6,5,1,1,0,1
stellen,3,3,0,0,1,0,1
sparen,5,2,3,1,-1,0,1
setzen,6,3,3,1,-1,0,1
erreichen,9,7,2,1,-1,0,1
verwandeln,2,2,0,0,1,0,1
melden,12,2,10,1,-1,0,1
benötigen,2,9,-7,-1,-1,0,1
zeigen,11,3,8,1,-1,0,1
fertigen,1,5,4,1,1,1,1
benötigen,3,2,1,1,-1,0,1
veröffentlichen,6,3,3,1,-1,0,1
modulieren,3,5,-2,-1,-1,0,1
zeigen,6,3,3,1,-1,0,1
bieten,10,4,6,1,-1,0,1
bieten,6,2,4,1,-1,0,1
bestehen,3,20,17,1,1,0,1
vertreiben,1,2,1,1,1,0,1
gewähren,13,2,11,1,-1,0,1
ebnen,6,3,3,1,-1,0,1
ziehen,7,3,4,1,-1,0,1
erwarten,6,4,2,1,-1,0,1
kaufen,2,5,-3,-1,-1,0,1
setzen,2,2,0,0,-1,0,1
setzen,4,2,2,1,-1,0,1
sorgen,2,4,-2,-1,-1,0,1
geben,12,2,10,1,-1,0,1
bringen,3,3,0,0,1,0,1
fahren,3,5,2,1,1,0,1
holen,5,3,-2,-1,1,0,1
prognostizieren,6,8,2,1,1,0,1
kosten,3,2,1,1,-1,0,1
integrieren,5,3,-2,-1,1,0,1
reduzieren,2,3,1,1,1,0,1
übernehmen,2,2,0,0,1,0,1
beschäftigen,4,3,1,1,-1,0,1
setzen,4,3,1,1,-1,0,1
entwickeln,11,11,0,0,-1,0,1
halten,4,3,1,1,-1,0,1
reagieren,6,5,-1,-1,1,0,1
geben,5,3,-2,-1,1,0,1
speichern,4,4,0,0,1,0,1
liefern,10,4,6,1,-1,0,1
verklagen,1,2,1,1,1,0,1
halten,7,2,5,1,-1,0,1
geben,3,3,0,0,-1,0,1
zeichnen,1,4,3,1,1,1,1
entziehen,2,10,8,1,1,0,1
reagieren,3,11,8,1,1,0,1
kaufen,5,2,-3,-1,1,0,1
erwarten,10,9,1,1,-1,0,1
erwarten,9,4,5,1,-1,0,1
führen,1,12,11,1,1,1,1
reichen,8,5,3,1,-1,0,1
führen,2,30,28,1,1,0,1
suchen,1,3,2,1,1,0,1
planen,6,4,2,1,-1,0,1
schreiben,1,2,-1,-1,-1,0,1
bieten,2,3,1,1,1,0,1
handeln,1,8,7,1,1,1,1
kosten,3,2,1,1,-1,0,1
geben,9,3,6,1,-1,0,1
bieten,8,7,1,1,-1,0,1
ermöglichen,2,3,-1,-1,-1,0,1
verpacken,1,10,9,1,1,1,1
entsprechen,9,2,7,1,-1,0,1
sorgen,19,3,16,1,-1,0,1
betragen,2,2,0,0,1,0,1
erwarten,11,7,4,1,-1,0,1
erwirtschaften,2,5,3,1,1,0,1
verklagen,1,6,5,1,1,0,1
belaufen,1,5,4,1,1,1,1
führen,4,3,-1,-1,1,0,1
liefern,7,3,4,1,-1,0,1
korrigieren,6,2,-4,-1,1,0,1
bewerten,4,5,1,1,1,0,1
bestreiten,7,3,4,1,-1,0,1
wickeln,9,3,6,1,-1,0,1
handeln,1,18,17,1,1,1,1
versprechen,8,2,6,1,-1,1,1
zeigen,8,9,-1,-1,-1,0,1
bieten,7,3,4,1,-1,0,1
portieren,1,2,1,1,1,0,1
bieten,2,4,-2,-1,-1,0,1
finden,1,11,-10,-1,-1,0,1
weisen,8,3,5,1,-1,0,1
finden,13,3,10,1,-1,0,1
finden,1,3,-2,-1,-1,0,1
lizenzieren,1,2,1,1,1,0,1
erstellen,4,2,-2,-1,1,0,1
erreichen,2,5,-3,-1,-1,0,1
halten,1,5,4,1,1,1,1
unterscheiden,2,13,11,1,1,0,1
liefern,12,3,9,1,-1,0,1
unterstützen,2,6,-4,-1,-1,0,1
messen,14,11,-3,-1,1,0,1
bringen,1,3,2,1,1,1,1
verlangen,7,2,5,1,-1,0,1
stellen,3,2,1,1,-1,0,1
führen,6,8,2,1,1,0,1
stehen,7,5,2,1,-1,0,1
erlauben,13,10,3,1,-1,0,1
stellen,3,3,0,0,-1,0,1
bieten,2,4,2,1,1,0,1
favorisieren,2,4,-2,-1,-1,0,1
enthalten,25,12,13,1,-1,0,1
benötigen,20,6,14,1,-1,0,1
entwickeln,2,5,3,1,1,0,1
denken,3,3,0,0,-1,0,1
setzen,10,4,6,1,-1,0,1
erreichen,6,3,3,1,-1,0,1
lesen,1,2,1,1,1,0,1
versprechen,10,8,2,1,-1,0,1
versprechen,21,2,19,1,-1,0,1
speichern,3,4,1,1,1,0,1
präsentieren,4,3,-1,-1,1,0,1
bemängeln,20,3,17,1,-1,0,1
erwarten,3,4,-1,-1,-1,0,1
zeigen,10,3,7,1,-1,0,1
teilen,5,4,1,1,-1,0,1
wiegen,3,2,1,1,-1,0,1
erlauben,1,3,2,1,1,0,1
wenden,1,13,12,1,1,1,1
liefern,1,33,32,1,1,0,1
erreichen,8,2,6,1,-1,0,1
bringen,5,3,-2,-1,1,0,1
entsprechen,2,2,0,0,1,0,1
nehmen,2,3,1,1,1,0,1
beanspruchen,3,4,1,1,1,0,1
tauschen,2,6,4,1,1,0,1
setzen,5,2,3,1,-1,0,1
präsentieren,10,7,3,1,-1,0,1
erweitern,2,5,3,1,1,0,1
gestehen,5,4,1,1,-1,0,1
verzeichnen,3,3,0,0,1,0,1
ermöglichen,8,7,1,1,-1,0,1
erreichen,3,3,0,0,-1,0,1
wirken,1,16,15,1,1,1,1
brechen,7,3,4,1,-1,0,1
kennen,2,5,3,1,1,0,1
stecken,8,5,-3,-1,1,0,1
legen,3,4,-1,-1,-1,0,1
bieten,7,4,3,1,-1,0,1
kündigen,3,4,-1,-1,-1,0,1
beschränken,2,2,0,0,-1,0,1
sorgen,11,5,6,1,-1,0,1
liefern,4,3,1,1,-1,0,1
stellen,1,2,1,1,1,1,1
erhalten,10,3,7,1,-1,0,1
bringen,1,3,2,1,1,0,1
betragen,2,11,-9,-1,-1,0,1
speichern,5,5,0,0,-1,0,1
lernen,4,10,6,1,1,0,1
erreichen,7,5,2,1,-1,0,1
gehören,1,3,-2,-1,-1,0,1
bieten,10,9,1,1,-1,0,1
überstehen,2,2,0,0,1,0,1
sagen,2,2,0,0,-1,0,1
betragen,2,4,-2,-1,-1,0,1
bieten,5,3,2,1,-1,0,1
zählen,2,2,0,0,-1,0,1
bestätigen,13,2,11,1,-1,0,1
präsentieren,1,3,2,1,1,1,1
verlieren,1,6,5,1,1,0,1
richten,1,5,4,1,1,1,1
reagieren,7,11,-4,-1,-1,0,1
geben,2,3,-1,-1,-1,0,1
weisen,6,2,4,1,-1,0,1
kündigen,5,2,3,1,-1,0,1
rechnen,3,3,0,0,-1,0,1
kaufen,1,2,1,1,1,1,1
unterzeichnen,3,2,1,1,-1,0,1
bieten,3,5,2,1,1,0,1
präsentieren,5,2,-3,-1,1,0,1
beantworten,13,2,11,1,-1,0,1
wandeln,2,2,0,0,1,0,1
kündigen,3,8,-5,-1,-1,0,1
erwarten,8,2,6,1,-1,0,1
fordern,5,2,3,1,-1,0,1
üben,2,2,0,0,-1,0,1
halten,18,6,12,1,-1,0,1
stellen,3,2,1,1,-1,0,1
fordern,3,13,10,1,1,0,1
zeigen,3,3,0,0,-1,0,1
geben,7,4,3,1,-1,0,1
gelingen,1,2,1,1,1,1,1
verweisen,7,3,4,1,-1,0,1
halten,1,3,2,1,1,0,1
geben,2,5,-3,-1,-1,0,1
sprechen,1,3,2,1,1,1,1
werfen,5,3,-2,-1,1,0,1
stärken,2,6,4,1,1,0,1
betragen,3,2,1,1,-1,0,1
stärken,2,3,1,1,1,0,1
übernehmen,10,3,7,1,-1,0,1
erklären,1,4,3,1,1,1,1
bestätigen,5,2,3,1,-1,0,1
lassen,1,3,-2,-1,-1,0,1
erlassen,5,3,2,1,-1,0,1
übernehmen,3,4,-1,-1,-1,0,1
erwarten,10,4,6,1,-1,0,1
brauchen,3,2,1,1,-1,0,1
zeichnen,1,3,2,1,1,1,1
ermöglichen,4,2,2,1,-1,0,1
stellen,3,5,-2,-1,-1,0,1
kündigen,2,12,10,1,1,0,1
sagen,2,3,-1,-1,-1,0,1
betrachten,2,4,2,1,1,0,1
werfen,5,3,-2,-1,1,0,1
bescheren,6,7,-1,-1,-1,-1,1
sehen,2,3,-1,-1,-1,0,1
heißen,6,4,2,1,-1,0,1
stellen,5,2,3,1,-1,0,1
melden,17,4,13,1,-1,0,1
schließen,6,3,3,1,-1,0,1
bieten,5,2,3,1,-1,0,1
feiern,1,7,-6,-1,-1,0,1
greifen,5,3,-2,-1,1,0,1
verkörpern,5,4,-1,-1,1,0,1
gründen,14,5,9,1,-1,0,1
präsentieren,9,13,-4,-1,-1,0,1
bringen,3,4,1,1,1,0,1
fordern,2,3,1,1,1,0,1
eröffnen,7,3,4,1,-1,0,1
verbauen,5,3,2,1,-1,0,1
beziehen,1,3,2,1,1,0,1
erwarten,2,2,0,0,1,0,1
erleben,9,3,6,1,-1,0,1
zeigen,3,2,1,1,-1,0,1
bieten,3,4,-1,-1,-1,0,1
richten,1,12,11,1,1,1,1
erwarten,10,3,7,1,-1,0,1
geben,6,3,3,1,-1,0,1
investieren,3,4,1,1,1,0,1
gehören,6,3,3,1,-1,0,1
machen,8,3,5,1,-1,0,1
sagen,3,2,-1,-1,1,0,1
nutzen,1,3,2,1,1,1,1
stehen,4,2,-2,-1,1,0,1
bieten,9,2,-7,-1,1,0,1
geben,4,3,-1,-1,1,0,1
nutzen,2,5,-3,-1,-1,0,1
rufen,4,3,1,1,-1,0,1
fordern,1,7,-6,-1,-1,0,1
handeln,1,12,11,1,1,1,1
nehmen,7,2,-5,-1,1,0,1
nennen,2,12,10,1,1,0,1
tauschen,2,4,2,1,1,0,1
richten,1,12,11,1,1,1,1
stellen,3,2,1,1,-1,1,1
erwarten,3,3,0,0,1,0,1
verarbeiten,2,3,1,1,1,0,1
überraschen,2,7,5,1,1,0,1
weisen,20,3,17,1,-1,0,1
erreichen,5,2,3,1,-1,0,1
erreichen,3,2,1,1,-1,0,1
fordern,7,8,-1,-1,-1,0,1
ermöglichen,10,2,8,1,-1,0,1
überholen,1,2,1,1,1,0,1
fassen,9,3,-6,-1,1,0,1
formatieren,2,2,0,0,-1,1,1
fahren,2,7,-5,-1,-1,0,1
zeigen,2,6,4,1,1,0,1
würzen,6,7,1,1,1,0,1
rechnen,11,3,8,1,-1,0,1
zahlen,4,3,-1,-1,1,0,1
versorgen,2,12,10,1,1,0,1
ergänzen,3,5,2,1,1,0,1
packen,7,4,-3,-1,1,0,1
machen,2,4,-2,-1,-1,0,1
verteilen,2,6,4,1,1,0,1
senken,2,4,-2,-1,-1,0,1
streben,8,8,0,0,-1,0,1
stützen,24,2,22,1,-1,0,1
kündigen,7,3,4,1,-1,0,1
bestätigen,7,2,5,1,-1,0,1
bieten,3,2,-1,-1,1,0,1
befragen,2,6,4,1,1,0,1
diskutieren,9,5,4,1,-1,0,1
verbinden,2,4,2,1,1,0,1
montieren,1,2,1,1,1,0,1
setzen,2,2,0,0,1,0,1
behindern,6,5,1,1,-1,0,1
versetzen,2,7,5,1,1,0,1
bringen,7,2,5,1,-1,-1,1
betreiben,2,6,4,1,1,0,1
betreffen,19,9,10,1,-1,0,1
planen,7,5,2,1,-1,0,1
treiben,2,6,4,1,1,0,1
beziffern,5,4,-1,-1,1,0,1
reduzieren,5,17,12,1,1,0,1
kündigen,5,2,3,1,-1,0,1
bieten,10,4,6,1,-1,0,1
kassieren,5,3,2,1,-1,0,1
gehen,32,3,29,1,-1,0,1
sehen,7,2,5,1,-1,1,1
vermitteln,4,8,4,1,1,0,1
codieren,2,11,9,1,1,0,1
spielen,3,8,-5,-1,-1,0,1
suchen,13,2,11,1,-1,0,1
ergänzen,2,3,1,1,1,0,1
zählen,3,3,0,0,-1,0,1
erzielen,6,5,1,1,-1,0,1
erlösen,4,7,-3,-1,-1,0,1
malen,6,4,-2,-1,1,0,1
stehen,3,2,-1,-1,1,0,1
sehen,2,3,-1,-1,-1,0,1
gehören,10,2,8,1,-1,0,1
handeln,1,8,7,1,1,1,1
handeln,1,5,4,1,1,1,1
bieten,4,2,2,1,-1,0,1
fördern,2,5,3,1,1,0,1
ziehen,4,3,1,1,-1,0,1
unterstellen,2,2,0,0,-1,0,1
versprechen,12,3,9,1,-1,0,1
entsprechen,7,2,5,1,-1,0,1
geraten,2,4,-2,-1,-1,0,1
nehmen,2,3,1,1,1,0,1
bilden,2,3,-1,-1,-1,0,1
erhalten,2,2,0,0,1,0,1
integrieren,1,2,1,1,1,0,1
halten,2,4,-2,-1,-1,0,1
schätzen,5,5,0,0,1,0,1
verkünden,4,2,2,1,-1,0,1
schreiben,5,3,2,1,-1,0,1
zeigen,2,2,0,0,1,0,1
tun,1,2,1,1,1,0,1
stellen,4,2,-2,-1,1,0,1
finden,1,6,5,1,1,1,1
gründen,4,8,-4,-1,-1,0,1
stellen,10,5,5,1,-1,0,1
erregen,1,3,2,1,1,0,1
nutzen,4,3,-1,-1,1,0,1
erhoffen,3,5,-2,-1,-1,0,1
überraschen,2,6,4,1,1,0,1
drucken,5,8,3,1,1,0,1
führen,2,3,-1,-1,-1,0,1
geben,1,2,1,1,1,0,1
bestätigen,1,15,14,1,1,1,1
überflügeln,2,6,4,1,1,0,1
investieren,4,4,0,0,1,0,1
erklären,3,2,-1,-1,1,0,1
sagen,4,7,3,1,1,0,1
weisen,10,3,7,1,-1,0,1
nutzen,14,4,10,1,-1,0,1
finden,3,4,-1,-1,-1,0,1
korrigieren,3,2,-1,-1,1,0,1
deuten,1,2,-1,-1,-1,0,1
untersuchen,2,3,-1,-1,-1,0,1
kosten,9,2,7,1,-1,0,1
nehmen,1,2,1,1,1,0,1
nehmen,2,5,-3,-1,-1,0,1
besitzen,2,3,-1,-1,-1,0,1
planen,4,10,-6,-1,-1,0,1
veröffentlichen,9,2,7,1,-1,0,1
benötigen,3,5,2,1,1,0,1
machen,1,2,1,1,1,1,1
benötigen,3,8,-5,-1,-1,0,1
bedeuten,2,9,-7,-1,-1,0,1
verhängen,3,2,-1,-1,1,0,1
zeigen,5,6,1,1,1,0,1
lassen,3,3,0,0,-1,0,1
erklären,2,23,21,1,1,0,1
bieten,4,3,1,1,-1,0,1
rechnen,3,4,-1,-1,-1,0,1
zitieren,5,3,-2,-1,1,0,1
lenken,3,3,0,0,1,0,1
melden,7,4,3,1,-1,0,1
belaufen,1,4,3,1,1,1,1
prognostizieren,7,3,4,1,-1,0,1
kündigen,14,3,11,1,-1,0,1
drängen,1,8,7,1,1,1,1
kosten,2,5,-3,-1,-1,0,1
zeichnen,1,3,2,1,1,1,1
berichten,1,3,2,1,1,0,1
entsprechen,5,2,3,1,-1,0,1
erwarten,9,5,4,1,-1,0,1
fordern,4,2,-2,-1,1,0,1
führen,4,8,-4,-1,-1,0,1
sehen,12,3,9,1,-1,0,1
gewinnen,4,2,-2,-1,1,-1,1
reklamieren,7,6,1,1,-1,0,1
verärgern,3,2,-1,-1,1,0,1
handeln,1,14,13,1,1,1,1
suchen,6,2,4,1,-1,0,1
suchen,3,2,-1,-1,1,0,1
steigern,2,2,0,0,-1,0,1
führen,3,11,-8,-1,-1,0,1
versichern,2,6,4,1,1,0,1
wechseln,3,3,0,0,-1,0,1
setzen,9,3,6,1,-1,0,1
geben,4,2,-2,-1,1,0,1
schaffen,1,8,7,1,1,1,1
gehören,11,8,3,1,-1,0,1
widmen,8,2,6,1,-1,1,1
würdigen,6,2,4,1,-1,0,1
verfügen,4,4,0,0,-1,0,1
machen,2,2,0,0,-1,0,1
mangeln,3,8,5,1,1,0,1
sehen,1,2,1,1,1,1,1
bauen,5,13,-8,-1,-1,0,1
stellen,6,2,-4,-1,1,0,1
planen,11,3,8,1,-1,0,1
zahlen,8,2,6,1,-1,0,1
verzeichnen,1,10,-9,-1,-1,0,1
investieren,10,3,7,1,-1,0,1
häufen,1,3,2,1,1,1,1
präzisieren,2,24,22,1,1,0,1
vertreiben,4,2,-2,-1,1,0,1
sehen,2,3,1,1,1,0,1
lösen,8,4,-4,-1,1,0,1
bieten,11,7,4,1,-1,0,1
erkennen,3,5,2,1,1,0,1
richten,1,10,9,1,1,1,1
lassen,1,3,2,1,1,1,1
widersprechen,6,2,4,1,-1,0,1
geben,9,2,7,1,-1,1,1
liefern,1,3,2,1,1,0,1
planen,9,4,5,1,-1,0,1
verhandeln,11,2,9,1,-1,0,1
zahlen,3,2,-1,-1,1,0,1
erhoffen,4,3,1,1,-1,-1,1
dementieren,2,2,0,0,-1,0,1
erhalten,7,4,3,1,-1,0,1
kaufen,1,3,2,1,1,1,1
kaufen,5,3,2,1,-1,0,1
finden,2,3,-1,-1,-1,0,1
belaufen,1,8,7,1,1,1,1
übertreffen,4,3,-1,-1,1,0,1
sehen,8,3,-5,-1,1,0,1
sehen,6,11,5,1,1,0,1
machen,5,2,3,1,-1,0,1
prognostizieren,21,4,17,1,-1,0,1
legen,2,4,-2,-1,-1,0,1
einigen,8,2,6,1,-1,0,1
versprechen,7,4,3,1,-1,0,1
hoffen,9,3,6,1,-1,0,1
zitieren,7,3,-4,-1,1,0,1
kündigen,5,4,1,1,-1,0,1
beginnen,17,6,11,1,-1,0,1
übertreffen,12,3,-9,-1,1,0,1
werfen,1,4,3,1,1,0,1
vergleichen,5,9,4,1,1,0,1
kaufen,1,4,3,1,1,0,1
handeln,1,9,8,1,1,1,1
führen,2,4,-2,-1,-1,0,1
sagen,2,2,0,0,1,0,1
setzen,4,3,1,1,-1,0,1
enthalten,16,3,13,1,-1,0,1
übertreffen,4,3,-1,-1,1,0,1
zeigen,5,4,1,1,-1,0,1
gehen,2,2,0,0,1,0,1
sprechen,1,4,-3,-1,-1,0,1
führen,7,6,1,1,-1,0,1
erwarten,12,10,2,1,-1,0,1
bedeuten,2,22,20,1,1,0,1
bestehen,3,2,1,1,-1,0,1
verbinden,7,4,3,1,-1,0,1
machen,4,2,2,1,-1,1,1
versorgen,1,6,5,1,1,0,1
senden,5,5,0,0,1,0,1
setzen,2,2,0,0,1,0,1
kündigen,7,5,2,1,-1,0,1
erweitern,2,8,6,1,1,0,1
erhalten,10,3,7,1,-1,0,1
erwarten,7,3,4,1,-1,0,1
fahren,6,7,-1,-1,-1,0,1
verzeichnen,7,3,4,1,-1,0,1
erpressen,1,2,1,1,1,0,1
erwarten,4,2,2,1,-1,0,1
sorgen,5,2,3,1,-1,0,1
unterschreiten,5,3,2,1,-1,0,1
machen,2,2,0,0,-1,0,1
treiben,3,2,-1,-1,1,0,1
bestätigen,2,2,0,0,-1,0,1
handeln,1,2,1,1,1,1,1
enttäuschen,2,5,3,1,1,0,1
erwarten,3,4,-1,-1,-1,0,1
liefern,2,5,3,1,1,0,1
brechen,2,2,0,0,1,0,1
entwickeln,7,4,3,1,-1,0,1
nutzen,3,3,0,0,1,0,1
werfen,1,6,5,1,1,0,1
sitzen,2,2,0,0,1,0,1
kritisieren,4,7,-3,-1,-1,0,1
stecken,2,3,1,1,1,0,1
bieten,5,2,3,1,-1,1,1
streben,2,2,0,0,-1,0,1
stellen,2,4,-2,-1,-1,0,1
hoffen,3,3,0,0,-1,0,1
erweitern,2,3,1,1,1,0,1
schließen,4,7,3,1,1,0,1
führen,3,3,0,0,-1,0,1
erwarten,6,7,-1,-1,-1,0,1
stellen,3,2,-1,-1,1,0,1
stoßen,2,4,-2,-1,-1,0,1
repräsentieren,5,2,3,1,-1,0,1
relativieren,3,4,-1,-1,-1,0,1
halten,10,4,6,1,-1,0,1
werfen,2,3,1,1,1,0,1
testen,17,3,-14,-1,1,0,1
erwarten,3,3,0,0,-1,0,1
zitieren,9,12,3,1,1,0,1
zeigen,2,3,1,1,1,0,1
ermitteln,4,14,10,1,1,0,1
glauben,5,3,2,1,-1,0,1
richten,1,6,5,1,1,1,1
drohen,1,2,1,1,1,1,1
bringen,4,2,-2,-1,1,0,1
ziehen,4,2,-2,-1,1,-1,1
umfassen,12,5,7,1,-1,0,1
bieten,12,4,8,1,-1,0,1
prüfen,2,2,0,0,-1,0,1
führen,6,2,4,1,-1,0,1
nehmen,2,5,-3,-1,-1,0,1
geben,2,2,0,0,1,0,1
präsentieren,2,2,0,0,-1,1,1
melden,12,5,7,1,-1,0,1
bewerten,3,2,1,1,-1,1,1
führen,3,6,3,1,1,0,1
setzen,5,6,-1,-1,-1,0,1
fühlen,1,2,1,1,1,1,1
bestätigen,18,2,16,1,-1,0,1
melden,12,2,10,1,-1,0,1
handeln,1,5,4,1,1,1,1
legen,2,4,2,1,1,0,1
kündigen,6,2,4,1,-1,0,1
zeichnen,1,9,8,1,1,1,1
stellen,5,7,-2,-1,-1,0,1
erreichen,12,3,-9,-1,1,-1,1
bieten,6,5,1,1,-1,0,1
befürchten,4,12,-8,-1,-1,0,1
erhoffen,10,4,6,1,-1,0,1
bestätigen,10,2,8,1,-1,0,1
schließen,10,3,-7,-1,1,0,1
bereiten,5,10,-5,-1,-1,0,1
finden,4,2,-2,-1,1,0,1
melden,3,4,-1,-1,-1,0,1
geben,2,9,-7,-1,-1,0,1
versuchen,2,2,0,0,-1,0,1
präsentieren,7,4,-3,-1,1,0,1
beschreiben,2,3,1,1,1,0,1
schließen,1,4,3,1,1,1,1
geben,2,4,-2,-1,-1,0,1
verfügen,11,2,9,1,-1,1,1
geben,3,3,0,0,-1,0,1
machen,2,4,-2,-1,-1,0,1
verlieren,2,2,0,0,1,0,1
bestätigen,10,2,8,1,-1,0,1
handeln,1,7,6,1,1,1,1
sagen,2,2,0,0,-1,0,1
offenbaren,2,2,0,0,-1,0,1
verlangen,8,2,6,1,-1,1,1
verfügen,3,6,-3,-1,-1,0,1
belaufen,1,9,8,1,1,1,1
verfügen,4,6,-2,-1,-1,0,1
prüfen,12,3,9,1,-1,0,1
verfügen,3,2,1,1,-1,0,1
schicken,1,2,1,1,1,0,1
nutzen,4,8,4,1,1,0,1
verstecken,10,4,6,1,-1,0,1
laden,3,4,1,1,1,0,1
schicken,1,5,4,1,1,1,1
bringen,1,4,3,1,1,0,1
bestätigen,6,2,4,1,-1,0,1
ziehen,2,3,1,1,1,0,1
zitieren,2,3,1,1,1,0,1
übertreffen,3,5,2,1,1,1,1
versprechen,2,6,4,1,1,0,1
richten,1,12,11,1,1,1,1
feiern,6,3,3,1,-1,0,1
zeigen,2,3,-1,-1,-1,0,1
melden,7,7,0,0,1,0,1
halten,7,3,-4,-1,1,0,1
nehmen,3,3,0,0,1,0,1
verbuchen,8,6,2,1,-1,0,1
erwarten,6,4,2,1,-1,0,1
melden,11,4,7,1,-1,0,1
regeln,1,4,3,1,1,1,1
liefern,1,12,11,1,1,0,1
versprechen,17,3,14,1,-1,0,1
legen,5,2,-3,-1,1,0,1
hören,1,3,2,1,1,1,1
wenden,1,5,4,1,1,1,1
stellen,4,22,-18,-1,-1,0,1
weisen,5,5,0,0,-1,0,1
lesen,3,5,2,1,1,0,1
lassen,7,2,-5,-1,1,-1,1
sagen,1,12,11,1,1,1,1
erwarten,8,6,2,1,-1,0,1
geben,14,2,12,1,-1,0,1
geben,16,7,9,1,-1,0,1
bestätigen,1,2,1,1,1,0,1
erwarten,8,3,5,1,-1,0,1
geben,7,2,5,1,-1,0,1
entwenden,2,4,2,1,1,0,1
handeln,1,10,9,1,1,0,1
führen,4,4,0,0,-1,0,1
präsentieren,11,5,6,1,-1,0,1
sehen,4,5,-1,-1,-1,0,1
erweitern,2,6,4,1,1,0,1
zeigen,4,3,1,1,-1,0,1
besitzen,3,2,-1,-1,1,0,1
schicken,2,4,2,1,1,0,1
bitten,4,5,-1,-1,-1,0,1
übertreffen,7,2,-5,-1,1,0,1
mindern,4,3,-1,-1,1,0,1
melden,7,8,1,1,1,0,1
übertreffen,4,3,-1,-1,1,0,1
beschäftigen,3,4,-1,-1,-1,0,1
eröffnen,4,3,1,1,-1,0,1
zahlen,4,3,-1,-1,1,0,1
kosten,2,2,0,0,-1,0,1
verteilen,2,3,1,1,1,0,1
kündigen,4,2,-2,-1,1,0,1
verleihen,2,11,9,1,1,0,1
verzeichnen,10,3,7,1,-1,0,1
pendeln,1,4,3,1,1,1,1
verfehlen,10,2,-8,-1,1,0,1
verlangen,1,2,-1,-1,-1,0,1
geben,17,2,15,1,-1,0,1
überraschen,2,11,9,1,1,0,1
sorgen,2,4,-2,-1,-1,0,1
erhalten,9,3,6,1,-1,0,1
erhalten,6,5,-1,-1,1,0,1
bringen,4,2,-2,-1,1,0,1
verlangen,12,2,10,1,-1,0,1
fassen,3,2,-1,-1,1,0,1
setzen,5,13,-8,-1,-1,0,1
prognostizieren,17,6,11,1,-1,0,1
belaufen,1,8,7,1,1,1,1
bieten,14,2,12,1,-1,0,1
bezweifeln,4,5,-1,-1,-1,0,1
formen,2,15,13,1,1,0,1
geben,4,4,0,0,-1,0,1
handeln,1,28,27,1,1,1,1
handeln,1,4,3,1,1,1,1
übertünchen,1,2,1,1,1,1,1
bauen,5,6,-1,-1,-1,0,1
nehmen,6,3,-3,-1,1,0,1
verfügen,5,4,1,1,-1,0,1
erwarten,4,2,2,1,-1,0,1
kaufen,1,12,11,1,1,1,1
zahlen,4,3,1,1,-1,0,1
rechnen,5,6,-1,-1,-1,0,1
handeln,1,8,7,1,1,1,1
portieren,3,2,-1,-1,1,0,1
gehören,3,3,0,0,-1,0,1
verdienen,3,3,0,0,-1,0,1
stellen,6,3,3,1,-1,0,1
planen,5,5,0,0,-1,0,1
bestreiten,2,4,-2,-1,-1,0,1
geben,6,4,-2,-1,1,0,1
bieten,8,2,6,1,-1,0,1
treten,6,4,2,1,-1,0,1
rechnen,8,7,1,1,-1,0,1
belaufen,1,4,3,1,1,1,1
machen,10,4,6,1,-1,0,1
führen,8,4,4,1,-1,0,1
geben,13,4,9,1,-1,0,1
erreichen,7,4,3,1,-1,0,1
übernehmen,3,2,1,1,-1,0,1
schließen,1,2,1,1,1,1,1
führen,1,3,2,1,1,0,1
kündigen,22,3,19,1,-1,0,1
tragen,8,5,3,1,-1,0,1
entdecken,3,17,14,1,1,0,1
bedauern,2,2,0,0,1,0,1
vertagen,6,4,-2,-1,1,0,1
wenden,1,5,4,1,1,1,1
melden,14,8,6,1,-1,0,1
lesen,2,2,0,0,-1,0,1
bringen,5,3,-2,-1,1,0,1
kombinieren,2,6,4,1,1,0,1
fordern,7,3,4,1,-1,0,1
bescheren,12,6,6,1,-1,0,1
steigern,1,3,2,1,1,0,1
belaufen,1,7,6,1,1,1,1
verfügen,5,2,3,1,-1,0,1
versetzen,7,10,3,1,1,0,1
weisen,4,18,-14,-1,-1,0,1
erwarten,3,4,-1,-1,-1,0,1
übernehmen,5,4,-1,-1,1,0,1
berichten,10,3,7,1,-1,0,1
geben,3,2,-1,-1,1,0,1
überschätzen,9,2,-7,-1,1,0,1
bestücken,2,5,3,1,1,0,1
verweisen,2,4,2,1,1,0,1
erfahren,13,2,11,1,-1,0,1
erwarten,3,2,1,1,-1,0,1
finden,5,4,1,1,-1,0,1
übertreffen,3,3,0,0,1,1,1
beziffern,4,4,0,0,1,0,1
spülen,3,7,4,1,1,0,1
veröffentlichen,3,2,1,1,-1,0,1
vermelden,10,2,8,1,-1,0,1
berichten,9,5,4,1,-1,0,1
planen,6,7,1,1,1,0,1
nutzen,2,3,-1,-1,-1,0,1
stoppen,1,2,1,1,1,0,1
bieten,2,3,1,1,1,0,1
handeln,1,3,2,1,1,1,1
stellen,4,3,1,1,-1,0,1
sehen,1,2,1,1,1,0,1
lesen,2,3,1,1,1,0,1
geben,3,6,3,1,1,0,1
fertigen,2,2,0,0,1,0,1
kosten,2,2,0,0,-1,0,1
geben,2,3,1,1,1,0,1
geben,1,6,-5,-1,-1,0,1
kosten,2,3,1,1,1,0,1
greifen,3,2,1,1,-1,0,1
dauern,2,2,0,0,-1,0,1
betreiben,7,5,2,1,-1,0,1
beantragen,5,5,0,0,-1,0,1
halten,5,3,2,1,-1,0,1
belegen,2,3,1,1,1,0,1
hageln,3,5,2,1,1,0,1
übernehmen,6,9,-3,-1,-1,0,1
bestehen,14,3,11,1,-1,0,1
reagieren,7,3,4,1,-1,0,1
weisen,2,2,0,0,-1,0,1
bieten,22,5,17,1,-1,0,1
fordern,4,3,1,1,-1,0,1
brauchen,1,2,1,1,1,0,1
erhoffen,4,4,0,0,-1,0,1
erwarten,3,2,-1,-1,1,0,1
nehmen,1,2,1,1,1,0,1
handeln,1,4,3,1,1,1,1
befürchten,1,3,2,1,1,0,1
kaufen,11,7,-4,-1,1,0,1
begrüßen,1,8,7,1,1,0,1
kündigen,6,2,-4,-1,1,0,1
versprechen,2,5,-3,-1,-1,0,1
fertigen,2,4,2,1,1,0,1
erwarten,7,12,-5,-1,-1,0,1
rühmen,1,3,2,1,1,1,1
bieten,3,4,-1,-1,-1,0,1
handeln,1,13,12,1,1,1,1
bieten,3,3,0,0,1,0,1
versprechen,8,3,5,1,-1,0,1
beanspruchen,5,3,2,1,-1,0,1
portieren,1,2,1,1,1,0,1
verlieren,2,12,10,1,1,0,1
nehmen,2,2,0,0,1,0,1
tauschen,7,6,-1,-1,1,0,1
schätzen,6,4,-2,-1,1,0,1
sehen,3,3,0,0,-1,0,1
sehen,2,13,11,1,1,0,1
wählen,7,6,1,1,-1,0,1
bieten,7,3,4,1,-1,0,1
richten,1,14,13,1,1,1,1
betreiben,1,2,-1,-1,-1,0,1
runden,2,2,0,0,1,0,1
erwägen,11,7,4,1,-1,0,1
befürchten,5,2,3,1,-1,0,1
sagen,2,2,0,0,-1,0,1
kosten,3,4,-1,-1,-1,0,1
verlassen,2,3,1,1,1,0,1
erzielen,10,4,6,1,-1,0,1
belegen,5,6,1,1,1,0,1
vergleichen,1,17,16,1,1,0,1
veranstalten,6,2,4,1,-1,0,1
erweitern,6,6,0,0,1,0,1
testen,25,6,19,1,-1,0,1
verbinden,2,3,-1,-1,-1,0,1
rechnen,7,4,3,1,-1,0,1
fordern,4,5,1,1,1,0,1
handeln,1,15,14,1,1,1,1
stellen,10,6,4,1,-1,0,1
vermuten,6,4,2,1,-1,0,1
stellen,16,4,12,1,-1,0,1
bremsen,2,3,1,1,1,0,1
nehmen,2,3,1,1,1,0,1
nehmen,2,10,8,1,1,0,1
starten,2,3,1,1,1,0,1
informieren,1,9,8,1,1,0,1
bedeuten,5,3,2,1,-1,0,1
erwarten,18,8,-10,-1,1,0,1
sehen,6,2,4,1,-1,1,1
verlieren,9,4,-5,-1,1,0,1
nehmen,1,2,1,1,1,0,1
weisen,2,3,1,1,1,0,1
passieren,2,3,-1,-1,-1,0,1
lösen,2,3,-1,-1,-1,0,1
betreuen,2,2,0,0,-1,1,1
beziehen,6,3,-3,-1,1,0,1
weisen,2,3,-1,-1,-1,0,1
signalisieren,5,2,3,1,-1,0,1
riskieren,1,3,-2,-1,-1,0,1
fordern,11,2,9,1,-1,0,1
stoßen,2,3,-1,-1,-1,0,1
kündigen,19,3,16,1,-1,0,1
übernehmen,6,2,4,1,-1,0,1
zeichnen,1,6,5,1,1,1,1
decken,5,4,1,1,-1,0,1
stellen,12,8,4,1,-1,0,1
entwickeln,6,4,2,1,-1,0,1
geben,3,2,1,1,-1,1,1
bilden,3,6,-3,-1,-1,0,1
weisen,4,3,-1,-1,1,0,1
bedeuten,1,5,4,1,1,0,1
sagen,2,2,0,0,1,0,1
planen,2,4,-2,-1,-1,0,1
verkaufen,4,4,0,0,1,0,1
geben,7,4,3,1,-1,0,1
bringen,2,4,2,1,1,0,1
erledigen,1,3,2,1,1,1,1
liefern,1,4,3,1,1,1,1
stellen,2,2,0,0,1,0,1
lassen,1,4,3,1,1,1,1
entsprechen,5,2,3,1,-1,0,1
besuchen,4,2,2,1,-1,1,1
machen,1,3,2,1,1,0,1
ergeben,17,4,13,1,-1,0,1
geben,5,2,3,1,-1,0,1
befürchten,5,3,2,1,-1,0,1
geben,2,6,-4,-1,-1,0,1
stellen,8,2,6,1,-1,0,1
bestehen,18,2,16,1,-1,1,1
schicken,3,2,-1,-1,1,0,1
halten,2,3,1,1,1,0,1
bestrafen,3,7,4,1,1,0,1
halten,3,3,0,0,1,0,1
sehen,1,5,4,1,1,0,1
befürchten,4,4,0,0,-1,0,1
verlangen,6,4,2,1,-1,0,1
sagen,3,2,1,1,-1,0,1
betreiben,3,4,1,1,1,0,1
erwachsen,2,19,17,1,1,1,1
geben,5,3,2,1,-1,0,1
erwarten,10,4,6,1,-1,0,1
gehen,8,3,5,1,-1,0,1
betragen,3,3,0,0,-1,0,1
setzen,2,3,1,1,1,0,1
verbringen,4,3,-1,-1,1,0,1
erwarten,3,7,-4,-1,-1,0,1
widersprechen,13,3,10,1,-1,0,1
vergeben,5,2,3,1,-1,0,1
versteigern,1,2,1,1,1,0,1
zahlen,1,2,1,1,1,0,1
machen,6,3,3,1,-1,0,1
verlangen,3,2,-1,-1,1,0,1
handeln,1,10,9,1,1,1,1
ziehen,3,2,1,1,-1,0,1
laufen,1,3,-2,-1,-1,-1,1
kündigen,2,4,-2,-1,-1,0,1
erlassen,15,2,13,1,-1,0,1
betragen,3,7,4,1,1,0,1
schicken,1,2,1,1,1,0,1
bezeichnen,5,2,3,1,-1,0,1
stehen,2,3,1,1,1,0,1
wünschen,2,12,-10,-1,-1,0,1
verurteilen,1,4,3,1,1,0,1
verteilen,5,2,-3,-1,1,0,1
stellen,5,3,-2,-1,1,0,1
beziffern,4,4,0,0,1,0,1
koordinieren,10,2,8,1,-1,0,1
weisen,1,2,-1,-1,-1,0,1
empfehlen,1,3,2,1,1,0,1
rechnen,14,5,9,1,-1,0,1
erwarten,7,8,1,1,1,0,1
leiden,2,3,1,1,1,0,1
richten,1,13,12,1,1,1,1
zitieren,2,15,13,1,1,0,1
bedienen,3,4,-1,-1,-1,0,1
verzeichnen,6,5,1,1,-1,0,1
gewinnen,11,2,9,1,-1,0,1
erwarten,2,7,5,1,1,0,1
bestätigen,2,2,0,0,1,0,1
erwarten,15,2,-13,-1,1,0,1
verzeichnen,12,4,8,1,-1,0,1
zeigen,1,4,3,1,1,1,1
überholen,1,2,1,1,1,0,1
zitieren,2,3,1,1,1,0,1
berichten,10,3,7,1,-1,0,1
gehören,7,3,4,1,-1,0,1
handeln,1,5,4,1,1,1,1
betragen,3,2,1,1,-1,0,1
machen,8,3,5,1,-1,0,1
spülen,4,3,-1,-1,1,0,1
beinhalten,12,12,0,0,-1,0,1
stehen,1,2,1,1,1,0,1
steuern,6,2,-4,-1,1,0,1
erheben,13,6,7,1,-1,0,1
kündigen,7,7,0,0,-1,0,1
kosten,2,3,1,1,1,0,1
bringen,5,10,-5,-1,-1,0,1
begründen,7,6,-1,-1,1,0,1
verklagen,1,14,13,1,1,0,1
versprechen,5,3,2,1,-1,0,1
bezahlen,6,6,0,0,1,0,1
zeigen,1,5,4,1,1,1,1
hinterlassen,4,4,0,0,-1,0,1
schätzen,4,6,2,1,1,0,1
lassen,1,5,4,1,1,1,1
schmücken,1,4,3,1,1,1,1
erwerben,5,7,2,1,1,0,1
beziehen,2,2,0,0,1,0,1
halten,2,2,0,0,1,0,1
zeigen,14,8,6,1,-1,0,1
suchen,6,3,3,1,-1,0,1
sehen,3,2,1,1,-1,0,1
sagen,5,2,3,1,-1,0,1
offerieren,2,3,1,1,1,0,1
weisen,5,4,1,1,-1,0,1
erreichen,5,4,1,1,-1,0,1
verfügen,6,2,4,1,-1,0,1
erhalten,7,3,4,1,-1,0,1
führen,3,9,6,1,1,0,1
bilden,2,2,0,0,1,0,1
genießen,3,4,-1,-1,-1,0,1
kennen,1,10,9,1,1,0,1
handeln,1,13,12,1,1,1,1
bedeuten,2,2,0,0,1,0,1
befürchten,7,6,1,1,-1,0,1
erhalten,5,4,1,1,-1,0,1
verzeichnen,2,3,-1,-1,-1,0,1
stellen,7,8,-1,-1,-1,0,1
verbinden,4,5,1,1,1,0,1
reagieren,5,7,2,1,1,0,1
steuern,4,3,-1,-1,1,0,1
spekulieren,7,7,0,0,-1,0,1
verbessern,6,8,2,1,1,0,1
entstehen,2,10,-8,-1,-1,0,1
bieten,4,12,8,1,1,0,1
erfahren,4,2,2,1,-1,-1,1
führen,6,6,0,0,-1,0,1
machen,2,3,1,1,1,0,1
fordern,3,12,9,1,1,0,1
begrüßen,2,3,1,1,1,0,1
mahnen,1,3,2,1,1,0,1
nehmen,4,2,2,1,-1,1,1
ziehen,1,3,2,1,1,0,1
fordern,1,5,4,1,1,0,1
übermitteln,2,3,-1,-1,-1,0,1
stellen,2,2,0,0,1,0,1
laden,2,3,1,1,1,0,1
planen,6,2,4,1,-1,0,1
stellen,1,3,2,1,1,0,1
nähern,4,3,1,1,-1,0,1
erläutern,6,3,3,1,-1,0,1
äußern,1,7,6,1,1,1,1
zeigen,1,3,2,1,1,1,1
rechnen,7,3,4,1,-1,0,1
bestätigen,6,2,4,1,-1,0,1
liefern,2,3,-1,-1,-1,0,1
belegen,1,4,3,1,1,0,1
bieten,5,6,1,1,1,0,1
verbinden,10,6,-4,-1,1,0,1
zeigen,19,3,16,1,-1,0,1
beantragen,1,7,6,1,1,0,1
verzeichnen,4,5,-1,-1,-1,0,1
nennen,6,4,2,1,-1,0,1
gehen,1,9,-8,-1,-1,0,1
versorgen,1,7,6,1,1,0,1
versprechen,13,3,10,1,-1,0,1
summieren,1,4,3,1,1,1,1
geben,9,4,5,1,-1,0,1
übernehmen,24,9,-15,-1,1,0,1
vergraulen,4,4,0,0,-1,0,1
kündigen,1,4,3,1,1,0,1
verteidigen,3,3,0,0,-1,0,1
bringen,4,2,-2,-1,1,0,1
handeln,1,7,6,1,1,0,1
eröffnen,2,12,10,1,1,0,1
erhalten,6,9,-3,-1,-1,0,1
ermitteln,10,2,8,1,-1,0,1
entwickeln,12,4,8,1,-1,0,1
finden,5,6,-1,-1,-1,0,1
zeigen,2,6,4,1,1,0,1
zitieren,6,17,11,1,1,0,1
machen,3,5,-2,-1,-1,0,1
führen,6,5,1,1,-1,0,1
begründen,2,2,0,0,1,-1,1
bringen,1,6,5,1,1,1,1
bekommen,7,4,3,1,-1,0,1
kosten,2,2,0,0,-1,0,1
schlagen,2,3,-1,-1,-1,0,1
zitieren,3,25,22,1,1,0,1
verschieben,14,3,11,1,-1,0,1
fordern,9,2,7,1,-1,0,1
übernehmen,10,3,7,1,-1,0,1
verlangen,6,3,3,1,-1,0,1
zitieren,8,17,9,1,1,0,1
eröffnen,2,15,13,1,1,0,1
stellen,9,2,7,1,-1,0,1
übertreffen,1,3,2,1,1,0,1
erwarten,14,2,12,1,-1,0,1
setzen,8,6,2,1,-1,0,1
beschleunigen,1,2,1,1,1,0,1
weisen,2,6,4,1,1,0,1
bringen,3,3,0,0,1,0,1
gehören,4,4,0,0,-1,0,1
ermöglichen,4,3,1,1,-1,0,1
führen,8,3,5,1,-1,0,1
bereiten,1,4,3,1,1,1,1
geben,10,2,8,1,-1,0,1
zählen,4,4,0,0,-1,0,1
decken,10,3,7,1,-1,0,1
gehören,3,3,0,0,-1,0,1
weisen,4,6,-2,-1,-1,0,1
verursachen,8,3,5,1,-1,0,1
bieten,2,3,-1,-1,-1,0,1
wandeln,2,2,0,0,1,0,1
erzielen,1,2,-1,-1,-1,0,1
erläutern,10,8,2,1,-1,0,1
listen,10,3,7,1,-1,0,1
nehmen,2,4,-2,-1,-1,0,1
rechnen,12,3,9,1,-1,0,1
stellen,2,2,0,0,1,0,1
vergleichen,1,5,4,1,1,1,1
drohen,2,4,2,1,1,0,1
rechtfertigen,5,14,9,1,1,0,1
erkennen,5,3,2,1,-1,0,1
vergeben,6,4,-2,-1,1,0,1
rüsten,2,3,1,1,1,0,1
erwägen,2,2,0,0,1,0,1
machen,2,11,-9,-1,-1,0,1
handeln,1,5,4,1,1,1,1
schmieden,1,3,-2,-1,-1,0,1
feiern,3,5,2,1,1,0,1
senden,2,2,0,0,1,0,1
verkaufen,1,2,1,1,1,0,1
sehen,3,4,-1,-1,-1,0,1
bringen,2,2,0,0,1,0,1
verwalten,2,4,-2,-1,-1,0,1
präsentieren,11,7,4,1,-1,0,1
beziffern,2,3,1,1,1,0,1
beziffern,10,4,-6,-1,1,0,1
setzen,4,2,-2,-1,1,0,1
zwingen,1,2,-1,-1,-1,1,1
versteigern,3,4,1,1,1,0,1
verzehren,3,4,-1,-1,-1,0,1
verbrauchen,3,3,0,0,-1,0,1
schätzen,9,3,-6,-1,1,0,1
begründen,1,3,2,1,1,1,1
bieten,2,4,2,1,1,0,1
knacken,8,9,1,1,1,0,1
beziffern,5,5,0,0,1,0,1
erheben,2,3,-1,-1,-1,0,1
reagieren,3,2,-1,-1,1,0,1
finden,1,5,-4,-1,-1,0,1
stimmen,5,3,2,1,-1,0,1
machen,6,10,-4,-1,-1,0,1
betragen,3,3,0,0,-1,0,1
enthalten,2,14,12,1,1,0,1
verbinden,2,3,1,1,1,0,1
bedeuten,5,4,-1,-1,1,0,1
belaufen,1,3,2,1,1,1,1
einigen,12,2,10,1,-1,0,1
widersprechen,13,5,8,1,-1,0,1
veröffentlichen,3,6,3,1,1,0,1
verweisen,10,3,7,1,-1,0,1
sehen,2,7,5,1,1,0,1
charakterisieren,2,4,-2,-1,-1,0,1
speichern,5,12,7,1,1,0,1
rechtfertigen,3,11,8,1,1,0,1
erwarten,17,2,15,1,-1,0,1
nutzen,2,3,1,1,1,0,1
verständigen,1,2,1,1,1,1,1
fehlen,2,3,1,1,1,0,1
messen,2,3,-1,-1,-1,0,1
verbrauchen,2,2,0,0,-1,0,1
rechnen,7,3,4,1,-1,0,1
betrachten,5,3,-2,-1,1,0,1
senken,2,3,-1,-1,-1,0,1
liefern,6,4,-2,-1,1,0,1
erhoffen,2,20,18,1,1,0,1
veröffentlichen,2,7,5,1,1,0,1
sorgen,18,2,16,1,-1,0,1
nehmen,3,2,1,1,-1,0,1
zitieren,2,4,2,1,1,0,1
vermuten,4,3,1,1,-1,0,1
erwarten,4,7,3,1,1,0,1
finden,15,4,11,1,-1,0,1
sehen,2,3,-1,-1,-1,0,1
geben,3,3,0,0,1,0,1
stellen,1,2,1,1,1,0,1
setzen,13,5,8,1,-1,0,1
machen,9,6,3,1,-1,0,1
versprechen,1,7,-6,-1,-1,-1,1
laden,1,3,2,1,1,0,1
handeln,1,13,12,1,1,1,1
streben,2,16,14,1,1,0,1
fördern,8,5,3,1,-1,0,1
spielen,6,2,4,1,-1,0,1
zeigen,1,2,1,1,1,1,1
werben,3,3,0,0,1,0,1
erwarten,8,4,4,1,-1,0,1
entsprechen,6,6,0,0,-1,0,1
kosten,23,2,21,1,-1,0,1
tragen,15,5,10,1,-1,0,1
setzen,1,5,-4,-1,-1,0,1
sehen,5,13,-8,-1,-1,0,1
prüfen,3,3,0,0,1,0,1
besitzen,7,3,4,1,-1,0,1
erklären,6,4,2,1,-1,0,1
befürchten,5,3,2,1,-1,0,1
sehen,4,3,1,1,-1,0,1
erfreuen,2,3,-1,-1,-1,0,1
schätzen,4,3,1,1,-1,0,1
visieren,9,2,7,1,-1,0,1
bekommen,3,3,0,0,-1,0,1
versteigern,2,3,1,1,1,0,1
erwarten,5,5,0,0,-1,0,1
erklären,1,2,1,1,1,0,1
wissen,3,3,0,0,1,1,1
gehören,2,5,-3,-1,-1,0,1
liefern,6,3,-3,-1,1,0,1
stellen,3,2,1,1,-1,0,1
veröffentlichen,3,2,-1,-1,1,0,1
prophezeien,4,4,0,0,-1,0,1
laufen,13,5,8,1,-1,0,1
geben,2,3,1,1,1,0,1
verwenden,1,3,2,1,1,0,1
verkaufen,7,5,2,1,-1,0,1
erwarten,8,3,5,1,-1,0,1
kündigen,14,4,10,1,-1,0,1
nennen,18,3,15,1,-1,0,1
führen,14,5,9,1,-1,0,1
erwarten,5,5,0,0,-1,0,1
geben,5,3,2,1,-1,0,1
zahlen,2,8,-6,-1,-1,0,1
geben,6,4,2,1,-1,0,1
erwirtschaften,6,4,2,1,-1,0,1
übertreffen,4,4,0,0,1,0,1
schildern,3,3,0,0,-1,0,1
handeln,1,9,8,1,1,1,1
reduzieren,5,4,-1,-1,1,0,1
schlussfolgern,6,3,3,1,-1,0,1
vereinbaren,6,2,4,1,-1,0,1
geben,19,2,17,1,-1,0,1
berechtigen,2,2,0,0,1,-1,1
gelten,5,3,2,1,-1,0,1
reduzieren,5,3,-2,-1,1,0,1
belaufen,1,3,2,1,1,1,1
stellen,3,4,-1,-1,-1,0,1
rufen,3,2,-1,-1,1,0,1
feuern,2,3,1,1,1,0,1
erzielen,6,5,1,1,-1,0,1
erwarten,7,4,3,1,-1,0,1
empfinden,3,7,4,1,1,0,1
wickeln,6,5,1,1,-1,0,1
erhoffen,6,3,3,1,-1,0,1
erhalten,7,2,5,1,-1,0,1
verlangen,2,3,1,1,1,0,1
erhoffen,1,6,5,1,1,1,1
versprechen,2,3,1,1,1,0,1
treffen,1,2,-1,-1,-1,1,1
kündigen,5,4,-1,-1,1,0,1
geben,3,3,0,0,-1,0,1
halten,2,4,-2,-1,-1,0,1
geben,2,4,2,1,1,0,1
stellen,6,6,0,0,-1,0,1
sehen,3,3,0,0,-1,0,1
erreichen,2,16,14,1,1,0,1
überwachen,4,5,1,1,1,0,1
betrachten,4,3,-1,-1,1,0,1
erhoffen,5,4,1,1,-1,0,1
bieten,8,2,6,1,-1,0,1
bieten,7,2,5,1,-1,0,1
führen,1,2,1,1,1,1,1
ziehen,2,3,-1,-1,-1,0,1
hüten,10,5,-5,-1,1,0,1
beschreiben,2,3,1,1,1,0,1
proben,13,9,4,1,-1,0,1
sehen,4,2,-2,-1,1,0,1
sagen,3,3,0,0,-1,0,1
entwickeln,14,3,11,1,-1,0,1
greifen,3,3,0,0,-1,0,1
wandeln,3,2,-1,-1,1,0,1
bringen,4,2,-2,-1,1,0,1
sehen,2,2,0,0,1,0,1
sehen,3,4,-1,-1,-1,0,1
erwirken,8,8,0,0,-1,0,1
drohen,2,16,14,1,1,0,1
nehmen,14,2,12,1,-1,0,1
bringen,8,4,4,1,-1,0,1
erhoffen,4,8,-4,-1,-1,0,1
erwarten,3,5,-2,-1,-1,0,1
legen,3,2,-1,-1,1,0,1
pfänden,21,4,17,1,-1,0,1
speisen,6,4,-2,-1,1,0,1
ermöglichen,7,3,-4,-1,1,0,1
formen,10,4,6,1,-1,0,1
ergänzen,14,3,11,1,-1,0,1
schreiben,12,3,9,1,-1,0,1
sehen,2,3,1,1,1,0,1
äußern,1,11,10,1,1,1,1
rechnen,5,3,2,1,-1,0,1
profitieren,2,3,-1,-1,-1,0,1
erlernen,1,9,8,1,1,0,1
übersetzen,6,3,-3,-1,1,0,1
nehmen,1,3,-2,-1,-1,0,1
gewinnen,2,2,0,0,-1,0,1
leisten,2,3,1,1,1,0,1
versprechen,14,6,8,1,-1,0,1
stellen,3,2,1,1,-1,1,1
liefern,2,3,-1,-1,-1,0,1
bringen,1,2,1,1,1,1,1
verstoßen,5,3,-2,-1,1,0,1
teilen,1,10,9,1,1,1,1
machen,2,3,1,1,1,0,1
bedrohen,10,6,4,1,-1,0,1
geben,15,3,12,1,-1,0,1
erwarten,5,3,2,1,-1,0,1
lassen,2,2,0,0,-1,-1,1
erreichen,1,8,7,1,1,1,1
verfügen,9,3,6,1,-1,0,1
teilen,20,5,15,1,-1,0,1
betreiben,8,3,5,1,-1,0,1
führen,2,3,-1,-1,-1,0,1
zeigen,4,4,0,0,-1,0,1
führen,5,5,0,0,-1,0,1
sehen,2,5,-3,-1,-1,0,1
richten,2,3,1,1,1,0,1
fordern,1,13,12,1,1,1,1
präsentieren,7,5,2,1,-1,0,1
machen,1,3,-2,-1,-1,0,1
verrichten,9,4,5,1,-1,0,1
spendieren,7,3,4,1,-1,0,1
stoßen,2,4,2,1,1,0,1
investieren,2,5,3,1,1,0,1
weisen,9,4,5,1,-1,0,1
zeigen,6,5,1,1,-1,0,1
verfügen,9,6,3,1,-1,0,1
werfen,3,6,3,1,1,0,1
schlagen,2,3,-1,-1,-1,0,1
entpuppen,1,2,1,1,1,1,1
bauen,2,3,1,1,1,0,1
fabrizieren,9,2,7,1,-1,0,1
sehen,2,6,4,1,1,0,1
fordern,2,4,-2,-1,-1,0,1
liefern,4,2,-2,-1,1,0,1
geben,2,4,2,1,1,0,1
integrieren,7,4,-3,-1,1,0,1
tun,2,9,7,1,1,0,1
tippen,3,3,0,0,-1,0,1
nutzen,2,16,14,1,1,0,1
nutzen,1,3,2,1,1,0,1
lizenzieren,1,2,1,1,1,0,1
ringen,2,2,0,0,1,1,1
gehen,2,6,-4,-1,-1,0,1
gewähren,9,2,7,1,-1,0,1
spielen,2,3,-1,-1,-1,0,1
verschmelzen,2,3,1,1,1,0,1
zeigen,11,5,6,1,-1,0,1
starten,18,3,15,1,-1,0,1
berechnen,2,2,0,0,1,0,1
bestehen,1,2,-1,-1,-1,0,1
planen,3,4,-1,-1,-1,0,1
entwickeln,7,4,3,1,-1,0,1
stellen,9,2,-7,-1,1,0,1
erhalten,1,6,5,1,1,1,1
zeigen,1,3,2,1,1,1,1
ähneln,2,5,-3,-1,-1,0,1
stellen,3,4,-1,-1,-1,0,1
beziehen,2,2,0,0,1,0,1
erhalten,2,2,0,0,1,0,1
suchen,3,2,-1,-1,1,0,1
entschuldigen,1,3,2,1,1,1,1
bieten,11,7,4,1,-1,0,1
enthalten,3,14,-11,-1,-1,0,1
erstellen,4,4,0,0,-1,0,1
teilen,2,2,0,0,1,-1,1
treffen,3,2,1,1,-1,1,1
nennen,9,3,6,1,-1,0,1
beseitigen,7,2,5,1,-1,0,1
führen,1,4,3,1,1,0,1
gründen,4,3,1,1,-1,0,1
sehen,4,8,4,1,1,0,1
bauen,3,2,1,1,-1,0,1
berechnen,2,2,0,0,-1,0,1
informieren,2,2,0,0,-1,0,1
liefern,8,4,-4,-1,1,0,1
liefern,13,2,11,1,-1,1,1
zeigen,1,2,1,1,1,0,1
stellen,10,2,-8,-1,1,0,1
handeln,1,4,3,1,1,1,1
belegen,4,3,1,1,-1,0,1
zeigen,1,3,2,1,1,1,1
verteilen,2,4,2,1,1,0,1
importieren,2,5,3,1,1,0,1
kosten,8,2,6,1,-1,0,1
geben,1,5,4,1,1,0,1
bringen,2,4,2,1,1,0,1
aktualisieren,3,4,1,1,1,0,1
halten,2,3,1,1,1,0,1
erzeugen,4,3,1,1,-1,0,1
finden,16,7,9,1,-1,0,1
machen,1,5,4,1,1,1,1
bündeln,4,4,0,0,1,0,1
begründen,2,3,1,1,1,0,1
setzen,3,2,1,1,-1,0,1
entwickeln,1,9,8,1,1,0,1
handeln,1,4,3,1,1,1,1
speichern,3,4,1,1,1,0,1
bestätigen,2,2,0,0,-1,0,1
schicken,5,2,-3,-1,1,0,1
enthalten,6,10,-4,-1,-1,0,1
geben,2,3,-1,-1,-1,0,1
handeln,1,21,20,1,1,1,1
finden,19,3,16,1,-1,0,1
bekommen,8,2,6,1,-1,0,1
erhalten,1,4,3,1,1,0,1
äußern,7,5,2,1,-1,0,1
errechnen,2,8,6,1,1,0,1
benutzen,11,5,6,1,-1,0,1
führen,8,14,6,1,1,0,1
vergrößern,3,3,0,0,1,0,1
erreichen,13,5,8,1,-1,0,1
erhalten,4,3,1,1,-1,0,1
berichten,12,4,8,1,-1,0,1
schätzen,8,4,-4,-1,1,0,1
verbannen,1,2,1,1,1,0,1
befürchten,4,2,2,1,-1,1,1
denken,1,5,-4,-1,-1,0,1
erschweren,17,2,15,1,-1,0,1
hoffen,3,2,1,1,-1,0,1
verteidigen,4,3,-1,-1,1,0,1
halten,2,2,0,0,1,0,1
vertreten,3,5,-2,-1,-1,0,1
suchen,3,3,0,0,-1,0,1
verlangen,3,2,1,1,-1,0,1
stoßen,11,3,8,1,-1,0,1
heben,2,3,1,1,1,0,1
sehen,3,3,0,0,-1,0,1
kommentieren,2,4,2,1,1,0,1
erwarten,3,6,-3,-1,-1,0,1
erwarten,6,3,3,1,-1,0,1
deuten,1,5,4,1,1,1,1
sehen,8,4,4,1,-1,0,1
erwirtschaften,6,3,3,1,-1,0,1
bedeuten,2,5,-3,-1,-1,0,1
verlagern,2,4,2,1,1,0,1
entsprechen,4,2,2,1,-1,-1,1
präsentieren,3,3,0,0,1,0,1
planen,2,7,-5,-1,-1,0,1
versprechen,5,6,-1,-1,-1,0,1
stellen,2,2,0,0,1,0,1
nehmen,2,5,-3,-1,-1,0,1
beantragen,3,3,0,0,-1,0,1
sehen,2,5,-3,-1,-1,0,1
handeln,1,8,7,1,1,1,1
testen,3,8,5,1,1,0,1
fordern,6,3,-3,-1,1,0,1
erklären,3,3,0,0,-1,0,1
beginnen,23,4,19,1,-1,0,1
geben,7,4,3,1,-1,0,1
verringern,1,4,3,1,1,1,1
widmen,2,14,-12,-1,-1,0,1
schleppen,10,2,-8,-1,1,-1,1
vergleichen,3,3,0,0,1,0,1
handeln,1,6,5,1,1,1,1
denken,1,4,-3,-1,-1,0,1
warnen,1,2,1,1,1,0,1
übernehmen,4,2,-2,-1,1,0,1
veröffentlichen,2,8,6,1,1,0,1
entsprechen,4,15,11,1,1,0,1
geben,2,5,-3,-1,-1,0,1
gehören,3,3,0,0,-1,0,1
warnen,1,2,1,1,1,0,1
bekommen,2,2,0,0,-1,0,1
beurteilen,2,12,10,1,1,0,1
erwarten,18,3,15,1,-1,0,1
unterscheiden,3,3,0,0,1,0,1
liefern,2,3,-1,-1,-1,0,1
überholen,1,2,1,1,1,0,1
betragen,2,3,-1,-1,-1,0,1
belaufen,1,7,6,1,1,1,1
sehen,4,5,-1,-1,-1,0,1
erwarten,7,3,4,1,-1,0,1
nennen,11,2,9,1,-1,0,1
zeichnen,1,3,2,1,1,1,1
kaufen,1,2,1,1,1,1,1
gehen,2,2,0,0,1,0,1
betragen,3,4,-1,-1,-1,0,1
heißen,3,2,1,1,-1,0,1
führen,2,15,13,1,1,0,1
rechnen,1,2,-1,-1,-1,0,1
verbuchen,6,5,1,1,-1,0,1
verfügen,12,3,9,1,-1,0,1
erwarten,5,8,-3,-1,-1,0,1
entsprechen,13,3,10,1,-1,0,1
werben,5,2,3,1,-1,0,1
empfehlen,3,3,0,0,1,0,1
finden,2,8,6,1,1,0,1
kennen,1,5,4,1,1,1,1
rechnen,6,4,2,1,-1,0,1
geben,3,6,-3,-1,-1,0,1
machen,2,3,-1,-1,-1,0,1
nominieren,1,2,1,1,1,0,1
leiten,9,3,6,1,-1,0,1
kündigen,2,3,-1,-1,-1,0,1
setzen,2,6,-4,-1,-1,0,1
bauen,2,4,2,1,1,0,1
bekommen,5,2,-3,-1,1,0,1
nennen,16,3,13,1,-1,0,1
erscheinen,1,3,-2,-1,-1,-1,1
benutzen,2,9,7,1,1,-1,1
handeln,1,17,16,1,1,1,1
erhoffen,5,5,0,0,-1,0,1
geben,11,8,3,1,-1,0,1
hoffen,8,4,4,1,-1,0,1
teilen,9,2,7,1,-1,0,1
sagen,4,6,2,1,1,0,1
bieten,7,3,4,1,-1,0,1
bekommen,9,5,-4,-1,1,0,1
umfassen,21,4,17,1,-1,0,1
liefern,2,2,0,0,-1,0,1
befördern,2,2,0,0,-1,0,1
kombinieren,5,5,0,0,1,-1,1
untersuchen,12,2,10,1,-1,0,1
sehen,2,5,-3,-1,-1,0,1
bieten,1,4,-3,-1,-1,0,1
halten,2,2,0,0,1,0,1
sichern,4,3,1,1,-1,0,1
erwarten,17,3,14,1,-1,0,1
kündigen,2,6,4,1,1,0,1
stellen,3,7,-4,-1,-1,0,1
erweitern,7,3,-4,-1,1,0,1
betragen,2,3,-1,-1,-1,0,1
bieten,4,3,1,1,-1,0,1
setzen,2,5,-3,-1,-1,-1,1
rechnen,1,6,-5,-1,-1,0,1
suchen,8,5,3,1,-1,0,1
erachten,2,3,1,1,1,0,1
zahlen,5,3,-2,-1,1,0,1
zahlen,1,3,2,1,1,1,1
rechnen,8,4,4,1,-1,0,1
sagen,3,4,1,1,1,0,1
versorgen,1,14,13,1,1,0,1
demonstrieren,15,3,12,1,-1,0,1
überbrücken,4,10,6,1,1,0,1
starten,8,3,-5,-1,1,0,1
bieten,3,25,22,1,1,0,1
stellen,2,12,10,1,1,0,1
lesen,1,2,1,1,1,0,1
bieten,6,3,3,1,-1,0,1
sprechen,4,4,0,0,-1,0,1
werben,4,3,1,1,-1,0,1
erwarten,3,4,-1,-1,-1,0,1
geben,3,4,-1,-1,-1,0,1
übernehmen,1,2,1,1,1,0,1
umfassen,18,3,15,1,-1,0,1
beschäftigen,3,2,1,1,-1,0,1
signalisieren,2,2,0,0,-1,0,1
protokollieren,2,8,6,1,1,0,1
präsentieren,1,10,9,1,1,1,1
erledigen,5,3,-2,-1,1,0,1
bieten,2,6,4,1,1,0,1
erfordern,2,3,1,1,1,0,1
verfügen,3,6,-3,-1,-1,0,1
geben,2,2,0,0,-1,1,1
schlagen,2,3,-1,-1,-1,0,1
betragen,2,3,-1,-1,-1,0,1
warnen,2,10,8,1,1,0,1
benennen,6,3,-3,-1,1,0,1
erwarten,4,3,1,1,-1,0,1
versprechen,3,5,-2,-1,-1,0,1
führen,10,2,-8,-1,1,0,1
investieren,5,3,2,1,-1,0,1
bergen,1,2,1,1,1,1,1
kritisieren,5,2,3,1,-1,0,1
richten,1,5,4,1,1,1,1
betragen,6,3,3,1,-1,0,1
erweitern,2,6,4,1,1,0,1
unterstützen,14,3,11,1,-1,0,1
entscheiden,1,2,1,1,1,1,1
bündeln,1,2,1,1,1,0,1
führen,2,6,4,1,1,0,1
bestätigen,6,4,2,1,-1,0,1
verbinden,3,3,0,0,1,0,1
kündigen,7,4,3,1,-1,0,1
geben,2,3,1,1,1,0,1
stellen,7,4,3,1,-1,0,1
verlangen,2,3,-1,-1,-1,0,1
entsprechen,4,2,-2,-1,1,0,1
nutzen,5,2,3,1,-1,0,1
bieten,3,3,0,0,1,0,1
zeigen,1,3,-2,-1,-1,0,1
erwarten,10,4,6,1,-1,0,1
kündigen,12,3,9,1,-1,0,1
erfreuen,2,4,-2,-1,-1,0,1
gründen,2,3,-1,-1,-1,0,1
ziehen,3,2,-1,-1,1,-1,1
halten,4,3,1,1,-1,0,1
sehen,1,10,9,1,1,1,1
stellen,3,6,3,1,1,0,1
kosten,3,2,1,1,-1,0,1
geben,2,2,0,0,-1,0,1
füllen,7,2,-5,-1,1,0,1
wählen,1,3,-2,-1,-1,0,1
rufen,1,3,2,1,1,1,1
ziehen,6,2,-4,-1,1,0,1
fragen,8,4,4,1,-1,0,1
kündigen,4,4,0,0,1,0,1
stellen,6,2,-4,-1,1,0,1
kassieren,1,7,6,1,1,0,1
weisen,1,2,-1,-1,-1,0,1
sehen,1,3,2,1,1,1,1
erhalten,2,25,23,1,1,0,1
legen,1,3,2,1,1,0,1
stellen,15,7,8,1,-1,0,1
übersetzen,2,3,1,1,1,0,1
bieten,2,2,0,0,-1,0,1
warten,4,5,-1,-1,-1,0,1
reichen,10,2,8,1,-1,0,1
bezahlen,2,3,1,1,1,0,1
stellen,17,5,12,1,-1,0,1
sagen,6,5,1,1,-1,0,1
decken,4,6,-2,-1,-1,0,1
erreichen,5,5,0,0,-1,0,1
geben,2,2,0,0,-1,0,1
beliefern,4,4,0,0,1,0,1
beschäftigen,3,2,1,1,-1,0,1
erzielen,9,3,6,1,-1,0,1
bringen,8,3,-5,-1,1,0,1
bieten,1,3,2,1,1,0,1
liefern,4,4,0,0,-1,0,1
suchen,4,2,2,1,-1,0,1
geben,3,4,-1,-1,-1,0,1
verheiraten,1,2,1,1,1,0,1
nehmen,1,2,1,1,1,0,1
fordern,10,4,6,1,-1,0,1
signalisieren,2,2,0,0,1,0,1
gliedern,2,4,2,1,1,0,1
sagen,2,6,4,1,1,0,1
halten,14,3,-11,-1,1,0,1
stellen,11,3,8,1,-1,0,1
schlagen,2,3,-1,-1,-1,0,1
stehen,6,2,-4,-1,1,0,1
stellen,8,6,2,1,-1,0,1
sorgen,6,2,4,1,-1,0,1
sammeln,1,3,2,1,1,1,1
feuern,9,3,-6,-1,1,0,1
vernetzen,2,3,1,1,1,0,1
schließen,1,4,3,1,1,1,1
erweitern,2,7,5,1,1,0,1
eröffnen,1,15,14,1,1,0,1
hinterlassen,1,3,2,1,1,0,1
bringen,3,2,-1,-1,1,0,1
erreichen,10,3,7,1,-1,0,1
bieten,6,3,3,1,-1,0,1
übernehmen,2,4,2,1,1,0,1
warten,1,3,-2,-1,-1,0,1
versprechen,8,3,5,1,-1,0,1
bieten,4,3,-1,-1,1,0,1
fühlen,1,3,2,1,1,1,1
bekommen,2,3,1,1,1,0,1
zahlen,7,2,5,1,-1,0,1
bekommen,4,3,-1,-1,1,0,1
berechnen,8,4,4,1,-1,0,1
berechnen,3,10,-7,-1,-1,0,1
sparen,2,2,0,0,-1,0,1
eröffnen,3,5,-2,-1,-1,0,1
kündigen,5,4,1,1,-1,0,1
hageln,7,9,-2,-1,-1,0,1
schaffen,2,3,-1,-1,-1,0,1
liefern,1,7,6,1,1,0,1
erhalten,3,3,0,0,-1,0,1
speichern,2,2,0,0,1,0,1
empfangen,7,4,-3,-1,1,0,1
nehmen,2,7,-5,-1,-1,0,1
handeln,1,5,4,1,1,1,1
senken,4,3,-1,-1,1,0,1
machen,3,5,-2,-1,-1,0,1
erwarten,8,3,5,1,-1,0,1
handeln,1,4,3,1,1,1,1
wickeln,5,2,-3,-1,1,0,1
fühlen,1,5,4,1,1,1,1
bieten,3,5,-2,-1,-1,0,1
halten,2,2,0,0,1,0,1
entscheiden,1,23,22,1,1,1,1
verkünden,16,7,9,1,-1,0,1
trennen,1,2,1,1,1,0,1
bringen,4,3,-1,-1,1,0,1
erwarten,4,12,-8,-1,-1,0,1
geraten,3,4,-1,-1,-1,0,1
betreuen,5,7,-2,-1,-1,0,1
beantworten,3,4,-1,-1,-1,0,1
erwirtschaften,6,6,0,0,-1,0,1
vermuten,2,6,-4,-1,-1,0,1
führen,1,18,17,1,1,1,1
machen,1,3,-2,-1,-1,0,1
werben,7,3,4,1,-1,0,1
starten,3,3,0,0,-1,0,1
erfreuen,5,3,2,1,-1,0,1
versprechen,2,4,2,1,1,0,1
versorgen,2,3,1,1,1,0,1
erlauben,4,3,-1,-1,1,0,1
geben,4,6,2,1,1,0,1
läuten,3,2,-1,-1,1,0,1
erwarten,4,3,1,1,-1,0,1
erwarten,3,3,0,0,-1,0,1
gehen,1,3,-2,-1,-1,0,1
bieten,9,4,-5,-1,1,0,1
übertragen,4,2,-2,-1,1,0,1
erlauben,4,3,-1,-1,1,0,1
erproben,2,3,-1,-1,-1,0,1
schalten,5,3,2,1,-1,0,1
bringen,5,3,-2,-1,1,0,1
empfangen,1,4,-3,-1,-1,0,1
unterstützen,2,2,0,0,1,0,1
beziffern,2,6,4,1,1,0,1
bieten,6,2,4,1,-1,0,1
bieten,6,2,4,1,-1,-1,1
erwarten,9,6,3,1,-1,0,1
richten,1,5,4,1,1,1,1
verweisen,7,2,5,1,-1,0,1
erwarten,5,3,2,1,-1,0,1
erreichen,4,3,1,1,-1,0,1
finden,1,5,-4,-1,-1,0,1
peilen,2,2,0,0,-1,0,1
erhalten,3,3,0,0,-1,0,1
kosten,9,3,6,1,-1,0,1
wählen,1,3,2,1,1,0,1
empfangen,2,2,0,0,1,0,1
missen,4,3,1,1,-1,0,1
kosten,2,2,0,0,-1,0,1
erreichen,4,3,1,1,-1,0,1
lassen,4,3,-1,-1,1,0,1
machen,1,7,6,1,1,0,1
sehen,4,2,2,1,-1,0,1
teilen,1,3,-2,-1,-1,0,1
übertragen,2,3,-1,-1,-1,0,1
präsentieren,9,2,7,1,-1,0,1
schnippen,4,3,-1,-1,1,0,1
stellen,6,2,4,1,-1,0,1
bieten,2,6,4,1,1,0,1
nehmen,2,5,3,1,1,0,1
betragen,4,2,2,1,-1,0,1
kosten,3,2,-1,-1,1,0,1
leiten,3,4,1,1,1,0,1
erwarten,2,4,-2,-1,-1,0,1
wissen,11,2,9,1,-1,-1,1
stellen,2,7,5,1,1,0,1
erfüllen,5,3,-2,-1,1,0,1
legen,2,5,3,1,1,0,1
bringen,6,5,1,1,-1,0,1
zahlen,8,9,-1,-1,-1,0,1
behalten,6,4,-2,-1,1,0,1
füllen,7,2,-5,-1,1,0,1
wählen,1,3,-2,-1,-1,0,1
rufen,1,3,2,1,1,1,1
fragen,8,4,4,1,-1,0,1
tragen,3,2,-1,-1,1,0,1
stehen,4,2,-2,-1,1,0,1
testen,7,4,-3,-1,1,0,1
bieten,9,3,6,1,-1,0,1
streben,7,2,5,1,-1,0,1
versprechen,6,5,1,1,-1,0,1
übertragen,2,2,0,0,1,0,1
bieten,10,2,8,1,-1,1,1
gehen,2,7,5,1,1,0,1
kosten,4,4,0,0,-1,0,1
nutzen,4,3,1,1,-1,0,1
nehmen,1,6,-5,-1,-1,0,1
testen,1,3,2,1,1,0,1
bieten,5,5,0,0,-1,0,1
zahlen,4,2,2,1,-1,0,1
erhalten,2,3,1,1,1,0,1
dienen,7,2,5,1,-1,0,1
präsentieren,14,3,11,1,-1,0,1
tilgen,1,3,2,1,1,0,1
ergeben,7,2,5,1,-1,0,1
nutzen,2,5,3,1,1,0,1
halten,2,3,-1,-1,-1,0,1
benötigen,9,2,7,1,-1,0,1
geben,11,2,9,1,-1,0,1
vermitteln,1,9,8,1,1,0,1
stellen,3,3,0,0,-1,0,1
bieten,10,6,4,1,-1,0,1
bringen,2,2,0,0,1,0,1
stellen,21,4,17,1,-1,0,1
nennen,7,3,4,1,-1,0,1
zeigen,7,3,-4,-1,1,0,1
emulieren,9,3,6,1,-1,0,1
erteilen,2,6,-4,-1,-1,0,1
vertiefen,2,6,4,1,1,0,1
versetzen,5,16,11,1,1,0,1
bauen,8,5,3,1,-1,0,1
reaktivieren,2,3,1,1,1,0,1
kosten,2,5,-3,-1,-1,0,1
dienen,4,3,1,1,-1,0,1
erwarten,4,5,-1,-1,-1,0,1
erwarten,6,2,4,1,-1,0,1
rechnen,4,3,1,1,-1,0,1
räumen,7,5,2,1,-1,0,1
lizenzieren,6,2,4,1,-1,0,1
erwerben,4,5,1,1,1,0,1
schaffen,1,7,6,1,1,0,1
konzentrieren,2,3,1,1,1,0,1
liefern,3,3,0,0,-1,0,1
erreichen,12,3,9,1,-1,0,1
präsentieren,18,4,14,1,-1,0,1
erreichen,2,4,-2,-1,-1,0,1
erzielen,9,3,6,1,-1,0,1
stellen,5,3,2,1,-1,0,1
setzen,4,5,-1,-1,-1,0,1
handeln,1,14,13,1,1,1,1
geben,2,11,9,1,1,0,1
erzielen,1,7,-6,-1,-1,0,1
handeln,1,5,4,1,1,1,1
schalten,3,4,1,1,1,0,1
bieten,8,5,3,1,-1,0,1
unterstützen,7,12,-5,-1,-1,0,1
befördern,1,6,5,1,1,0,1
geben,2,7,5,1,1,0,1
planen,1,3,2,1,1,0,1
kündigen,4,4,0,0,-1,0,1
setzen,4,6,-2,-1,-1,0,1
präsentieren,1,13,12,1,1,1,1
kündigen,1,5,4,1,1,1,1
unterstützen,3,4,1,1,1,0,1
planen,2,5,-3,-1,-1,0,1
lehnen,5,2,3,1,-1,0,1
nehmen,1,7,-6,-1,-1,0,1
stellen,4,2,2,1,-1,1,1
bündeln,10,3,7,1,-1,0,1
vereinen,2,3,1,1,1,0,1
stellen,8,3,5,1,-1,0,1
bieten,6,3,3,1,-1,0,1
weisen,2,3,-1,-1,-1,0,1
kündigen,2,3,1,1,1,0,1
schlagen,2,4,-2,-1,-1,0,1
bieten,7,4,3,1,-1,0,1
stellen,5,2,3,1,-1,0,1
schaffen,11,2,9,1,-1,0,1
bieten,11,2,9,1,-1,0,1
kosten,4,4,0,0,-1,0,1
schlagen,2,5,-3,-1,-1,0,1
erhoffen,16,2,14,1,-1,0,1
verlangen,7,3,4,1,-1,0,1
stellen,19,2,17,1,-1,0,1
stellen,5,3,2,1,-1,0,1
bieten,19,3,16,1,-1,0,1
zeigen,4,3,1,1,-1,0,1
finden,12,3,9,1,-1,0,1
greifen,5,3,2,1,-1,0,1
senken,2,7,5,1,1,0,1
berechnen,5,3,-2,-1,1,0,1
stellen,4,3,1,1,-1,0,1
bieten,3,2,1,1,-1,0,1
schreiben,12,3,-9,-1,1,0,1
kosten,7,5,2,1,-1,0,1
bauen,6,2,4,1,-1,0,1
unterstützen,1,7,6,1,1,1,1
steuern,10,3,7,1,-1,0,1
gehen,2,2,0,0,1,0,1
schlagen,2,4,-2,-1,-1,0,1
vervierfachen,2,5,3,1,1,0,1
rechnen,7,2,5,1,-1,0,1
nehmen,2,2,0,0,-1,0,1
wirken,1,12,11,1,1,1,1
halten,9,3,6,1,-1,0,1
erteilen,2,6,-4,-1,-1,0,1
nutzen,1,3,2,1,1,1,1
stellen,6,3,3,1,-1,0,1
zahlen,5,3,2,1,-1,0,1
bieten,7,3,4,1,-1,0,1
bekommen,3,2,-1,-1,1,0,1
verbuchen,13,4,9,1,-1,0,1
verfolgen,4,2,2,1,-1,0,1
sehen,1,3,2,1,1,1,1
kosten,3,2,1,1,-1,0,1
zahlen,2,2,0,0,-1,0,1
halten,2,3,1,1,1,0,1
zeigen,20,3,17,1,-1,0,1
sagen,5,4,1,1,-1,0,1
bahnen,1,6,5,1,1,1,1
gehen,4,5,-1,-1,-1,0,1
erhalten,10,6,-4,-1,1,0,1
erwarten,1,4,3,1,1,0,1
sehen,2,4,-2,-1,-1,0,1
häufen,1,5,4,1,1,1,1
weisen,2,4,2,1,1,0,1
enthalten,16,3,13,1,-1,0,1
geben,2,6,-4,-1,-1,0,1
ersteigern,5,8,-3,-1,-1,0,1
kaufen,9,6,-3,-1,1,0,1
reklamieren,5,2,-3,-1,1,-1,1
nutzen,18,3,15,1,-1,0,1
übernehmen,8,2,6,1,-1,0,1
erwarten,7,3,4,1,-1,0,1
bekommen,1,3,-2,-1,-1,0,1
zahlen,4,6,-2,-1,-1,0,1
kosten,15,5,10,1,-1,0,1
ordern,1,2,1,1,1,0,1
präsentieren,14,3,11,1,-1,0,1
unterstützen,3,2,1,1,-1,0,1
erweitern,2,4,2,1,1,0,1
bieten,3,5,-2,-1,-1,0,1
setzen,1,4,3,1,1,0,1
richten,1,19,18,1,1,1,1
bringen,7,2,-5,-1,1,1,1
rechnen,7,3,4,1,-1,0,1
bekommen,13,6,7,1,-1,0,1
lassen,1,3,2,1,1,1,1
belaufen,1,5,4,1,1,1,1
belaufen,1,5,4,1,1,1,1
schlagen,2,6,-4,-1,-1,0,1
verschlüsseln,1,2,1,1,1,0,1
entwickeln,14,4,10,1,-1,0,1
drücken,4,3,1,1,-1,0,1
tauschen,3,3,0,0,-1,0,1
erzielen,9,3,6,1,-1,0,1
erzielen,6,3,3,1,-1,0,1
zahlen,3,2,-1,-1,1,0,1
betragen,2,2,0,0,-1,0,1
liefern,12,3,9,1,-1,0,1
installieren,6,7,-1,-1,-1,0,1
senken,4,5,1,1,1,0,1
sehen,3,2,1,1,-1,0,1
verzeichnen,4,2,-2,-1,1,0,1
geben,12,4,8,1,-1,0,1
geben,16,2,14,1,-1,0,1
sorgen,6,2,4,1,-1,1,1
nehmen,1,2,1,1,1,1,1
bieten,3,3,0,0,1,0,1
kosten,4,2,2,1,-1,0,1
versprechen,14,3,11,1,-1,0,1
zitieren,30,3,27,1,-1,0,1
umgehen,1,2,1,1,1,0,1
setzen,3,20,-17,-1,-1,0,1
demonstrieren,17,2,15,1,-1,0,1
stellen,4,10,-6,-1,-1,0,1
enthalten,5,5,0,0,-1,0,1
bringen,12,3,9,1,-1,0,1
überfordern,3,7,4,1,1,0,1
erfordern,5,3,-2,-1,1,0,1
gründen,3,4,-1,-1,-1,0,1
treiben,4,6,2,1,1,0,1
betragen,4,3,-1,-1,1,0,1
nehmen,2,3,1,1,1,0,1
illustrieren,19,2,17,1,-1,1,1
verklagen,1,7,6,1,1,0,1
stellen,7,2,-5,-1,1,0,1
handeln,1,33,32,1,1,1,1
unterstützen,2,4,2,1,1,0,1
kommen,1,3,2,1,1,0,1
erzielen,5,3,2,1,-1,0,1
liefern,6,12,6,1,1,0,1
übertreffen,6,3,-3,-1,1,0,1
präsentieren,10,2,8,1,-1,0,1
finden,8,9,-1,-1,-1,0,1
entscheiden,1,9,8,1,1,1,1
läuten,5,5,0,0,-1,0,1
halten,18,6,12,1,-1,0,1
setzen,3,5,-2,-1,-1,0,1
finden,5,3,-2,-1,1,0,1
betragen,2,2,0,0,1,0,1
heben,3,2,1,1,-1,0,1
verklagen,3,5,2,1,1,0,1
schreiben,1,3,2,1,1,0,1
erlauben,30,5,25,1,-1,0,1
bieten,5,4,-1,-1,1,0,1
kündigen,3,7,4,1,1,0,1
erhalten,6,2,4,1,-1,0,1
laden,4,3,-1,-1,1,0,1
gewinnen,3,5,-2,-1,-1,0,1
bieten,8,3,5,1,-1,0,1
genießen,1,2,-1,-1,-1,0,1
setzen,2,6,4,1,1,0,1
demonstrieren,2,8,6,1,1,0,1
überbrücken,3,2,1,1,-1,0,1
führen,1,6,-5,-1,-1,0,1
brauchen,10,3,7,1,-1,0,1
präsentieren,5,2,3,1,-1,0,1
drücken,2,3,1,1,1,0,1
geraten,2,8,-6,-1,-1,0,1
machen,4,6,-2,-1,-1,0,1
sehen,3,28,25,1,1,0,1
erwarten,4,11,-7,-1,-1,0,1
folgen,1,11,10,1,1,0,1
sehen,5,3,2,1,-1,0,1
schließen,2,4,-2,-1,-1,0,1
warnen,1,2,1,1,1,0,1
warnen,2,6,4,1,1,0,1
stellen,5,5,0,0,1,0,1
erwarten,5,3,2,1,-1,0,1
planen,9,4,5,1,-1,0,1
veröffentlichen,9,3,6,1,-1,0,1
handeln,1,18,17,1,1,1,1
treten,5,2,-3,-1,1,0,1
fangen,11,4,7,1,-1,0,1
steigern,4,3,-1,-1,1,0,1
halten,1,6,-5,-1,-1,0,1
kommen,3,2,1,1,-1,0,1
spiegeln,3,12,9,1,1,0,1
bringen,2,3,1,1,1,0,1
steuern,4,3,-1,-1,1,0,1
brauchen,5,3,2,1,-1,0,1
erhalten,5,8,-3,-1,-1,0,1
geben,1,4,-3,-1,-1,0,1
rechnen,3,4,-1,-1,-1,0,1
testen,5,7,2,1,1,0,1
lassen,1,8,7,1,1,1,1
beschäftigen,3,5,-2,-1,-1,0,1
fordern,2,2,0,0,1,0,1
fordern,6,4,2,1,-1,0,1
handeln,1,9,8,1,1,1,1
sehen,2,13,11,1,1,0,1
sehen,7,6,1,1,-1,0,1
versetzen,3,15,12,1,1,0,1
verspüren,3,5,2,1,1,0,1
verzeichnen,6,5,-1,-1,1,0,1
geben,11,2,9,1,-1,0,1
fällen,1,3,2,1,1,0,1
verkaufen,4,2,2,1,-1,0,1
richten,1,13,12,1,1,1,1
nehmen,1,2,1,1,1,0,1
kosten,2,2,0,0,-1,0,1
erhalten,2,5,-3,-1,-1,0,1
erheben,5,2,3,1,-1,0,1
bemalen,5,4,-1,-1,1,0,1
danken,2,3,1,1,1,0,1
gehören,5,2,3,1,-1,0,1
übernehmen,3,2,1,1,-1,0,1
stehen,2,7,5,1,1,0,1
starten,3,3,0,0,-1,0,1
werfen,2,3,-1,-1,-1,0,1
handeln,1,20,19,1,1,1,1
sehen,8,2,-6,-1,1,0,1
drohen,2,2,0,0,1,0,1
formulieren,1,4,3,1,1,1,1
bauen,1,2,-1,-1,-1,0,1
beraten,6,2,4,1,-1,0,1
verlieren,3,3,0,0,-1,0,1
verlieren,3,3,0,0,-1,0,1
unterstützen,11,3,8,1,-1,0,1
erwarten,7,2,-5,-1,1,0,1
bieten,2,2,0,0,-1,0,1
kündigen,5,4,1,1,-1,0,1
führen,16,4,12,1,-1,0,1
preisen,14,2,12,1,-1,1,1
handeln,1,6,5,1,1,1,1
konfrontieren,3,26,23,1,1,0,1
stellen,2,2,0,0,1,0,1
nehmen,3,3,0,0,1,0,1
richten,1,4,3,1,1,1,1
behindern,8,8,0,0,-1,0,1
verlängern,5,3,-2,-1,1,0,1
erhalten,4,7,-3,-1,-1,0,1
entsprechen,2,6,-4,-1,-1,0,1
stellen,4,12,8,1,1,0,1
bekommen,2,2,0,0,-1,0,1
mangeln,3,2,1,1,-1,1,1
mangeln,5,2,3,1,-1,1,1
beschäftigen,4,2,2,1,-1,0,1
dementieren,14,2,12,1,-1,0,1
bringen,1,7,6,1,1,1,1
verbuchen,6,3,3,1,-1,0,1
stehen,3,4,1,1,1,0,1
verpflichten,1,2,1,1,1,0,1
erinnern,3,3,0,0,-1,0,1
lassen,3,3,0,0,-1,0,1
simulieren,3,2,-1,-1,1,0,1
speichern,1,18,17,1,1,1,1
bauen,3,2,1,1,-1,0,1
verfolgen,2,9,-7,-1,-1,0,1
übernehmen,5,2,3,1,-1,0,1
übernehmen,4,4,0,0,-1,0,1
heimsen,1,4,-3,-1,-1,0,1
geben,3,3,0,0,-1,0,1
erklären,4,16,12,1,1,0,1
knipsen,2,5,-3,-1,-1,0,1
halten,1,3,-2,-1,-1,0,1
ziehen,2,3,-1,-1,-1,0,1
stampfen,4,3,1,1,-1,0,1
führen,7,7,0,0,-1,0,1
verbuchen,6,3,3,1,-1,0,1
vertagen,2,4,2,1,1,0,1
reichen,1,2,1,1,1,1,1
behaupten,2,6,-4,-1,-1,0,1
belaufen,1,5,4,1,1,1,1
versteigern,1,2,1,1,1,0,1
streichen,1,3,-2,-1,-1,0,1
mangeln,3,3,0,0,-1,0,1
prognostizieren,8,4,4,1,-1,0,1
bereiten,1,4,-3,-1,-1,0,1
schlagen,3,4,-1,-1,-1,0,1
besiegen,7,2,-5,-1,1,0,1
gewinnen,4,4,0,0,-1,0,1
korrigieren,7,5,-2,-1,1,0,1
locken,3,3,0,0,1,0,1
umreißen,5,4,1,1,-1,0,1
finden,2,17,15,1,1,0,1
lenken,2,5,-3,-1,-1,0,1
drohen,3,2,1,1,-1,0,1
schlagen,2,2,0,0,-1,0,1
kritisieren,2,3,1,1,1,0,1
schließen,2,4,-2,-1,-1,0,1
steuern,6,3,3,1,-1,0,1
fallen,1,5,4,1,1,1,1
favorisieren,5,4,1,1,-1,0,1
sehen,4,3,1,1,-1,0,1
widersprechen,5,4,1,1,-1,0,1
kommen,3,4,1,1,1,0,1
legen,1,3,2,1,1,1,1
enthalten,2,2,0,0,-1,0,1
zeigen,1,3,2,1,1,1,1
finden,4,4,0,0,-1,0,1
sorgen,2,6,-4,-1,-1,0,1
warnen,1,2,1,1,1,0,1
treiben,2,3,1,1,1,0,1
akzeptieren,3,2,1,1,-1,0,1
warten,5,3,2,1,-1,0,1
fahren,2,2,0,0,1,0,1
lösen,3,2,1,1,-1,0,1
führen,1,4,3,1,1,0,1
bringen,1,10,9,1,1,1,1
stimmen,7,3,4,1,-1,0,1
bieten,2,2,0,0,1,0,1
geben,4,9,-5,-1,-1,0,1
treffen,2,2,0,0,1,0,1
rangieren,1,2,-1,-1,-1,0,1
erreichen,5,4,1,1,-1,0,1
erreichen,7,4,3,1,-1,0,1
landen,1,2,-1,-1,-1,0,1
setzen,4,3,1,1,-1,0,1
verkaufen,3,3,0,0,-1,0,1
bilanzieren,7,4,3,1,-1,0,1
führen,4,2,-2,-1,1,0,1
machen,4,3,1,1,-1,0,1
geben,3,3,0,0,-1,0,1
geben,2,2,0,0,-1,0,1
erwarten,5,3,2,1,-1,0,1
verweisen,7,3,4,1,-1,0,1
verabschieden,1,3,2,1,1,1,1
setzen,8,2,6,1,-1,0,1
rufen,1,3,2,1,1,0,1
handeln,1,9,8,1,1,1,1
passen,2,4,2,1,1,0,1
geben,5,4,1,1,-1,0,1
absolvieren,4,3,1,1,-1,0,1
taxieren,5,9,4,1,1,0,1
erfahren,6,4,2,1,-1,0,1
frisieren,3,3,0,0,1,0,1
belasten,3,8,5,1,1,0,1
bekommen,2,2,0,0,1,0,1
sehen,2,3,-1,-1,-1,0,1
verlangen,14,3,11,1,-1,0,1
nennen,2,9,7,1,1,0,1
rechnen,3,3,0,0,-1,0,1
bitten,1,2,1,1,1,0,1
stoßen,5,4,1,1,-1,0,1
geben,9,4,5,1,-1,0,1
setzen,6,3,3,1,-1,0,1
legen,1,3,2,1,1,0,1
holen,5,5,0,0,1,0,1
bringen,1,13,12,1,1,1,1
verstecken,1,2,1,1,1,0,1
drohen,2,6,4,1,1,0,1
entdecken,12,3,9,1,-1,0,1
stoßen,1,2,1,1,1,0,1
erobern,5,3,2,1,-1,0,1
verkaufen,2,3,1,1,1,0,1
drohen,4,3,-1,-1,1,0,1
belaufen,1,3,2,1,1,1,1
drängen,2,3,-1,-1,-1,0,1
weisen,2,4,-2,-1,-1,0,1
ködern,1,2,1,1,1,0,1
streben,15,3,12,1,-1,0,1
rechnen,9,3,6,1,-1,0,1
beschäftigen,3,2,-1,-1,1,0,1
kommentieren,2,2,0,0,-1,0,1
nutzen,1,3,2,1,1,1,1
bereiten,6,8,-2,-1,-1,0,1
stoßen,8,5,3,1,-1,0,1
machen,4,2,-2,-1,1,0,1
beschäftigen,4,2,-2,-1,1,0,1
erhöhen,2,3,1,1,1,0,1
richten,2,7,5,1,1,0,1
bilanzieren,6,3,3,1,-1,0,1
sehen,3,2,-1,-1,1,0,1
bieten,7,2,5,1,-1,0,1
lehnen,6,4,-2,-1,1,0,1
erwarten,5,3,2,1,-1,0,1
weisen,9,3,6,1,-1,0,1
richten,1,14,13,1,1,1,1
kassieren,7,10,-3,-1,-1,0,1
sitzen,4,2,2,1,-1,0,1
erwähnen,2,4,-2,-1,-1,0,1
beklagen,4,2,2,1,-1,1,1
sehen,17,2,-15,-1,1,0,1
drohen,2,2,0,0,1,0,1
büßen,4,2,-2,-1,1,0,1
fordern,4,3,1,1,-1,0,1
sagen,5,2,3,1,-1,0,1
sehen,20,6,14,1,-1,0,1
drohen,1,2,1,1,1,0,1
reagieren,15,3,12,1,-1,0,1
fassen,3,3,0,0,-1,0,1
stoppen,4,4,0,0,-1,0,1
bündeln,2,5,3,1,1,0,1
erreichen,4,5,1,1,1,0,1
richten,1,15,14,1,1,1,1
überantworten,2,14,12,1,1,0,1
rechnen,6,7,-1,-1,-1,0,1
fordern,4,3,-1,-1,1,0,1
führen,2,3,-1,-1,-1,0,1
finden,14,2,12,1,-1,1,1
trinken,2,6,4,1,1,0,1
sehen,9,2,-7,-1,1,0,1
stellen,3,3,0,0,1,0,1
bringen,3,6,3,1,1,0,1
vergeben,4,2,-2,-1,1,0,1
rühren,2,12,-10,-1,-1,0,1
drohen,1,2,1,1,1,0,1
handeln,1,9,8,1,1,1,1
stocken,2,3,1,1,1,0,1
greifen,2,7,5,1,1,0,1
vermarkten,2,8,6,1,1,0,1
verklagen,1,10,9,1,1,0,1
-,9,2,7,1,-1,0,1
verfügen,8,7,1,1,-1,0,1
schließen,16,3,13,1,-1,0,1
stellen,3,6,-3,-1,-1,0,1
sperren,2,6,-4,-1,-1,0,1
verteidigen,2,14,12,1,1,0,1
äußern,1,24,23,1,1,1,1
rechnen,7,5,2,1,-1,0,1
werfen,9,3,6,1,-1,0,1
fordern,2,7,5,1,1,0,1
zahlen,4,8,-4,-1,-1,0,1
bringen,7,4,3,1,-1,0,1
heißen,1,2,-1,-1,-1,0,1
erhalten,6,2,4,1,-1,0,1
zeichnen,1,2,1,1,1,1,1
versprechen,1,2,-1,-1,-1,0,1
kündigen,5,2,3,1,-1,0,1
bezahlen,3,3,0,0,-1,0,1
bekommen,2,3,-1,-1,-1,0,1
lesen,1,9,8,1,1,1,1
zählen,5,2,3,1,-1,1,1
planen,4,3,1,1,-1,0,1
geben,2,5,-3,-1,-1,0,1
verschärfen,1,2,1,1,1,0,1
handeln,1,7,6,1,1,1,1
werben,7,11,-4,-1,-1,0,1
versprechen,3,3,0,0,-1,0,1
planen,5,3,2,1,-1,0,1
kündigen,12,2,10,1,-1,0,1
entwickeln,1,4,-3,-1,-1,0,1
stellen,1,3,2,1,1,0,1
begründen,3,3,0,0,1,0,1
besitzen,11,2,9,1,-1,0,1
erwähnen,3,3,0,0,1,0,1
senken,2,2,0,0,1,-1,1
handeln,1,8,7,1,1,1,1
erwarten,3,4,-1,-1,-1,0,1
bedeuten,2,2,0,0,1,0,1
bieten,17,2,15,1,-1,0,1
bringen,2,2,0,0,1,0,1
zeigen,1,5,4,1,1,1,1
erklären,1,2,1,1,1,0,1
stellen,2,6,-4,-1,-1,0,1
führen,5,4,1,1,-1,0,1
rechnen,3,3,0,0,-1,0,1
erwarten,2,3,1,1,1,0,1
handeln,1,13,12,1,1,1,1
bringen,1,5,4,1,1,1,1
ziehen,7,3,-4,-1,1,0,1
stellen,9,3,6,1,-1,0,1
rechnen,4,4,0,0,-1,0,1
kündigen,5,3,2,1,-1,0,1
bekommen,4,3,-1,-1,1,0,1
inszenieren,6,6,0,0,1,0,1
setzen,1,3,2,1,1,0,1
schrauben,2,4,2,1,1,0,1
übertreffen,2,3,1,1,1,0,1
setzen,4,6,-2,-1,-1,0,1
kündigen,4,3,1,1,-1,0,1
verlagern,2,3,1,1,1,0,1
beraten,6,2,-4,-1,1,0,1
quittieren,2,5,3,1,1,0,1
belaufen,1,4,3,1,1,1,1
bieten,4,3,1,1,-1,0,1
übertreffen,3,2,-1,-1,1,0,1
bringen,4,4,0,0,-1,0,1
bieten,7,6,1,1,-1,0,1
werfen,3,4,-1,-1,-1,0,1
stellen,6,3,3,1,-1,0,1
benötigen,5,6,-1,-1,-1,0,1
halten,3,3,0,0,1,0,1
bringen,5,7,2,1,1,0,1
beschwichtigen,1,18,17,1,1,0,1
reagieren,3,2,1,1,-1,0,1
rechnen,7,2,5,1,-1,0,1
weisen,15,4,11,1,-1,0,1
schließen,3,10,7,1,1,0,1
rechnen,7,2,5,1,-1,0,1
weisen,9,2,7,1,-1,0,1
schätzen,8,5,-3,-1,1,0,1
prüfen,8,2,6,1,-1,0,1
geben,1,8,-7,-1,-1,0,1
berichten,1,2,-1,-1,-1,0,1
beleuchten,4,2,2,1,-1,0,1
setzen,2,13,11,1,1,0,1
sorgen,3,13,-10,-1,-1,0,1
schotten,1,3,2,1,1,0,1
geben,3,8,-5,-1,-1,0,1
versprechen,1,6,5,1,1,0,1
führen,2,3,1,1,1,0,1
konfrontieren,2,20,18,1,1,0,1
-,3,3,0,0,-1,0,1
hinterlassen,3,11,-8,-1,-1,0,1
drohen,4,3,-1,-1,1,0,1
verschaffen,5,2,3,1,-1,0,1
öffnen,2,4,2,1,1,0,1
geben,2,3,-1,-1,-1,0,1
setzen,2,2,0,0,1,0,1
stellen,5,2,3,1,-1,-1,1
bringen,2,3,1,1,1,0,1
zeigen,6,6,0,0,-1,0,1
fordern,2,2,0,0,-1,0,1
rufen,3,4,-1,-1,-1,0,1
steuern,3,6,3,1,1,0,1
bringen,1,4,3,1,1,1,1
handeln,1,9,8,1,1,1,1
halten,5,2,3,1,-1,0,1
rechnen,1,2,-1,-1,-1,0,1
untersagen,1,19,18,1,1,1,1
erwecken,10,9,1,1,-1,0,1
handeln,1,5,4,1,1,1,1
überspringen,2,5,-3,-1,-1,0,1
bauen,4,14,10,1,1,0,1
verlangen,7,3,4,1,-1,0,1
erhalten,3,4,-1,-1,-1,0,1
führen,26,2,24,1,-1,0,1
konfrontieren,2,18,16,1,1,0,1
reißen,1,3,2,1,1,0,1
erhoffen,18,3,15,1,-1,0,1
verdienen,3,3,0,0,-1,0,1
erwarten,4,8,-4,-1,-1,0,1
präsentieren,2,2,0,0,1,0,1
finden,1,18,17,1,1,0,1
steigern,2,3,1,1,1,0,1
stoßen,5,8,-3,-1,-1,0,1
halten,11,2,9,1,-1,0,1
kündigen,9,2,7,1,-1,0,1
halten,7,7,0,0,1,0,1
halten,1,10,-9,-1,-1,0,1
machen,1,2,1,1,1,0,0
mehren,1,3,-2,-1,-1,-1,0
planen,10,5,-5,-1,1,0,0
fordern,7,3,4,1,-1,0,0
vertagen,2,6,-4,-1,-1,0,0
malen,4,5,1,1,1,0,0
schreiben,2,11,9,1,1,0,0
stärken,4,4,0,0,-1,0,0
nehmen,3,2,1,1,-1,0,0
melden,6,6,0,0,1,0,0
führen,3,9,-6,-1,-1,0,0
erhalten,2,2,0,0,1,0,0
rechnen,7,4,-3,-1,1,0,0
nehmen,1,2,1,1,1,0,0
handeln,1,4,-3,-1,-1,-1,0
bitten,8,3,5,1,-1,0,0
nutzen,2,4,-2,-1,-1,0,0
gehören,4,4,0,0,1,0,0
erwirtschaften,6,3,-3,-1,1,0,0
setzen,6,3,-3,-1,1,0,0
schlagen,2,5,3,1,1,0,0
rechnen,5,2,-3,-1,1,0,0
ziehen,2,7,-5,-1,-1,0,0
führen,6,2,4,1,-1,0,0
rechnen,2,8,6,1,1,0,0
beantworten,5,4,1,1,-1,0,0
erwarten,3,3,0,0,1,0,0
schicken,3,6,-3,-1,-1,0,0
beschäftigen,8,2,-6,-1,1,0,0
unternehmen,19,3,-16,-1,1,0,0
kosten,2,3,1,1,1,0,0
erhoffen,2,2,0,0,1,0,0
führen,2,18,-16,-1,-1,0,0
beziffern,4,4,0,0,-1,0,0
erwarten,2,6,4,1,1,0,0
planen,4,3,-1,-1,1,0,0
starten,2,4,2,1,1,0,0
demonstrieren,1,3,-2,-1,-1,0,0
planen,5,3,-2,-1,1,0,0
deuten,1,3,-2,-1,-1,-1,0
rechnen,8,6,-2,-1,1,0,0
gehen,10,3,-7,-1,1,0,0
schaden,4,3,-1,-1,1,0,0
quittieren,2,2,0,0,-1,0,0
bereiten,1,4,-3,-1,-1,-1,0
verdoppeln,5,4,1,1,-1,0,0
bezeichnen,2,6,-4,-1,-1,0,0
streichen,2,3,1,1,1,0,0
rekrutieren,1,2,-1,-1,-1,0,0
bedeuten,5,2,-3,-1,1,0,0
versorgen,1,7,-6,-1,-1,0,0
sichern,5,7,2,1,1,0,0
führen,2,8,-6,-1,-1,0,0
begründen,2,9,-7,-1,-1,0,0
stoppen,9,2,-7,-1,1,0,0
kündigen,9,3,-6,-1,1,0,0
führen,4,12,-8,-1,-1,0,0
verschieben,7,3,4,1,-1,0,0
winken,2,2,0,0,-1,0,0
führen,16,3,-13,-1,1,0,0
entpuppen,1,2,-1,-1,-1,-1,0
sehen,5,3,-2,-1,1,0,0
sehen,6,6,0,0,-1,0,0
liefern,6,15,-9,-1,-1,0,0
stellen,2,3,1,1,1,0,0
kündigen,1,4,-3,-1,-1,-1,0
kündigen,4,4,0,0,1,0,0
fordern,6,2,-4,-1,1,0,0
fordern,2,4,2,1,1,0,0
sprechen,2,3,-1,-1,-1,0,0
machen,1,18,17,1,1,0,0
drohen,3,3,0,0,-1,0,0
erwarten,9,8,-1,-1,1,0,0
beschäftigen,4,2,-2,-1,1,0,0
übernehmen,1,3,-2,-1,-1,0,0
betragen,4,4,0,0,1,0,0
schleppen,10,2,8,1,-1,1,0
verbinden,2,2,0,0,-1,0,0
stehen,4,2,2,1,-1,0,0
setzen,4,3,-1,-1,1,0,0
deuten,1,5,-4,-1,-1,-1,0
weisen,6,3,-3,-1,1,0,0
finden,1,3,2,1,1,0,0
beobachten,4,2,2,1,-1,0,0
belaufen,1,4,-3,-1,-1,-1,0
teilen,3,11,-8,-1,-1,0,0
verschieben,2,3,-1,-1,-1,0,0
entschuldigen,2,15,-13,-1,-1,0,0
halten,8,2,-6,-1,1,0,0
verzichten,3,2,-1,-1,1,0,0
stoßen,4,4,0,0,1,0,0
bieten,7,4,-3,-1,1,0,0
bringen,1,8,-7,-1,-1,-1,0
handeln,1,4,-3,-1,-1,-1,0
verzeichnen,3,3,0,0,1,0,0
büßen,4,3,-1,-1,1,0,0
führen,14,3,-11,-1,1,0,0
erhalten,3,3,0,0,1,0,0
verabschieden,8,5,-3,-1,1,0,0
rechnen,7,6,-1,-1,1,0,0
führen,2,16,-14,-1,-1,0,0
bieten,6,7,-1,-1,-1,0,0
halten,2,7,-5,-1,-1,0,0
wickeln,4,2,2,1,-1,0,0
kaufen,1,2,-1,-1,-1,-1,0
rüsten,12,2,10,1,-1,0,0
löschen,2,6,-4,-1,-1,0,0
begleichen,8,4,4,1,-1,0,0
veröffentlichen,6,3,3,1,-1,0,0
beraten,3,3,0,0,1,0,0
handeln,1,13,-12,-1,-1,-1,0
lassen,1,3,-2,-1,-1,-1,0
erhalten,7,3,4,1,-1,0,0
führen,3,8,-5,-1,-1,0,0
bringen,1,2,-1,-1,-1,0,0
führen,14,6,-8,-1,1,0,0
liefern,2,2,0,0,-1,0,0
nehmen,1,2,-1,-1,-1,0,0
verteidigen,2,7,-5,-1,-1,0,0
verkaufen,4,6,-2,-1,-1,0,0
gewähren,5,3,-2,-1,1,0,0
bergen,4,2,-2,-1,1,0,0
führen,1,3,-2,-1,-1,0,0
erwarten,2,2,0,0,-1,0,0
handeln,1,6,-5,-1,-1,-1,0
warten,8,2,-6,-1,1,0,0
geben,10,4,-6,-1,1,0,0
halten,3,3,0,0,-1,0,0
richten,1,4,-3,-1,-1,-1,0
melden,5,4,1,1,-1,0,0
geben,3,6,3,1,1,0,0
erwarten,7,2,-5,-1,1,0,0
berichten,4,5,-1,-1,-1,0,0
stecken,2,2,0,0,-1,0,0
zeigen,1,2,1,1,1,0,0
treten,2,4,2,1,1,0,0
bringen,20,3,-17,-1,1,0,0
nehmen,7,5,-2,-1,1,0,0
erhoffen,2,5,3,1,1,0,0
vergleichen,4,5,-1,-1,-1,0,0
stellen,10,2,8,1,-1,0,0
fallen,2,8,-6,-1,-1,0,0
halten,1,14,-13,-1,-1,0,0
verfügen,6,2,-4,-1,1,0,0
geben,6,7,-1,-1,-1,0,0
gefährden,2,4,-2,-1,-1,0,0
heben,1,4,-3,-1,-1,-1,0
rechnen,8,4,-4,-1,1,0,0
bescheren,7,3,-4,-1,1,0,0
enthüllen,6,7,1,1,1,0,0
zeigen,4,3,-1,-1,1,0,0
überweisen,2,7,-5,-1,-1,0,0
ergänzen,2,11,-9,-1,-1,0,0
bieten,15,3,-12,-1,1,0,0
zahlen,2,3,1,1,1,0,0
umfassen,2,3,1,1,1,0,0
verweisen,8,3,-5,-1,1,0,0
stellen,12,4,-8,-1,1,0,0
entrichten,3,3,0,0,-1,0,0
erfassen,15,4,-11,-1,1,0,0
stellen,2,2,0,0,-1,0,0
benachteiligen,2,4,-2,-1,-1,0,0
rufen,3,3,0,0,-1,0,0
richten,1,5,-4,-1,-1,-1,0
suchen,3,3,0,0,1,0,0
fühlen,1,3,-2,-1,-1,-1,0
weisen,1,2,1,1,1,0,0
zeigen,1,2,-1,-1,-1,-1,0
wenden,1,2,-1,-1,-1,-1,0
richten,1,6,-5,-1,-1,-1,0
verkaufen,10,3,7,1,-1,0,0
liefern,5,5,0,0,1,0,0
verlieren,6,3,3,1,-1,0,0
kündigen,9,12,3,1,1,0,0
halten,6,3,-3,-1,1,0,0
legen,3,3,0,0,1,0,0
machen,5,7,2,1,1,0,0
schreiben,2,6,4,1,1,0,0
verändern,4,3,1,1,-1,0,0
legen,1,2,-1,-1,-1,0,0
zahlen,9,6,-3,-1,1,0,0
geben,10,2,-8,-1,1,0,0
erwarten,8,4,-4,-1,1,0,0
widersprechen,4,26,-22,-1,-1,0,0
relativieren,2,8,-6,-1,-1,0,0
beziffern,4,4,0,0,-1,0,0
führen,5,6,1,1,1,0,0
bilden,2,3,1,1,1,0,0
zeichnen,1,6,-5,-1,-1,-1,0
belaufen,1,5,-4,-1,-1,-1,0
gründen,1,6,-5,-1,-1,-1,0
administrieren,50,2,-48,-1,1,0,0
bieten,3,5,2,1,1,0,0
verlieren,4,3,-1,-1,1,0,0
erstatten,3,3,0,0,1,0,0
beginnen,2,4,2,1,1,0,0
stellen,4,3,-1,-1,1,0,0
reagieren,4,2,-2,-1,1,0,0
reklamieren,4,2,-2,-1,1,-1,0
holen,2,8,-6,-1,-1,0,0
gründen,1,15,-14,-1,-1,-1,0
verdienen,6,6,0,0,1,0,0
leiten,1,6,-5,-1,-1,-1,0
richten,1,4,-3,-1,-1,-1,0
entsprechen,5,4,-1,-1,1,0,0
verbergen,2,15,13,1,1,0,0
weisen,4,2,-2,-1,1,0,0
wickeln,4,3,1,1,-1,0,0
bitten,6,2,4,1,-1,0,0
veröffentlichen,5,2,3,1,-1,0,0
führen,4,3,1,1,-1,0,0
schreiben,1,3,2,1,1,0,0
fordern,5,2,-3,-1,1,0,0
steigern,1,3,-2,-1,-1,0,0
erzielen,9,2,-7,-1,1,0,0
stellen,1,2,1,1,1,0,0
mahnen,1,2,-1,-1,-1,0,0
sehen,2,2,0,0,1,-1,0
belegen,2,7,5,1,1,0,0
treiben,4,3,1,1,-1,0,0
fahren,6,6,0,0,1,0,0
kündigen,6,2,-4,-1,1,0,0
vertreiben,2,7,-5,-1,-1,0,0
fotografieren,9,3,6,1,-1,0,0
ermitteln,9,2,-7,-1,1,0,0
speichern,1,4,-3,-1,-1,-1,0
zeigen,2,6,4,1,1,0,0
verdienen,3,7,4,1,1,0,0
stehen,1,2,-1,-1,-1,-1,0
sagen,3,2,1,1,-1,0,0
stellen,7,2,5,1,-1,0,0
verlangen,20,3,-17,-1,1,0,0
ernennen,1,3,-2,-1,-1,0,0
handeln,1,9,-8,-1,-1,-1,0
schreiben,2,3,-1,-1,-1,0,0
halten,1,2,-1,-1,-1,0,0
bekommen,4,2,-2,-1,1,0,0
stellen,2,3,1,1,1,0,0
bedeuten,6,5,-1,-1,1,0,0
erlauben,11,2,-9,-1,1,0,0
registrieren,9,2,-7,-1,1,-1,0
erleben,3,10,7,1,1,0,0
beurteilen,4,2,-2,-1,1,0,0
erzielen,4,2,2,1,-1,0,0
richten,1,2,-1,-1,-1,-1,0
schauen,2,4,2,1,1,0,0
drucken,4,3,1,1,-1,0,0
lehnen,2,13,-11,-1,-1,0,0
kündigen,3,3,0,0,1,0,0
gewinnen,4,3,-1,-1,1,0,0
betragen,3,10,-7,-1,-1,0,0
kontrollieren,15,5,-10,-1,1,0,0
betragen,3,3,0,0,1,0,0
lehnen,14,2,-12,-1,1,0,0
halten,2,3,1,1,1,0,0
kommen,2,17,-15,-1,-1,0,0
geben,7,4,3,1,-1,0,0
entscheiden,1,5,-4,-1,-1,-1,0
betragen,3,4,1,1,1,0,0
kaufen,9,4,-5,-1,1,0,0
erhalten,6,6,0,0,1,0,0
erachten,1,7,-6,-1,-1,-1,0
erwarten,11,3,-8,-1,1,0,0
speichern,2,6,-4,-1,-1,0,0
rufen,2,3,1,1,1,0,0
schieben,3,13,-10,-1,-1,0,0
entsprechen,3,2,-1,-1,1,0,0
benutzen,2,15,13,1,1,0,0
machen,1,5,4,1,1,0,0
kontaminieren,1,2,-1,-1,-1,0,0
beschießen,1,3,-2,-1,-1,0,0
bauen,1,4,-3,-1,-1,0,0
weisen,4,3,1,1,-1,0,0
nehmen,1,4,3,1,1,0,0
schicken,5,4,-1,-1,1,0,0
erhalten,1,3,2,1,1,0,0
sehen,5,7,2,1,1,0,0
handeln,1,7,-6,-1,-1,-1,0
warnen,3,6,-3,-1,-1,0,0
stoßen,2,4,2,1,1,0,0
legen,2,5,-3,-1,-1,0,0
wappnen,1,4,-3,-1,-1,-1,0
unterstützen,4,14,-10,-1,-1,0,0
bestehen,1,2,1,1,1,-1,0
erreichen,5,3,-2,-1,1,0,0
rufen,2,4,2,1,1,0,0
rufen,5,3,-2,-1,1,0,0
führen,3,7,-4,-1,-1,0,0
lehnen,1,3,-2,-1,-1,-1,0
berichten,15,7,-8,-1,1,0,0
lassen,1,3,-2,-1,-1,-1,0
versenden,1,3,-2,-1,-1,0,0
erkaufen,2,3,-1,-1,-1,0,0
suchen,4,4,0,0,1,0,0
handeln,1,15,-14,-1,-1,-1,0
lassen,1,2,-1,-1,-1,-1,0
fordern,2,6,4,1,1,0,0
durchsuchen,2,9,-7,-1,-1,0,0
testen,19,4,-15,-1,1,0,0
blockieren,2,4,2,1,1,0,0
nehmen,7,3,4,1,-1,0,0
fordern,2,3,1,1,1,0,0
belegen,2,21,-19,-1,-1,0,0
entsprechen,7,5,-2,-1,1,0,0
treten,2,3,1,1,1,0,0
geben,7,3,-4,-1,1,0,0
bieten,11,2,-9,-1,1,0,0
halten,4,2,-2,-1,1,0,0
geben,2,3,-1,-1,-1,0,0
spiegeln,5,3,-2,-1,1,0,0
stellen,6,2,4,1,-1,0,0
interviewen,1,3,2,1,1,0,0
erhalten,14,3,-11,-1,1,0,0
berichten,11,2,-9,-1,1,0,0
veröffentlichen,19,3,-16,-1,1,0,0
sorgen,2,8,6,1,1,0,0
fügen,2,4,2,1,1,0,0
richten,1,14,-13,-1,-1,-1,0
nehmen,2,2,0,0,-1,0,0
hören,1,7,-6,-1,-1,0,0
identifizieren,3,3,0,0,-1,0,0
widersprechen,7,3,-4,-1,1,0,0
stellen,9,8,-1,-1,1,0,0
erzeugen,4,4,0,0,1,0,0
kündigen,2,3,1,1,1,0,0
suchen,20,2,-18,-1,1,0,0
versenden,3,16,-13,-1,-1,0,0
bieten,8,3,-5,-1,1,0,0
erreichen,4,4,0,0,1,0,0
sehen,2,2,0,0,-1,0,0
lesen,29,2,-27,-1,1,0,0
benutzen,9,3,-6,-1,1,0,0
sehen,6,2,4,1,-1,0,0
verschwenden,2,3,1,1,1,0,0
eröffnen,1,4,-3,-1,-1,-1,0
stellen,3,3,0,0,-1,0,0
erhalten,7,5,2,1,-1,0,0
kritisieren,2,9,-7,-1,-1,0,0
bewegen,3,2,1,1,-1,0,0
verfolgen,3,2,1,1,-1,0,0
sehen,8,4,4,1,-1,0,0
umfassen,17,3,-14,-1,1,0,0
langweilen,1,2,-1,-1,-1,-1,0
weisen,1,2,1,1,1,0,0
vergleichen,2,7,-5,-1,-1,0,0
richten,1,3,-2,-1,-1,-1,0
benutzen,1,7,-6,-1,-1,0,0
setzen,1,4,-3,-1,-1,0,0
empfehlen,6,2,-4,-1,1,0,0
widerrufen,2,17,-15,-1,-1,0,0
stimmen,2,2,0,0,1,0,0
grenzen,1,3,-2,-1,-1,-1,0
erklären,1,4,-3,-1,-1,-1,0
setzen,38,3,-35,-1,1,0,0
wenden,1,3,-2,-1,-1,-1,0
ziehen,5,18,-13,-1,-1,0,0
stellen,5,5,0,0,-1,0,0
unterzeichnen,30,3,-27,-1,1,0,0
nennen,7,10,3,1,1,0,0
übernehmen,4,2,-2,-1,1,0,0
überprüfen,7,2,-5,-1,1,-1,0
erhalten,2,2,0,0,-1,0,0
suchen,1,2,-1,-1,-1,0,0
mehren,1,4,-3,-1,-1,-1,0
bitten,10,3,-7,-1,1,0,0
spielen,1,2,-1,-1,-1,-1,0
erhalten,4,2,-2,-1,1,0,0
geben,4,2,2,1,-1,0,0
bringen,1,6,-5,-1,-1,0,0
kaufen,3,4,1,1,1,0,0
verfügen,3,4,1,1,1,0,0
tun,1,8,-7,-1,-1,-1,0
nehmen,2,11,-9,-1,-1,0,0
erlauben,1,2,-1,-1,-1,-1,0
führen,2,5,-3,-1,-1,0,0
sehen,3,3,0,0,-1,0,0
erhalten,2,5,3,1,1,0,0
zeigen,1,10,-9,-1,-1,-1,0
geben,1,5,-4,-1,-1,0,0
wirken,1,3,2,1,1,0,0
durchsuchen,2,13,-11,-1,-1,0,0
lösen,13,9,-4,-1,1,0,0
fordern,6,12,6,1,1,0,0
beeinflussen,3,3,0,0,1,0,0
legitimieren,3,2,-1,-1,1,0,0
verwenden,3,4,1,1,1,0,0
erlauben,2,2,0,0,-1,0,0
besprechen,2,2,0,0,-1,0,0
weisen,2,2,0,0,-1,0,0
veröffentlichen,6,3,-3,-1,1,0,0
füllen,2,3,1,1,1,0,0
kondensieren,2,18,-16,-1,-1,0,0
vermuten,2,5,3,1,1,0,0
sehen,3,2,1,1,-1,0,0
spielen,3,6,3,1,1,0,0
untersuchen,7,8,-1,-1,-1,0,0
nutzen,2,2,0,0,1,0,0
sehen,22,2,-20,-1,1,0,0
üben,4,7,3,1,1,0,0
vermelden,3,3,0,0,1,0,0
schlagen,2,10,-8,-1,-1,0,0
erwarten,2,2,0,0,1,0,0
zeigen,7,2,-5,-1,1,0,0
genießen,3,4,1,1,1,0,0
richten,1,2,-1,-1,-1,0,0
zeigen,1,5,-4,-1,-1,-1,0
empfehlen,6,4,-2,-1,1,0,0
geben,2,3,-1,-1,-1,0,0
finden,16,3,-13,-1,1,0,0
formulieren,5,8,-3,-1,-1,0,0
verfügen,9,4,-5,-1,1,0,0
gratulieren,16,7,-9,-1,1,0,0
veralbern,6,4,-2,-1,1,0,0
schicken,2,13,-11,-1,-1,0,0
nehmen,1,3,2,1,1,0,0
fordern,2,3,1,1,1,0,0
verändern,14,7,7,1,-1,0,0
ernten,3,4,1,1,1,0,0
bejahen,4,6,2,1,1,0,0
erfüllen,2,3,1,1,1,0,0
halten,12,5,7,1,-1,0,0
nehmen,1,2,-1,-1,-1,0,0
rekrutieren,1,19,-18,-1,-1,-1,0
geben,3,6,3,1,1,0,0
zeichnen,1,8,-7,-1,-1,-1,0
öffnen,2,7,-5,-1,-1,0,0
bringen,2,7,-5,-1,-1,0,0
schulen,4,3,1,1,-1,0,0
komponieren,5,4,-1,-1,1,0,0
nehmen,3,2,1,1,-1,0,0
bieten,1,2,1,1,1,0,0
erzielen,4,4,0,0,1,0,0
erläutern,27,2,-25,-1,1,0,0
beschuldigen,2,3,-1,-1,-1,0,0
kosten,6,2,-4,-1,1,1,0
versehen,2,5,-3,-1,-1,0,0
erhoffen,2,3,1,1,1,0,0
fangen,15,3,-12,-1,1,0,0
geben,1,2,-1,-1,-1,0,0
erweitern,4,14,-10,-1,-1,0,0
bezeichnen,2,3,1,1,1,0,0
kommen,4,4,0,0,-1,0,0
machen,1,4,3,1,1,0,0
machen,1,19,-18,-1,-1,0,0
stehen,2,2,0,0,-1,0,0
bemängeln,13,2,-11,-1,1,-1,0
geben,16,5,-11,-1,1,0,0
vergeben,4,2,-2,-1,1,0,0
richten,1,11,-10,-1,-1,-1,0
verbreiten,2,4,2,1,1,0,0
dokumentieren,5,5,0,0,-1,0,0
rechnen,3,4,-1,-1,-1,0,0
stellen,4,2,2,1,-1,0,0
bieten,2,5,-3,-1,-1,0,0
geben,13,3,-10,-1,1,0,0
entstehen,3,2,1,1,-1,0,0
geben,3,2,-1,-1,1,0,0
durchsuchen,2,7,-5,-1,-1,0,0
schicken,2,3,-1,-1,-1,0,0
verbinden,2,6,-4,-1,-1,0,0
fügen,14,4,-10,-1,1,0,0
schaffen,2,3,-1,-1,-1,0,0
durchsuchen,1,2,-1,-1,-1,0,0
sehen,9,2,-7,-1,1,0,0
entwickeln,1,2,-1,-1,-1,0,0
begrüßen,2,3,1,1,1,0,0
betreffen,19,2,-17,-1,1,-1,0
finden,2,3,1,1,1,0,0
zeigen,6,4,-2,-1,1,0,0
bringen,1,2,-1,-1,-1,0,0
ziehen,4,5,1,1,1,0,0
geben,2,3,1,1,1,0,0
richten,3,3,0,0,-1,0,0
dienen,11,2,-9,-1,1,0,0
versprechen,24,5,-19,-1,1,0,0
erhalten,1,4,-3,-1,-1,0,0
publizieren,6,4,2,1,-1,0,0
sehen,3,8,-5,-1,-1,0,0
richten,1,21,-20,-1,-1,-1,0
nehmen,11,9,-2,-1,1,0,0
verabschieden,24,4,-20,-1,1,0,0
wenden,1,12,-11,-1,-1,-1,0
nehmen,1,2,-1,-1,-1,0,0
verstoßen,8,4,-4,-1,1,0,0
stellen,8,7,-1,-1,1,0,0
versprechen,1,6,-5,-1,-1,0,0
kritisieren,4,3,-1,-1,1,0,0
verbinden,1,3,-2,-1,-1,-1,0
steuern,4,3,1,1,-1,0,0
wechseln,7,3,4,1,-1,0,0
verändern,2,3,1,1,1,0,0
halten,2,4,-2,-1,-1,0,0
bekommen,5,2,3,1,-1,0,0
beanspruchen,18,3,-15,-1,1,0,0
enthalten,6,12,6,1,1,0,0
sehen,4,5,1,1,1,0,0
stellen,1,2,-1,-1,-1,-1,0
gehören,32,3,-29,-1,1,0,0
bestätigen,10,2,-8,-1,1,0,0
kündigen,5,16,11,1,1,0,0
fordern,5,4,-1,-1,1,0,0
setzen,2,3,-1,-1,-1,0,0
berichten,6,3,-3,-1,1,0,0
veranschlagen,3,7,4,1,1,0,0
sehen,7,6,1,1,-1,0,0
verstoßen,3,3,0,0,1,0,0
setzen,2,7,5,1,1,0,0
geben,26,2,-24,-1,1,0,0
setzen,1,7,6,1,1,0,0
setzen,15,6,-9,-1,1,0,0
entdecken,11,3,-8,-1,1,0,0
setzen,1,2,-1,-1,-1,0,0
machen,2,2,0,0,1,-1,0
machen,2,2,0,0,1,-1,0
geben,2,5,-3,-1,-1,0,0
fürchten,6,4,-2,-1,1,0,0
preisen,2,5,3,1,1,0,0
empfinden,4,5,-1,-1,-1,0,0
ernennen,3,4,-1,-1,-1,0,0
erwählen,22,10,12,1,-1,0,0
geben,5,2,-3,-1,1,0,0
bestehen,2,4,2,1,1,0,0
äußern,1,4,-3,-1,-1,-1,0
entwickeln,5,5,0,0,1,0,0
kritisieren,11,2,-9,-1,1,-1,0
stellen,6,2,4,1,-1,0,0
spielen,4,3,-1,-1,1,0,0
setzen,1,3,2,1,1,0,0
stellen,3,2,-1,-1,1,-1,0
verlieren,2,5,3,1,1,0,0
lassen,1,3,-2,-1,-1,-1,0
geben,12,2,-10,-1,1,0,0
erklären,1,2,-1,-1,-1,-1,0
fordern,8,7,-1,-1,1,0,0
rechtfertigen,2,3,1,1,1,0,0
nehmen,13,2,-11,-1,1,0,0
sehen,2,3,1,1,1,0,0
sprechen,1,2,-1,-1,-1,0,0
stellen,12,3,9,1,-1,0,0
verteilen,2,5,-3,-1,-1,0,0
eröffnen,3,2,-1,-1,1,0,0
sagen,3,3,0,0,1,0,0
machen,4,2,-2,-1,1,-1,0
geben,10,13,3,1,1,0,0
fischen,2,4,2,1,1,0,0
gleichen,1,3,-2,-1,-1,-1,0
dienen,2,5,-3,-1,-1,0,0
verändern,4,3,-1,-1,1,1,0
stoßen,5,6,1,1,1,0,0
finden,7,2,-5,-1,1,0,0
versprechen,1,15,-14,-1,-1,-1,0
setzen,3,8,5,1,1,0,0
stellen,8,5,3,1,-1,0,0
überwachen,12,2,-10,-1,1,0,0
halten,14,2,-12,-1,1,-1,0
überreichen,3,4,-1,-1,-1,0,0
verkaufen,1,2,-1,-1,-1,0,0
eröffnen,10,3,-7,-1,1,0,0
sehen,2,2,0,0,1,0,0
stellen,3,4,-1,-1,-1,0,0
ziehen,3,3,0,0,-1,0,0
geben,1,2,1,1,1,0,0
setzen,1,2,-1,-1,-1,0,0
unterlaufen,2,3,1,1,1,0,0
unterliegen,21,3,-18,-1,1,0,0
danken,2,4,-2,-1,-1,0,0
sehen,7,3,-4,-1,1,0,0
investieren,5,2,-3,-1,1,-1,0
geben,9,21,12,1,1,0,0
suchen,12,7,-5,-1,1,0,0
sehen,3,17,-14,-1,-1,0,0
präsentieren,2,3,1,1,1,0,0
greifen,2,3,1,1,1,0,0
unterzeichnen,12,5,-7,-1,1,0,0
behandeln,15,15,0,0,1,0,0
sehen,4,5,1,1,1,0,0
durchsuchen,8,4,4,1,-1,0,0
äußern,1,5,4,1,1,0,0
zeigen,1,11,-10,-1,-1,-1,0
stellen,20,6,-14,-1,1,0,0
handeln,1,12,-11,-1,-1,-1,0
brauchen,3,10,-7,-1,-1,0,0
kritisieren,1,4,-3,-1,-1,0,0
handeln,1,10,-9,-1,-1,-1,0
handeln,1,20,-19,-1,-1,-1,0
geben,5,3,-2,-1,1,0,0
wickeln,9,4,5,1,-1,0,0
zählen,5,4,-1,-1,1,0,0
sehen,6,4,2,1,-1,0,0
stehen,2,3,1,1,1,0,0
halten,2,4,-2,-1,-1,0,0
machen,1,4,3,1,1,0,0
lehnen,3,4,-1,-1,-1,0,0
werfen,13,3,10,1,-1,0,0
verbieten,1,2,1,1,1,0,0
erheben,21,3,-18,-1,1,0,0
sammeln,21,2,-19,-1,1,0,0
fordern,1,2,1,1,1,0,0
bekunden,5,2,3,1,-1,0,0
verklagen,13,2,11,1,-1,0,0
beziffern,3,4,-1,-1,-1,0,0
betreiben,6,2,-4,-1,1,0,0
heben,13,3,10,1,-1,0,0
korrigieren,12,2,10,1,-1,0,0
begrüßen,3,5,2,1,1,0,0
durchlaufen,4,4,0,0,1,0,0
integrieren,1,14,-13,-1,-1,-1,0
geben,5,4,-1,-1,1,0,0
gehören,3,8,5,1,1,0,0
erfordern,2,4,2,1,1,0,0
machen,1,3,-2,-1,-1,-1,0
finden,4,4,0,0,1,0,0
bestätigen,4,3,-1,-1,1,0,0
katapultieren,1,3,-2,-1,-1,0,0
sehen,6,3,-3,-1,1,0,0
betragen,2,4,-2,-1,-1,0,0
nennen,5,4,1,1,-1,0,0
kombinieren,3,3,0,0,-1,0,0
entfernen,5,4,1,1,-1,1,0
blenden,2,4,-2,-1,-1,0,0
helfen,1,4,3,1,1,0,0
bieten,2,12,-10,-1,-1,0,0
betragen,2,4,2,1,1,0,0
sehen,1,7,-6,-1,-1,-1,0
geben,15,3,-12,-1,1,0,0
kontrollieren,11,3,-8,-1,1,0,0
erwerben,5,8,-3,-1,-1,0,0
erhalten,6,4,-2,-1,1,0,0
erhalten,5,5,0,0,-1,0,0
halten,7,4,-3,-1,1,0,0
geben,19,4,-15,-1,1,0,0
bringen,3,3,0,0,-1,0,0
versuchen,1,26,-25,-1,-1,-1,0
erwähnen,6,3,-3,-1,1,0,0
führen,1,11,-10,-1,-1,-1,0
laden,15,3,12,1,-1,0,0
schießen,2,3,-1,-1,-1,0,0
gestatten,3,2,-1,-1,1,0,0
erzielen,9,3,-6,-1,1,0,0
sehen,3,14,-11,-1,-1,-1,0
sehen,4,3,1,1,-1,0,0
nehmen,2,3,-1,-1,-1,0,0
halten,2,4,2,1,1,0,0
sehen,2,3,1,1,1,0,0
verwenden,2,3,-1,-1,-1,0,0
geben,9,4,-5,-1,1,0,0
finden,2,2,0,0,1,0,0
verbinden,1,4,-3,-1,-1,0,0
sehen,1,12,11,1,1,0,0
bekommen,3,2,-1,-1,1,0,0
zeigen,3,4,1,1,1,0,0
setzen,5,5,0,0,-1,0,0
geben,2,2,0,0,-1,0,0
weichen,2,4,2,1,1,0,0
begründen,14,12,2,1,-1,0,0
geben,1,2,-1,-1,-1,0,0
geben,4,4,0,0,-1,0,0
bestätigen,7,2,-5,-1,1,0,0
verbuchen,8,8,0,0,1,0,0
zeigen,1,3,-2,-1,-1,-1,0
verbuchen,7,3,-4,-1,1,0,0
beraten,3,3,0,0,-1,0,0
führen,4,2,-2,-1,1,0,0
sehen,16,7,-9,-1,1,0,0
lassen,5,3,-2,-1,1,0,0
zitieren,2,30,-28,-1,-1,0,0
prüfen,2,3,-1,-1,-1,0,0
unterstehen,9,2,-7,-1,1,0,0
übersteigen,2,3,-1,-1,-1,0,0
betreffen,2,4,2,1,1,0,0
zeigen,1,4,-3,-1,-1,-1,0
behalten,5,2,-3,-1,1,-1,0
verdienen,1,5,4,1,1,0,0
sehen,2,5,-3,-1,-1,0,0
bieten,5,2,-3,-1,1,0,0
bauen,5,10,5,1,1,0,0
materialisierten,1,28,-27,-1,-1,-1,0
entdecken,1,3,-2,-1,-1,-1,0
spielen,2,3,-1,-1,-1,0,0
verkünden,5,2,-3,-1,1,0,0
setzen,2,9,-7,-1,-1,0,0
lassen,2,11,-9,-1,-1,0,0
bieten,18,2,-16,-1,1,0,0
rekonstruieren,2,3,1,1,1,0,0
bilden,2,9,7,1,1,0,0
planen,5,5,0,0,-1,0,0
verlassen,2,3,-1,-1,-1,0,0
bieten,2,4,-2,-1,-1,0,0
bieten,6,2,-4,-1,1,0,0
leisten,2,8,6,1,1,0,0
zeigen,1,4,-3,-1,-1,-1,0
gehen,4,3,-1,-1,1,0,0
beantragen,1,4,-3,-1,-1,-1,0
betragen,2,2,0,0,1,0,0
treffen,7,3,-4,-1,1,0,0
nützen,2,11,-9,-1,-1,0,0
verarbeiten,8,2,6,1,-1,0,0
geben,3,2,-1,-1,1,0,0
versprechen,4,4,0,0,1,0,0
machen,14,2,12,1,-1,0,0
finden,6,2,-4,-1,1,0,0
gliedern,1,32,-31,-1,-1,-1,0
versprechen,11,3,-8,-1,1,0,0
fordern,5,2,3,1,-1,0,0
handeln,1,11,-10,-1,-1,-1,0
leiten,7,3,-4,-1,1,0,0
belegen,2,7,5,1,1,0,0
geben,6,5,1,1,-1,0,0
investieren,5,6,1,1,1,0,0
erhoffen,10,3,-7,-1,1,0,0
unterstützen,2,4,-2,-1,-1,0,0
greifen,3,7,4,1,1,0,0
bieten,6,6,0,0,1,0,0
erhalten,1,3,-2,-1,-1,0,0
geben,1,20,-19,-1,-1,-1,0
führen,2,12,-10,-1,-1,0,0
schreiben,2,7,-5,-1,-1,0,0
erhalten,4,6,2,1,1,0,0
erhalten,2,3,-1,-1,-1,0,0
kosten,3,2,1,1,-1,0,0
fällen,4,9,5,1,1,0,0
führen,5,8,3,1,1,0,0
finden,22,3,-19,-1,1,0,0
setzen,7,3,-4,-1,1,0,0
nutzen,2,8,-6,-1,-1,0,0
benennen,2,2,0,0,-1,0,0
machen,12,4,-8,-1,1,0,0
erhalten,11,2,9,1,-1,0,0
betreiben,4,3,-1,-1,1,0,0
leiten,3,3,0,0,1,0,0
berichten,10,8,-2,-1,1,0,0
bauen,8,2,-6,-1,1,0,0
bieten,4,3,-1,-1,1,0,0
geben,6,3,3,1,-1,0,0
verfügen,4,5,1,1,1,0,0
handeln,1,4,-3,-1,-1,-1,0
handeln,1,3,-2,-1,-1,-1,0
lassen,1,3,-2,-1,-1,-1,0
sorgen,2,3,1,1,1,0,0
bieten,3,3,0,0,1,0,0
suchen,2,7,-5,-1,-1,0,0
entsprechen,4,2,-2,-1,1,-1,0
vergleichen,5,3,2,1,-1,0,0
hinken,3,7,4,1,1,0,0
bieten,4,2,-2,-1,1,0,0
protestieren,8,4,-4,-1,1,0,0
halten,6,3,3,1,-1,0,0
beschäftigen,3,2,-1,-1,1,0,0
verbuchen,8,8,0,0,1,0,0
begründen,6,14,-8,-1,-1,0,0
stellen,2,2,0,0,-1,0,0
nutzen,3,6,-3,-1,-1,0,0
verzeichnen,1,3,2,1,1,0,0
sehen,14,2,-12,-1,1,0,0
beschäftigen,3,3,0,0,1,0,0
färben,1,2,-1,-1,-1,-1,0
schreiben,2,3,1,1,1,0,0
verletzen,2,3,1,1,1,0,0
sehen,2,6,-4,-1,-1,0,0
bekommen,3,7,-4,-1,-1,0,0
benutzen,3,9,-6,-1,-1,0,0
beenden,11,7,4,1,-1,0,0
erhalten,33,4,-29,-1,1,0,0
schreiben,2,3,1,1,1,0,0
geben,10,3,-7,-1,1,0,0
entsprechen,7,9,2,1,1,0,0
überholen,16,3,-13,-1,1,0,0
richten,1,2,-1,-1,-1,-1,0
erzielen,8,5,-3,-1,1,0,0
spielen,3,18,-15,-1,-1,0,0
führen,19,2,17,1,-1,0,0
stärken,5,4,-1,-1,1,0,0
erwarten,3,6,3,1,1,0,0
bieten,3,2,-1,-1,1,0,0
erreichen,5,2,-3,-1,1,0,0
enthalten,16,2,-14,-1,1,0,0
erhalten,3,5,2,1,1,0,0
nehmen,5,3,-2,-1,1,0,0
bringen,3,3,0,0,1,0,0
entwickeln,11,4,-7,-1,1,0,0
äußern,1,3,-2,-1,-1,-1,0
übertreffen,6,10,4,1,1,0,0
führen,2,3,-1,-1,-1,0,0
geben,6,3,-3,-1,1,0,0
sehen,3,4,1,1,1,0,0
betreffen,2,2,0,0,1,-1,0
begründen,2,11,-9,-1,-1,0,0
rechnen,7,4,-3,-1,1,0,0
werfen,2,2,0,0,1,-1,0
halten,1,2,1,1,1,0,0
sagen,2,2,0,0,1,0,0
frieren,1,4,-3,-1,-1,0,0
sagen,2,2,0,0,1,0,0
feiern,4,5,-1,-1,-1,0,0
rechnen,3,4,1,1,1,0,0
betragen,3,2,-1,-1,1,0,0
betreiben,7,3,-4,-1,1,1,0
kündigen,20,3,-17,-1,1,0,0
nehmen,3,3,0,0,1,0,0
installieren,15,3,-12,-1,1,0,0
erhalten,4,6,-2,-1,-1,0,0
verweigern,2,4,2,1,1,0,0
spülen,4,5,-1,-1,-1,0,0
spielen,2,2,0,0,-1,0,0
erwarten,5,19,14,1,1,0,0
erwarten,1,2,1,1,1,0,0
kosten,2,2,0,0,-1,0,0
korrigieren,1,2,-1,-1,-1,0,0
gründen,10,2,-8,-1,1,0,0
suchen,14,4,-10,-1,1,0,0
beschäftigen,3,9,6,1,1,0,0
erwarten,8,7,1,1,-1,0,0
widmen,34,2,-32,-1,1,-1,0
zeigen,1,5,-4,-1,-1,-1,0
erfordern,5,3,-2,-1,1,0,0
bedauern,2,7,-5,-1,-1,0,0
verkaufen,1,2,-1,-1,-1,-1,0
beziffern,2,8,-6,-1,-1,0,0
belaufen,1,4,-3,-1,-1,-1,0
behandeln,4,3,1,1,-1,0,0
nehmen,1,3,2,1,1,1,0
setzen,6,2,4,1,-1,0,0
führen,1,3,2,1,1,0,0
verweisen,5,4,-1,-1,1,0,0
betreffen,5,2,-3,-1,1,-1,0
rufen,2,2,0,0,-1,0,0
spielen,1,2,-1,-1,-1,-1,0
versprechen,2,3,1,1,1,0,0
schließen,5,16,-11,-1,-1,0,0
wissen,1,3,2,1,1,0,0
halten,2,7,-5,-1,-1,0,0
stellen,9,2,7,1,-1,0,0
lehnen,2,3,1,1,1,0,0
vertagen,2,3,-1,-1,-1,0,0
vergleichen,2,19,-17,-1,-1,0,0
sehen,1,11,-10,-1,-1,0,0
erhalten,1,17,-16,-1,-1,0,0
streben,4,7,3,1,1,0,0
planen,1,3,-2,-1,-1,0,0
bereiten,8,4,-4,-1,1,0,0
erzielen,6,3,-3,-1,1,0,0
verzeichnen,3,5,-2,-1,-1,0,0
warten,3,3,0,0,1,0,0
setzen,1,3,-2,-1,-1,-1,0
präsentieren,1,2,-1,-1,-1,0,0
präsentieren,5,2,3,1,-1,0,0
enthalten,8,3,5,1,-1,0,0
nehmen,2,2,0,0,-1,0,0
erinnern,4,2,-2,-1,1,0,0
setzen,7,11,-4,-1,-1,0,0
teilen,4,3,-1,-1,1,0,0
kosten,5,2,3,1,-1,0,0
verschicken,1,4,-3,-1,-1,-1,0
eröffnen,7,3,-4,-1,1,0,0
verbuchen,6,7,-1,-1,-1,0,0
betragen,2,3,1,1,1,0,0
verlangen,28,2,-26,-1,1,-1,0
teilen,5,3,2,1,-1,0,0
führen,2,22,-20,-1,-1,0,0
fügen,3,6,3,1,1,0,0
betreiben,3,6,-3,-1,-1,0,0
machen,1,2,-1,-1,-1,0,0
nutzen,4,5,1,1,1,0,0
mieten,2,3,-1,-1,-1,0,0
zahlen,5,2,3,1,-1,0,0
kosten,1,4,-3,-1,-1,-1,0
besagen,3,3,0,0,1,0,0
stellen,3,13,-10,-1,-1,0,0
stellen,2,4,-2,-1,-1,0,0
rechnen,2,4,2,1,1,0,0
bekommen,3,2,-1,-1,1,0,0
machen,1,3,-2,-1,-1,-1,0
wünschen,2,3,-1,-1,-1,0,0
öffnen,2,2,0,0,1,0,0
verweisen,22,2,-20,-1,1,0,0
fordern,4,2,-2,-1,1,0,0
setzen,4,2,-2,-1,1,0,0
verbringen,3,2,1,1,-1,0,0
nutzen,5,2,3,1,-1,1,0
schaffen,3,4,1,1,1,0,0
erlangen,1,4,-3,-1,-1,0,0
rechnen,6,4,-2,-1,1,0,0
geben,4,2,2,1,-1,0,0
zeigen,2,6,-4,-1,-1,0,0
behindern,4,2,-2,-1,1,0,0
werfen,3,3,0,0,-1,0,0
verlieren,4,5,1,1,1,0,0
fallen,7,2,5,1,-1,0,0
lehnen,3,3,0,0,-1,0,0
legen,4,3,-1,-1,1,0,0
lassen,1,4,-3,-1,-1,0,0
sichern,3,2,1,1,-1,0,0
halten,5,3,2,1,-1,0,0
präsentieren,3,2,1,1,-1,0,0
erwarten,3,3,0,0,1,0,0
sehen,2,8,6,1,1,0,0
weisen,17,2,-15,-1,1,0,0
bezeichnen,2,3,-1,-1,-1,0,0
bringen,6,4,2,1,-1,0,0
verlangen,4,3,-1,-1,1,0,0
zahlen,2,3,1,1,1,0,0
streben,6,9,3,1,1,0,0
sehen,14,8,6,1,-1,0,0
erklären,2,2,0,0,-1,0,0
finden,1,12,-11,-1,-1,0,0
schlagen,2,4,2,1,1,0,0
ersteigern,13,3,-10,-1,1,0,0
platzieren,2,6,-4,-1,-1,0,0
handeln,1,12,-11,-1,-1,-1,0
fassen,2,5,-3,-1,-1,0,0
geben,10,9,-1,-1,1,0,0
extrahieren,3,3,0,0,-1,0,0
machen,6,8,2,1,1,0,0
diskutieren,1,3,2,1,1,0,0
vertreiben,2,3,1,1,1,0,0
geben,3,3,0,0,1,0,0
liefern,5,4,-1,-1,1,0,0
stoßen,6,5,-1,-1,1,0,0
besorgen,10,2,-8,-1,1,0,0
verhängen,13,9,-4,-1,1,0,0
geraten,2,14,12,1,1,0,0
geraten,2,8,6,1,1,0,0
zeigen,1,2,-1,-1,-1,-1,0
fassen,2,4,-2,-1,-1,0,0
schaffen,6,7,1,1,1,0,0
rechnen,11,4,-7,-1,1,0,0
hinken,3,5,-2,-1,-1,0,0
übertrumpfen,1,6,-5,-1,-1,-1,0
betreffen,5,2,-3,-1,1,0,0
liefern,2,12,-10,-1,-1,0,0
reservieren,2,2,0,0,1,0,0
machen,5,3,-2,-1,1,0,0
stechen,3,2,-1,-1,1,0,0
lizenzieren,8,3,5,1,-1,0,0
beenden,2,2,0,0,1,0,0
klären,2,5,-3,-1,-1,0,0
benötigen,6,3,-3,-1,1,0,0
erwarten,7,4,-3,-1,1,0,0
loben,15,3,-12,-1,1,0,0
laufen,17,3,-14,-1,1,0,0
machen,1,6,-5,-1,-1,-1,0
schlagen,1,4,3,1,1,0,0
treffen,2,2,0,0,-1,0,0
geben,1,3,2,1,1,0,0
weisen,2,4,-2,-1,-1,0,0
machen,2,4,2,1,1,0,0
fordern,8,3,-5,-1,1,0,0
sagen,2,2,0,0,1,0,0
öffnen,2,3,1,1,1,0,0
sehen,9,9,0,0,1,0,0
teilen,2,9,-7,-1,-1,0,0
geben,2,3,1,1,1,0,0
vergeben,12,8,-4,-1,1,0,0
erlangen,4,4,0,0,1,0,0
-,1,3,-2,-1,-1,-1,0
werfen,2,3,-1,-1,-1,0,0
begründen,2,7,-5,-1,-1,0,0
erwerben,6,5,-1,-1,1,0,0
kaufen,10,5,-5,-1,1,0,0
erwerben,7,4,-3,-1,1,0,0
geben,7,3,-4,-1,1,1,0
halten,10,6,-4,-1,1,0,0
sprechen,1,4,-3,-1,-1,-1,0
streiten,1,7,-6,-1,-1,-1,0
wenden,1,4,-3,-1,-1,-1,0
leiten,4,6,-2,-1,-1,0,0
kaufen,5,4,1,1,-1,0,0
verlieren,8,11,3,1,1,0,0
bieten,6,2,-4,-1,1,-1,0
sehen,12,4,-8,-1,1,0,0
unterstützen,2,4,-2,-1,-1,0,0
machen,2,3,1,1,1,0,0
verstoßen,4,7,3,1,1,0,0
beenden,10,4,6,1,-1,0,0
richten,1,7,-6,-1,-1,-1,0
verknüpfen,2,5,-3,-1,-1,0,0
stellen,6,2,4,1,-1,0,0
übernehmen,5,3,-2,-1,1,0,0
verfolgen,2,2,0,0,-1,0,0
geben,5,2,-3,-1,1,0,0
präsentieren,18,3,-15,-1,1,0,0
präsentieren,6,3,-3,-1,1,0,0
entscheiden,1,15,-14,-1,-1,-1,0
kündigen,15,4,-11,-1,1,0,0
bekommen,27,3,-24,-1,1,0,0
geben,2,8,6,1,1,0,0
schließen,2,4,-2,-1,-1,0,0
planen,5,2,-3,-1,1,0,0
erinnern,1,2,-1,-1,-1,-1,0
verwandeln,1,2,-1,-1,-1,-1,0
entscheiden,1,6,-5,-1,-1,-1,0
warten,5,4,-1,-1,1,0,0
überwinden,2,3,-1,-1,-1,0,0
setzen,4,4,0,0,1,0,0
kennen,1,2,1,1,1,0,0
raten,2,4,2,1,1,0,0
integrieren,1,2,-1,-1,-1,0,0
gelingen,3,4,-1,-1,-1,0,0
geben,3,2,1,1,-1,0,0
entsprechen,6,2,-4,-1,1,0,0
erläutern,3,5,-2,-1,-1,0,0
spülen,2,3,-1,-1,-1,0,0
ermöglichen,5,2,-3,-1,1,0,0
erwarten,17,4,-13,-1,1,0,0
planen,2,2,0,0,1,0,0
bringen,1,4,-3,-1,-1,0,0
schreiben,25,2,-23,-1,1,0,0
bringen,1,3,-2,-1,-1,-1,0
verbrennen,3,3,0,0,-1,0,0
zählen,16,3,-13,-1,1,0,0
verfolgen,3,7,4,1,1,0,0
korrigieren,4,2,2,1,-1,0,0
unterstützen,12,4,-8,-1,1,0,0
sehen,11,7,-4,-1,1,0,0
bereiten,8,2,-6,-1,1,0,0
greifen,23,3,-20,-1,1,0,0
unterzeichnen,16,2,-14,-1,1,0,0
sehen,11,3,-8,-1,1,0,0
halten,6,3,-3,-1,1,0,0
besitzen,6,3,-3,-1,1,0,0
richten,1,25,-24,-1,-1,-1,0
erhalten,5,4,-1,-1,1,0,0
handeln,1,3,-2,-1,-1,-1,0
sehen,2,3,-1,-1,-1,0,0
verstellen,8,5,-3,-1,1,0,0
bestehen,8,2,-6,-1,1,0,0
nutzen,7,5,2,1,-1,0,0
bereiten,3,2,-1,-1,1,0,0
kommentieren,4,3,-1,-1,1,0,0
schmettern,1,4,-3,-1,-1,-1,0
lösen,3,3,0,0,-1,0,0
vergleichen,9,12,-3,-1,-1,0,0
beantworten,2,2,0,0,-1,0,0
heben,2,2,0,0,-1,0,0
mischen,1,9,-8,-1,-1,-1,0
kritisieren,3,3,0,0,1,0,0
schätzen,11,6,5,1,-1,0,0
wickeln,8,3,-5,-1,1,0,0
brauchen,8,3,-5,-1,1,0,0
setzen,5,2,3,1,-1,0,0
verzeichnen,12,2,-10,-1,1,0,0
peilen,4,3,-1,-1,1,0,0
sagen,2,2,0,0,1,0,0
sehen,14,3,-11,-1,1,0,0
setzen,1,4,-3,-1,-1,0,0
stellen,3,3,0,0,-1,0,0
befallen,9,5,-4,-1,1,0,0
kündigen,22,3,-19,-1,1,0,0
eröffnen,2,3,1,1,1,0,0
lehnen,14,2,-12,-1,1,0,0
machen,3,4,1,1,1,0,0
lehnen,2,2,0,0,1,-1,0
zeigen,2,5,-3,-1,-1,0,0
schieben,2,2,0,0,-1,1,0
rechnen,6,4,-2,-1,1,0,0
transportieren,6,3,3,1,-1,0,0
sehen,1,2,-1,-1,-1,-1,0
geben,9,2,-7,-1,1,0,0
untersuchen,5,3,2,1,-1,0,0
handeln,1,5,-4,-1,-1,-1,0
stellen,2,2,0,0,1,0,0
werfen,3,3,0,0,-1,0,0
setzen,2,12,-10,-1,-1,0,0
kombinieren,12,12,0,0,-1,0,0
verlangen,2,3,-1,-1,-1,0,0
setzen,3,3,0,0,1,1,0
erzielen,5,4,-1,-1,1,0,0
profitieren,7,2,-5,-1,1,0,0
begründen,3,4,-1,-1,-1,0,0
starten,2,3,1,1,1,0,0
speichern,2,13,-11,-1,-1,0,0
gewinnen,4,3,-1,-1,1,0,0
sehen,15,4,-11,-1,1,0,0
investieren,1,2,-1,-1,-1,0,0
übernehmen,3,4,1,1,1,0,0
vollziehen,8,3,-5,-1,1,0,0
verlieren,5,4,-1,-1,1,0,0
machen,8,4,-4,-1,1,0,0
sehen,2,4,2,1,1,0,0
gleichen,8,2,6,1,-1,0,0
erwarten,8,3,-5,-1,1,0,0
bringen,15,10,5,1,-1,0,0
sprechen,1,8,-7,-1,-1,-1,0
geben,5,3,-2,-1,1,0,0
sprechen,1,11,-10,-1,-1,-1,0
sorgen,2,2,0,0,1,0,0
ergehen,13,8,-5,-1,1,0,0
wählen,8,2,-6,-1,1,0,0
modifizieren,7,3,-4,-1,1,0,0
taufen,1,11,-10,-1,-1,-1,0
sehen,5,3,-2,-1,1,0,0
dehnen,10,5,-5,-1,1,0,0
nutzen,12,5,-7,-1,1,0,0
weisen,6,15,9,1,1,0,0
rechnen,13,7,-6,-1,1,0,0
scheinen,1,2,-1,-1,-1,0,0
begründen,4,26,-22,-1,-1,0,0
unterstützen,2,7,-5,-1,-1,0,0
übernehmen,3,5,-2,-1,-1,0,0
verdoppeln,2,5,-3,-1,-1,0,0
stellen,14,8,-6,-1,1,0,0
nennen,5,8,3,1,1,0,0
führen,14,7,-7,-1,1,0,0
vergleichen,1,7,-6,-1,-1,0,0
machen,1,3,-2,-1,-1,-1,0
hageln,4,10,-6,-1,-1,0,0
werfen,2,3,-1,-1,-1,0,0
halten,7,2,5,1,-1,0,0
erhalten,2,5,3,1,1,0,0
belaufen,1,8,-7,-1,-1,-1,0
betragen,3,3,0,0,1,0,0
enttäuschen,2,7,5,1,1,0,0
belaufen,1,4,-3,-1,-1,-1,0
kritisieren,6,2,-4,-1,1,-1,0
geben,1,3,-2,-1,-1,0,0
erweitern,7,4,3,1,-1,0,0
dienen,13,3,-10,-1,1,0,0
sehen,4,2,2,1,-1,1,0
bezahlen,4,2,-2,-1,1,0,0
setzen,3,9,6,1,1,0,0
machen,2,3,-1,-1,-1,0,0
lassen,1,4,-3,-1,-1,-1,0
drängen,5,2,-3,-1,1,0,0
fordern,11,2,-9,-1,1,-1,0
führen,2,4,-2,-1,-1,0,0
führen,4,3,-1,-1,1,0,0
geben,2,2,0,0,1,0,0
geben,2,6,4,1,1,0,0
geben,11,3,-8,-1,1,0,0
bringen,2,2,0,0,-1,0,0
helfen,15,5,-10,-1,1,1,0
schreiben,1,4,-3,-1,-1,-1,0
lehnen,2,4,-2,-1,-1,0,0
begründen,1,9,-8,-1,-1,-1,0
handeln,1,5,-4,-1,-1,-1,0
bekommen,1,3,-2,-1,-1,0,0
beglückwünschen,3,9,-6,-1,-1,0,0
unterstützen,7,4,-3,-1,1,0,0
unterstützen,4,2,-2,-1,1,0,0
zeigen,1,3,-2,-1,-1,-1,0
handeln,1,19,-18,-1,-1,-1,0
erhalten,1,2,-1,-1,-1,0,0
halten,2,5,3,1,1,0,0
sagen,3,6,-3,-1,-1,0,0
geben,2,4,2,1,1,0,0
drängen,4,6,-2,-1,-1,0,0
erwerben,35,4,-31,-1,1,0,0
setzen,2,3,-1,-1,-1,0,0
schicken,2,14,-12,-1,-1,0,0
analysieren,2,6,-4,-1,-1,0,0
erhalten,9,6,-3,-1,1,0,0
vergleichen,2,4,-2,-1,-1,1,0
summieren,1,4,-3,-1,-1,-1,0
betragen,4,11,-7,-1,-1,0,0
betragen,3,11,-8,-1,-1,0,0
erwarten,3,9,6,1,1,0,0
nehmen,6,3,3,1,-1,0,0
unterstützen,2,8,-6,-1,-1,0,0
hoffen,6,7,1,1,1,0,0
gehen,1,3,2,1,1,0,0
ziehen,2,4,2,1,1,0,0
greifen,7,5,-2,-1,1,0,0
stempeln,2,2,0,0,-1,0,0
nehmen,1,3,-2,-1,-1,0,0
nehmen,9,3,6,1,-1,0,0
bringen,6,2,4,1,-1,0,0
übernehmen,7,3,-4,-1,1,1,0
geben,1,4,3,1,1,0,0
setzen,2,3,-1,-1,-1,0,0
kündigen,12,4,-8,-1,1,0,0
beurteilen,7,6,-1,-1,1,0,0
stellen,3,5,-2,-1,-1,0,0
konzentrieren,1,2,-1,-1,-1,0,0
machen,1,11,-10,-1,-1,0,0
kündigen,15,5,-10,-1,1,0,0
rechnen,9,3,-6,-1,1,0,0
bezahlen,4,4,0,0,1,0,0
rechnen,7,4,-3,-1,1,0,0
unterstützen,2,6,-4,-1,-1,0,0
küren,7,3,-4,-1,1,0,0
stellen,3,2,1,1,-1,0,0
begleiten,2,2,0,0,-1,0,0
sehen,13,8,-5,-1,1,0,0
entsprechen,9,2,-7,-1,1,0,0
erwarten,9,4,-5,-1,1,0,0
bringen,3,3,0,0,-1,0,0
lenken,2,8,-6,-1,-1,0,0
spielen,2,5,-3,-1,-1,0,0
übernehmen,5,6,-1,-1,-1,0,0
erhalten,3,4,1,1,1,0,0
geben,2,3,-1,-1,-1,0,0
simulieren,2,4,2,1,1,0,0
kommen,2,3,-1,-1,-1,0,0
schütteln,2,3,-1,-1,-1,0,0
installieren,3,3,0,0,1,0,0
geben,9,3,-6,-1,1,0,0
präsentieren,1,3,-2,-1,-1,-1,0
kaufen,25,2,-23,-1,1,0,0
verfügen,13,3,-10,-1,1,0,0
kündigen,2,4,2,1,1,0,0
führen,8,9,-1,-1,-1,0,0
machen,13,7,-6,-1,1,0,0
brauchen,2,2,0,0,1,0,0
halten,7,6,1,1,-1,0,0
bieten,4,2,-2,-1,1,0,0
liefern,1,4,3,1,1,0,0
bemängeln,10,4,-6,-1,1,0,0
machen,13,5,-8,-1,1,0,0
halten,7,2,5,1,-1,0,0
sehen,9,2,-7,-1,1,-1,0
fühlen,3,3,0,0,-1,0,0
stellen,7,5,-2,-1,1,0,0
vertreten,17,3,-14,-1,1,0,0
handeln,1,17,-16,-1,-1,-1,0
stellen,6,2,4,1,-1,0,0
ergänzen,2,23,-21,-1,-1,0,0
betragen,2,5,-3,-1,-1,0,0
bekommen,6,3,3,1,-1,0,0
zeigen,4,3,-1,-1,1,0,0
werfen,5,5,0,0,-1,0,0
protestieren,9,2,-7,-1,1,0,0
versorgen,2,2,0,0,-1,0,0
stellen,10,2,8,1,-1,0,0
betreten,1,5,-4,-1,-1,0,0
strengen,2,3,1,1,1,0,0
hinken,2,2,0,0,1,0,0
geben,2,4,-2,-1,-1,0,0
lehnen,17,2,-15,-1,1,0,0
gründen,25,2,-23,-1,1,-1,0
machen,1,8,-7,-1,-1,0,0
erfüllen,8,4,-4,-1,1,0,0
geben,2,4,2,1,1,0,0
erhoffen,6,5,-1,-1,1,0,0
bringen,2,2,0,0,-1,0,0
entsprechen,3,5,2,1,1,0,0
finden,1,3,-2,-1,-1,-1,0
beklagen,5,3,-2,-1,1,0,0
geben,2,4,2,1,1,0,0
verdienen,8,6,-2,-1,1,0,0
betragen,2,8,-6,-1,-1,0,0
besitzen,21,3,-18,-1,1,0,0
erwarten,13,5,-8,-1,1,0,0
schlagen,1,8,7,1,1,0,0
versprechen,18,3,-15,-1,1,0,0
liefern,7,2,-5,-1,1,0,0
weisen,5,2,-3,-1,1,0,0
geben,3,5,2,1,1,0,0
heizen,12,3,-9,-1,1,0,0
sehen,1,3,-2,-1,-1,-1,0
erhalten,2,6,4,1,1,0,0
erwarten,7,7,0,0,-1,0,0
erwarten,18,5,-13,-1,1,0,0
erhalten,8,8,0,0,-1,0,0
erwerben,2,4,-2,-1,-1,0,0
machen,2,2,0,0,1,0,0
bauen,10,11,-1,-1,-1,0,0
schicken,2,3,-1,-1,-1,0,0
bieten,15,4,-11,-1,1,0,0
reichen,14,3,-11,-1,1,0,0
wissen,4,2,2,1,-1,-1,0
handeln,1,14,-13,-1,-1,-1,0
erhalten,8,4,-4,-1,1,0,0
belaufen,1,4,-3,-1,-1,-1,0
erhoffen,17,5,-12,-1,1,0,0
äußern,1,3,2,1,1,0,0
favorisieren,1,2,-1,-1,-1,0,0
sehen,4,3,-1,-1,1,0,0
bekommen,20,3,-17,-1,1,0,0
bieten,2,5,-3,-1,-1,0,0
beruhen,13,4,-9,-1,1,0,0
machen,4,2,-2,-1,1,0,0
plädieren,7,2,-5,-1,1,0,0
halten,12,10,-2,-1,1,0,0
stellen,2,3,1,1,1,0,0
stellen,2,4,-2,-1,-1,0,0
behalten,7,3,4,1,-1,0,0
werfen,2,4,-2,-1,-1,0,0
bereiten,4,8,-4,-1,-1,0,0
schockieren,2,22,-20,-1,-1,0,0
machen,5,4,1,1,-1,0,0
reduzieren,2,5,3,1,1,0,0
begründen,2,8,-6,-1,-1,0,0
fordern,7,3,-4,-1,1,0,0
liefern,1,6,-5,-1,-1,0,0
verpacken,4,3,1,1,-1,0,0
prognostizieren,3,4,1,1,1,0,0
bringen,7,4,-3,-1,1,0,0
-,16,3,-13,-1,1,0,0
gründen,1,11,-10,-1,-1,-1,0
passieren,1,2,1,1,1,0,0
verwandeln,1,3,-2,-1,-1,-1,0
schließen,2,3,1,1,1,0,0
zeigen,1,8,-7,-1,-1,-1,0
nehmen,4,6,2,1,1,0,0
geben,10,4,-6,-1,1,0,0
spielen,4,3,1,1,-1,0,0
benutzen,8,2,-6,-1,1,0,0
geben,2,3,-1,-1,-1,0,0
lassen,1,4,-3,-1,-1,-1,0
geben,16,7,-9,-1,1,0,0
übernehmen,17,3,-14,-1,1,0,0
geben,15,3,-12,-1,1,0,0
bezeichnen,4,5,1,1,1,0,0
brauchen,2,4,2,1,1,0,0
bekennen,1,5,4,1,1,0,0
gehören,3,4,1,1,1,0,0
missfallen,3,4,-1,-1,-1,0,0
sehen,9,8,-1,-1,1,0,0
gehen,1,2,-1,-1,-1,0,0
schließen,2,2,0,0,-1,0,0
locken,3,2,1,1,-1,0,0
lehnen,3,2,-1,-1,1,0,0
fühlen,1,5,-4,-1,-1,-1,0
passieren,1,3,-2,-1,-1,-1,0
helfen,1,10,-9,-1,-1,-1,0
streben,6,5,-1,-1,1,0,0
geben,3,2,1,1,-1,0,0
werfen,5,2,-3,-1,1,0,0
vertreiben,2,2,0,0,-1,0,0
erhalten,2,9,-7,-1,-1,0,0
geben,1,6,5,1,1,0,0
geben,10,2,-8,-1,1,0,0
erfreuen,2,3,1,1,1,0,0
laden,14,2,-12,-1,1,0,0
realisieren,12,2,-10,-1,1,0,0
beziffern,5,5,0,0,-1,0,0
untersuchen,15,4,-11,-1,1,0,0
sprechen,2,3,-1,-1,-1,0,0
geben,3,4,-1,-1,-1,0,0
stellen,6,2,4,1,-1,0,0
schaffen,4,3,1,1,-1,0,0
sehen,4,8,-4,-1,-1,0,0
übernehmen,4,3,-1,-1,1,0,0
rücken,2,2,0,0,-1,0,0
vereinigen,6,2,4,1,-1,1,0
warnen,1,3,-2,-1,-1,0,0
lösen,4,2,-2,-1,1,0,0
erkennen,4,5,1,1,1,0,0
sehen,6,15,-9,-1,-1,0,0
schätzen,2,13,-11,-1,-1,0,0
werfen,2,3,-1,-1,-1,0,0
platzieren,3,3,0,0,1,0,0
ziehen,6,2,4,1,-1,0,0
sagen,2,2,0,0,1,0,0
beziehen,1,3,2,1,1,0,0
erklären,4,2,2,1,-1,0,0
fordern,2,12,10,1,1,0,0
geben,17,4,-13,-1,1,0,0
bieten,9,4,-5,-1,1,0,0
schlagen,13,4,-9,-1,1,0,0
verklagen,3,2,1,1,-1,0,0
übertragen,2,5,3,1,1,-1,0
erreichen,2,5,3,1,1,-1,0
lassen,3,7,4,1,1,0,0
treten,2,4,2,1,1,0,0
geißeln,4,4,0,0,1,0,0
entschließen,7,2,-5,-1,1,0,0
erwarten,8,4,-4,-1,1,0,0
machen,1,4,-3,-1,-1,0,0
starten,2,5,-3,-1,-1,0,0
bieten,8,4,-4,-1,1,0,0
zahlen,3,3,0,0,1,0,0
investieren,6,5,1,1,-1,0,0
weisen,21,2,-19,-1,1,0,0
ziehen,2,3,-1,-1,-1,0,0
machen,2,11,-9,-1,-1,0,0
lassen,7,5,2,1,-1,0,0
machen,5,2,3,1,-1,0,0
stellen,10,4,-6,-1,1,0,0
laufen,1,3,2,1,1,0,0
verkaufen,3,4,-1,-1,-1,0,0
überraschen,3,3,0,0,-1,0,0
spielen,5,2,-3,-1,1,0,0
sehen,5,5,0,0,1,0,0
erzielen,7,2,-5,-1,1,0,0
handeln,1,25,-24,-1,-1,-1,0
geben,6,3,-3,-1,1,0,0
peilen,4,3,-1,-1,1,0,0
zeichnen,1,13,-12,-1,-1,-1,0
präsentieren,29,3,-26,-1,1,0,0
versprechen,4,2,2,1,-1,0,0
bringen,12,4,-8,-1,1,0,0
räumen,1,6,5,1,1,0,0
holen,13,3,-10,-1,1,0,0
erwarten,13,2,-11,-1,1,0,0
halten,1,6,-5,-1,-1,0,0
setzen,4,3,-1,-1,1,0,0
beschäftigen,3,3,0,0,1,0,0
schrauben,6,3,3,1,-1,0,0
bergen,2,2,0,0,-1,1,0
halten,2,3,-1,-1,-1,0,0
geben,1,9,-8,-1,-1,-1,0
bieten,6,5,-1,-1,1,0,0
messen,10,7,-3,-1,1,0,0
verständigen,1,6,-5,-1,-1,-1,0
ändern,2,3,1,1,1,0,0
-,3,16,-13,-1,-1,0,0
geben,11,2,-9,-1,1,1,0
bieten,4,4,0,0,1,0,0
zeigen,1,4,-3,-1,-1,-1,0
reagieren,4,2,2,1,-1,0,0
bezeichnen,2,13,-11,-1,-1,0,0
vermitteln,4,2,-2,-1,1,0,0
rechnen,5,8,3,1,1,0,0
befördern,8,4,4,1,-1,0,0
bedienen,3,3,0,0,-1,0,0
sehen,8,9,1,1,1,0,0
halten,3,3,0,0,-1,0,0
weisen,1,5,4,1,1,0,0
machen,10,8,-2,-1,1,0,0
versprechen,4,5,1,1,1,0,0
statten,2,12,-10,-1,-1,0,0
sehen,2,6,-4,-1,-1,0,0
wählen,1,2,1,1,1,0,0
setzen,2,3,1,1,1,0,0
preisen,5,10,5,1,1,0,0
bieten,3,5,2,1,1,0,0
schmücken,2,2,0,0,-1,0,0
lassen,1,4,-3,-1,-1,-1,0
zeigen,1,3,-2,-1,-1,-1,0
stürzen,1,2,-1,-1,-1,-1,0
erwarten,15,2,-13,-1,1,0,0
rechnen,1,3,2,1,1,0,0
kaufen,3,9,-6,-1,-1,0,0
zahlen,5,3,2,1,-1,0,0
setzen,3,3,0,0,1,0,0
erhalten,4,3,-1,-1,1,0,0
benutzen,2,2,0,0,1,0,0
erhalten,1,3,-2,-1,-1,0,0
bieten,3,2,-1,-1,1,0,0
erwirtschaften,6,14,8,1,1,0,0
ziehen,3,8,5,1,1,0,0
schalten,2,3,1,1,1,0,0
machen,3,2,1,1,-1,0,0
begründen,2,8,-6,-1,-1,0,0
betragen,2,5,3,1,1,0,0
bieten,4,5,1,1,1,0,0
halten,1,2,-1,-1,-1,-1,0
unterstützen,21,5,-16,-1,1,0,0
zeigen,7,3,-4,-1,1,0,0
reißen,3,5,-2,-1,-1,0,0
belaufen,1,4,-3,-1,-1,-1,0
rechnen,3,4,1,1,1,0,0
rechnen,8,17,-9,-1,-1,0,0
registrieren,7,9,2,1,1,0,0
zitieren,1,3,2,1,1,0,0
sehen,1,4,-3,-1,-1,-1,0
sagen,2,2,0,0,-1,0,0
stellen,9,5,-4,-1,1,0,0
beantworten,2,3,-1,-1,-1,0,0
machen,2,2,0,0,-1,0,0
kosten,3,2,-1,-1,1,0,0
schlagen,4,3,1,1,-1,0,0
fotografieren,5,3,-2,-1,1,0,0
lassen,1,2,-1,-1,-1,-1,0
gehören,5,10,-5,-1,-1,0,0
zeigen,1,2,-1,-1,-1,-1,0
leihen,3,2,1,1,-1,0,0
rechnen,12,2,-10,-1,1,0,0
bringen,9,2,7,1,-1,0,0
bringen,10,3,7,1,-1,0,0
spielen,4,3,1,1,-1,0,0
rechnen,7,5,-2,-1,1,0,0
führen,1,23,-22,-1,-1,-1,0
bestätigen,6,3,-3,-1,1,0,0
beherrschen,3,2,-1,-1,1,0,0
sehen,5,3,2,1,-1,0,0
lizenzieren,2,3,1,1,1,0,0
weisen,6,3,-3,-1,1,0,0
besitzen,15,2,-13,-1,1,0,0
missen,4,10,-6,-1,-1,0,0
begründen,2,7,-5,-1,-1,0,0
greifen,11,2,-9,-1,1,0,0
kontrollieren,1,3,-2,-1,-1,0,0
benutzen,1,4,3,1,1,0,0
rechnen,9,2,7,1,-1,0,0
übernehmen,6,3,-3,-1,1,0,0
verfügen,3,12,9,1,1,0,0
verfügen,4,9,5,1,1,0,0
teilen,2,4,-2,-1,-1,0,0
finden,3,3,0,0,1,0,0
verblüffen,3,2,-1,-1,1,0,0
legen,12,11,-1,-1,1,0,0
spielen,2,7,5,1,1,0,0
bezeichnen,2,3,-1,-1,-1,0,0
machen,17,7,-10,-1,1,0,0
liefern,16,4,-12,-1,1,0,0
erreichen,6,3,3,1,-1,0,0
bilden,3,5,2,1,1,0,0
machen,3,3,0,0,-1,0,0
machen,6,2,4,1,-1,0,0
stellen,10,3,-7,-1,1,1,0
holen,4,3,1,1,-1,0,0
geben,8,4,-4,-1,1,0,0
leihen,3,4,-1,-1,-1,0,0
geben,2,2,0,0,1,0,0
erwarten,7,4,-3,-1,1,0,0
führen,1,7,-6,-1,-1,-1,0
verdienen,7,7,0,0,-1,0,0
lassen,2,2,0,0,1,0,0
steigern,3,2,1,1,-1,0,0
sorgen,8,3,-5,-1,1,0,0
reichen,10,2,-8,-1,1,0,0
erwarten,4,2,2,1,-1,0,0
verbringen,2,4,-2,-1,-1,0,0
setzen,1,3,-2,-1,-1,0,0
investieren,3,5,2,1,1,0,0
sehen,18,3,-15,-1,1,0,0
verlieren,6,4,-2,-1,1,0,0
sehen,14,2,-12,-1,1,0,0
schließen,2,3,-1,-1,-1,0,0
erwarten,11,4,-7,-1,1,0,0
kündigen,6,2,-4,-1,1,0,0
führen,1,15,-14,-1,-1,-1,0
richten,1,12,-11,-1,-1,0,0
stellen,13,3,-10,-1,1,0,0
stellen,4,5,-1,-1,-1,0,0
nutzen,9,5,4,1,-1,0,0
verbinden,4,6,-2,-1,-1,0,0
setzen,1,2,-1,-1,-1,0,0
brauchen,2,3,1,1,1,0,0
künden,2,4,-2,-1,-1,0,0
betreiben,5,4,-1,-1,1,0,0
beginnen,2,3,1,1,1,0,0
geben,24,4,-20,-1,1,0,0
trösten,1,4,-3,-1,-1,-1,0
richten,1,3,-2,-1,-1,-1,0
ziehen,3,2,1,1,-1,1,0
bieten,2,2,0,0,-1,0,0
halten,6,5,-1,-1,1,0,0
verzeichnen,6,2,-4,-1,1,-1,0
erwarten,4,4,0,0,1,0,0
schätzen,2,2,0,0,-1,0,0
befürchten,5,9,-4,-1,-1,0,0
gelingen,2,4,-2,-1,-1,0,0
bestätigen,2,2,0,0,1,0,0
planen,6,2,-4,-1,1,0,0
betragen,2,10,-8,-1,-1,0,0
erwarten,9,2,-7,-1,1,0,0
sehen,6,15,-9,-1,-1,0,0
sprechen,1,11,-10,-1,-1,-1,0
äußern,7,3,-4,-1,1,0,0
gründen,3,4,1,1,1,0,0
investieren,3,3,0,0,-1,0,0
stellen,20,4,-16,-1,1,0,0
bewirken,7,2,-5,-1,1,0,0
drohen,1,2,-1,-1,-1,0,0
lehnen,4,11,7,1,1,0,0
steigern,1,5,-4,-1,-1,0,0
belaufen,1,3,-2,-1,-1,-1,0
lieben,2,2,0,0,-1,0,0
leiten,1,4,-3,-1,-1,-1,0
handeln,1,3,-2,-1,-1,-1,0
markieren,3,10,-7,-1,-1,0,0
besitzen,2,3,1,1,1,0,0
stellen,2,2,0,0,1,0,0
rechnen,13,2,-11,-1,1,0,0
verlangen,4,3,-1,-1,1,0,0
machen,1,3,2,1,1,0,0
vergleichen,1,4,-3,-1,-1,-1,0
handeln,1,12,-11,-1,-1,-1,0
sprechen,2,2,0,0,1,0,0
ziehen,17,2,15,1,-1,0,0
fordern,7,3,-4,-1,1,0,0
sagen,2,2,0,0,-1,0,0
richten,1,25,-24,-1,-1,-1,0
benutzen,8,3,5,1,-1,0,0
sehen,3,5,2,1,1,0,0
entwickeln,5,3,-2,-1,1,0,0
vertreiben,10,3,7,1,-1,0,0
fördern,2,4,-2,-1,-1,0,0
unterstützen,6,7,-1,-1,-1,0,0
tauschen,2,12,-10,-1,-1,0,0
stellen,10,8,-2,-1,1,0,0
bieten,3,2,-1,-1,1,0,0
rechnen,10,2,-8,-1,1,0,0
ermöglichen,15,2,-13,-1,1,-1,0
verlangen,7,2,-5,-1,1,0,0
handeln,1,15,-14,-1,-1,-1,0
vertreiben,2,7,-5,-1,-1,0,0
entkleiden,2,2,0,0,-1,0,0
reduzieren,1,4,-3,-1,-1,-1,0
halten,5,3,2,1,-1,0,0
benutzen,1,2,-1,-1,-1,-1,0
erscheinen,2,6,-4,-1,-1,0,0
halten,5,2,-3,-1,1,0,0
ergehen,1,9,-8,-1,-1,-1,0
fragen,2,2,0,0,1,0,0
berichten,3,3,0,0,1,0,0
machen,2,2,0,0,1,0,0
feuern,2,3,1,1,1,0,0
verbuchen,14,7,7,1,-1,0,0
führen,2,10,-8,-1,-1,0,0
verlieren,2,3,-1,-1,-1,0,0
stellen,2,2,0,0,-1,0,0
verlangen,5,7,2,1,1,0,0
machen,1,3,-2,-1,-1,-1,0
geben,6,3,-3,-1,1,0,0
geben,2,3,1,1,1,0,0
antworten,6,4,-2,-1,1,0,0
bieten,3,15,12,1,1,0,0
wiederholen,4,2,-2,-1,1,0,0
bringen,3,2,1,1,-1,0,0
nehmen,8,2,6,1,-1,0,0
spülen,5,10,-5,-1,-1,0,0
führen,2,3,1,1,1,0,0
verhindern,5,3,-2,-1,1,0,0
betreiben,13,3,-10,-1,1,0,0
denken,7,5,-2,-1,1,0,0
benutzen,3,5,2,1,1,0,0
übersetzen,2,3,-1,-1,-1,0,0
stellen,2,8,-6,-1,-1,0,0
geben,2,3,-1,-1,-1,0,0
beschleunigen,2,17,-15,-1,-1,0,0
ersetzen,2,3,1,1,1,0,0
bieten,6,5,-1,-1,1,0,0
geben,5,2,-3,-1,1,0,0
lassen,2,6,-4,-1,-1,0,0
bekommen,2,3,-1,-1,-1,0,0
machen,2,2,0,0,1,0,0
erwarten,4,3,-1,-1,1,0,0
greifen,1,3,-2,-1,-1,0,0
bemänteln,2,3,-1,-1,-1,0,0
verbuchen,6,4,-2,-1,1,0,0
betragen,4,12,-8,-1,-1,0,0
statten,5,3,2,1,-1,0,0
sehen,5,3,-2,-1,1,0,0
machen,6,7,1,1,1,0,0
lassen,1,3,-2,-1,-1,-1,0
bauen,8,4,4,1,-1,0,0
erwarten,2,4,2,1,1,0,0
zahlen,3,13,-10,-1,-1,0,0
übernehmen,9,4,5,1,-1,0,0
verleiben,4,4,0,0,-1,0,0
betragen,15,2,-13,-1,1,0,0
senken,2,5,-3,-1,-1,0,0
schreiben,2,3,-1,-1,-1,0,0
erwarten,2,6,-4,-1,-1,0,0
stellen,2,3,-1,-1,-1,0,0
stellen,3,3,0,0,-1,0,0
geben,2,2,0,0,-1,0,0
betreiben,4,8,-4,-1,-1,0,0
liefern,3,4,1,1,1,0,0
sprechen,11,2,-9,-1,1,0,0
kaufen,1,2,-1,-1,-1,-1,0
nehmen,4,3,-1,-1,1,0,0
denken,8,9,1,1,1,0,0
sehen,9,4,-5,-1,1,0,0
geben,5,2,3,1,-1,0,0
lassen,1,9,-8,-1,-1,-1,0
produzieren,12,4,-8,-1,1,0,0
warnen,2,3,-1,-1,-1,0,0
leben,12,3,-9,-1,1,0,0
finden,1,3,-2,-1,-1,0,0
benötigen,4,3,-1,-1,1,0,0
führen,4,2,2,1,-1,0,0
begründen,2,10,-8,-1,-1,0,0
vertelefonieren,4,4,0,0,-1,0,0
lassen,1,12,-11,-1,-1,-1,0
ausliefern,3,4,-1,-1,-1,0,0
unterstützen,35,4,-31,-1,1,0,0
lassen,1,2,-1,-1,-1,-1,0
bekommen,5,5,0,0,1,0,0
setzen,8,4,-4,-1,1,0,0
schneiden,1,3,-2,-1,-1,-1,0
gründen,24,5,-19,-1,1,0,0
treiben,4,2,2,1,-1,0,0
booten,2,3,1,1,1,0,0
einigen,1,2,1,1,1,0,0
erheben,4,5,-1,-1,-1,0,0
veröffentlichen,5,10,5,1,1,0,0
begründen,2,4,-2,-1,-1,0,0
beschäftigen,3,3,0,0,1,0,0
bringen,2,18,-16,-1,-1,0,0
verbuchen,6,10,-4,-1,-1,0,0
rufen,1,3,2,1,1,0,0
kündigen,8,5,-3,-1,1,0,0
richten,1,5,-4,-1,-1,-1,0
erreichen,7,4,3,1,-1,0,0
reichen,4,3,1,1,-1,0,0
erreichen,3,3,0,0,1,0,0
betragen,8,2,-6,-1,1,0,0
schüren,7,3,-4,-1,1,0,0
kennen,6,2,-4,-1,1,0,0
sehen,4,2,-2,-1,1,0,0
verhindern,5,18,13,1,1,0,0
stellen,2,2,0,0,1,0,0
treten,3,3,0,0,1,0,0
stehen,1,21,-20,-1,-1,-1,0
übersteigen,2,2,0,0,1,0,0
bringen,6,3,3,1,-1,0,0
spüren,4,6,2,1,1,0,0
erweitern,1,2,-1,-1,-1,0,0
stellen,18,2,16,1,-1,0,0
setzen,10,3,-7,-1,1,0,0
enthalten,8,2,-6,-1,1,0,0
erzeugen,4,3,-1,-1,1,0,0
handeln,1,11,-10,-1,-1,-1,0
geben,7,2,5,1,-1,0,0
begründen,2,8,-6,-1,-1,0,0
bringen,1,4,-3,-1,-1,-1,0
bekommen,2,2,0,0,-1,0,0
weisen,12,3,-9,-1,1,0,0
verschieben,2,3,-1,-1,-1,0,0
bieten,15,6,-9,-1,1,0,0
handeln,1,19,-18,-1,-1,-1,0
halten,8,2,6,1,-1,0,0
planen,1,8,7,1,1,0,0
erwirtschaften,11,7,-4,-1,1,0,0
betreiben,3,9,-6,-1,-1,0,0
liefern,3,5,2,1,1,0,0
erzielen,5,3,-2,-1,1,0,0
bekräftigen,4,2,-2,-1,1,0,0
benennen,2,8,-6,-1,-1,0,0
sehen,5,3,-2,-1,1,0,0
ziehen,2,3,-1,-1,-1,0,0
wissen,1,5,4,1,1,0,0
gehören,10,2,-8,-1,1,0,0
geben,4,2,-2,-1,1,0,0
verletzen,4,3,-1,-1,1,0,0
eröffnen,4,4,0,0,1,0,0
warnen,2,7,-5,-1,-1,0,0
bekommen,5,3,2,1,-1,0,0
unterstützen,19,4,-15,-1,1,0,0
werfen,1,2,-1,-1,-1,-1,0
bieten,5,4,-1,-1,1,0,0
bedienen,11,2,-9,-1,1,-1,0
beschließen,24,3,-21,-1,1,0,0
bringen,1,4,-3,-1,-1,0,0
sehen,11,4,-7,-1,1,0,0
rechnen,7,6,-1,-1,1,0,0
bekräftigen,23,2,-21,-1,1,0,0
sehen,9,6,-3,-1,1,0,0
erwarten,4,3,-1,-1,1,0,0
ziehen,10,4,-6,-1,1,0,0
zitieren,2,3,1,1,1,0,0
handeln,1,12,-11,-1,-1,-1,0
reichen,10,5,-5,-1,1,0,0
investieren,3,4,-1,-1,-1,0,0
betragen,8,2,-6,-1,1,0,0
verlieren,2,3,-1,-1,-1,0,0
prophezeien,3,9,-6,-1,-1,0,0
rechnen,16,9,7,1,-1,0,0
bezeichnen,1,6,-5,-1,-1,-1,0
informieren,2,5,-3,-1,-1,0,0
bringen,1,2,-1,-1,-1,0,0
machen,1,4,-3,-1,-1,-1,0
nennen,8,2,-6,-1,1,-1,0
beschreiben,4,2,-2,-1,1,0,0
verteilen,4,4,0,0,-1,0,0
verkaufen,3,2,1,1,-1,0,0
verkaufen,4,4,0,0,-1,0,0
machen,12,7,-5,-1,1,0,0
geben,6,3,-3,-1,1,0,0
äußern,1,6,-5,-1,-1,-1,0
betreiben,9,4,-5,-1,1,0,0
beklagen,5,5,0,0,1,0,0
kritisieren,2,2,0,0,1,0,0
verfügen,7,6,-1,-1,1,0,0
bringen,2,2,0,0,-1,0,0
machen,8,3,-5,-1,1,0,0
belaufen,1,8,-7,-1,-1,-1,0
machen,5,5,0,0,-1,0,0
vergleichen,1,9,-8,-1,-1,-1,0
strotzen,2,4,2,1,1,0,0
verhindern,8,4,-4,-1,1,0,0
geben,16,3,-13,-1,1,0,0
betreiben,5,8,-3,-1,-1,0,0
zensieren,1,2,-1,-1,-1,0,0
spülen,3,3,0,0,-1,0,0
kritisieren,2,3,-1,-1,-1,0,0
verschärfen,5,10,5,1,1,0,0
warnen,1,6,-5,-1,-1,0,0
schließen,6,3,3,1,-1,0,0
erwarten,10,9,1,1,-1,0,0
legen,5,2,-3,-1,1,0,0
bleiben,1,2,-1,-1,-1,-1,0
stellen,9,2,-7,-1,1,0,0
geben,2,3,1,1,1,0,0
rechnen,8,3,-5,-1,1,0,0
geben,2,4,2,1,1,0,0
spülen,4,3,1,1,-1,0,0
begründen,2,3,-1,-1,-1,0,0
geben,2,6,4,1,1,0,0
untersuchen,11,3,-8,-1,1,0,0
nennen,9,4,-5,-1,1,0,0
geben,6,10,-4,-1,-1,0,0
zeigen,2,2,0,0,-1,0,0
stoßen,3,4,1,1,1,0,0
äußern,31,3,-28,-1,1,0,0
gehen,1,4,-3,-1,-1,0,0
bieten,22,4,-18,-1,1,0,0
rügen,14,3,-11,-1,1,0,0
betreiben,1,4,-3,-1,-1,0,0
nutzen,2,2,0,0,-1,0,0
stellen,1,3,-2,-1,-1,-1,0
lassen,1,3,-2,-1,-1,0,0
beschließen,3,9,-6,-1,-1,0,0
besitzen,12,3,-9,-1,1,0,0
bekommen,7,3,-4,-1,1,0,0
dehnen,2,12,-10,-1,-1,0,0
lassen,1,2,-1,-1,-1,-1,0
halten,5,5,0,0,1,0,0
feiern,2,3,1,1,1,0,0
präsentieren,22,2,-20,-1,1,0,0
nennen,1,2,-1,-1,-1,-1,0
mieten,2,5,-3,-1,-1,0,0
bringen,5,3,2,1,-1,0,0
machen,1,2,1,1,1,-1,0
verschenken,2,2,0,0,1,0,0
ziehen,1,2,-1,-1,-1,0,0
ziehen,2,2,0,0,-1,0,0
korrigieren,6,2,4,1,-1,0,0
sehen,1,3,2,1,1,0,0
machen,4,6,-2,-1,-1,0,0
sehen,3,5,2,1,1,0,0
machen,1,2,-1,-1,-1,0,0
bescheren,15,6,-9,-1,1,0,0
kündigen,8,4,-4,-1,1,0,0
erhoffen,1,2,-1,-1,-1,-1,0
erwarten,6,8,2,1,1,0,0
legen,1,4,-3,-1,-1,-1,0
bauen,8,3,-5,-1,1,0,0
erhalten,3,4,-1,-1,-1,0,0
kosten,2,3,1,1,1,0,0
bieten,6,3,-3,-1,1,0,0
halten,2,6,-4,-1,-1,0,0
reißen,2,2,0,0,-1,0,0
bauen,5,8,3,1,1,0,0
suggerieren,2,2,0,0,-1,0,0
locken,2,3,-1,-1,-1,0,0
behalten,8,5,-3,-1,1,0,0
handeln,1,15,-14,-1,-1,-1,0
geben,2,5,3,1,1,0,0
begründen,1,32,-31,-1,-1,-1,0
planen,8,4,-4,-1,1,0,0
sehen,2,3,1,1,1,0,0
investieren,3,14,-11,-1,-1,0,0
verstärken,20,5,-15,-1,1,0,0
stellen,7,4,-3,-1,1,0,0
bezeichnen,1,9,-8,-1,-1,0,0
liefern,2,2,0,0,1,0,0
übertreffen,7,3,4,1,-1,0,0
verdoppeln,9,8,1,1,-1,0,0
üben,1,2,-1,-1,-1,-1,0
stellen,10,3,-7,-1,1,0,0
stellen,2,2,0,0,-1,0,0
kaufen,6,4,-2,-1,1,0,0
kündigen,10,3,-7,-1,1,0,0
häufen,1,4,-3,-1,-1,-1,0
übernehmen,5,2,-3,-1,1,0,0
kaufen,5,6,1,1,1,0,0
bedeuten,9,3,-6,-1,1,0,0
belaufen,1,15,-14,-1,-1,-1,0
verschieben,12,6,-6,-1,1,0,0
gehören,4,3,-1,-1,1,0,0
streben,6,4,2,1,-1,0,0
erhoffen,3,6,-3,-1,-1,0,0
verraten,11,4,-7,-1,1,0,0
geben,1,18,-17,-1,-1,0,0
geben,2,4,2,1,1,0,0
gehen,10,16,6,1,1,0,0
weisen,8,3,-5,-1,1,0,0
berühren,1,12,-11,-1,-1,0,0
erwarten,9,9,0,0,1,0,0
stehen,1,2,-1,-1,-1,0,0
verdoppeln,2,3,-1,-1,-1,0,0
verlieren,5,5,0,0,1,0,0
sehen,5,3,-2,-1,1,0,0
führen,7,9,-2,-1,-1,0,0
zeigen,1,3,-2,-1,-1,-1,0
zeigen,1,25,-24,-1,-1,-1,0
testen,1,4,-3,-1,-1,0,0
erhöhen,8,5,3,1,-1,0,0
legen,2,3,1,1,1,0,0
geben,3,3,0,0,1,0,0
geben,2,3,1,1,1,0,0
rechnen,7,4,-3,-1,1,0,0
sehen,3,12,-9,-1,-1,0,0
hängen,25,2,-23,-1,1,-1,0
lernen,3,3,0,0,-1,0,0
nutzen,3,3,0,0,-1,1,0
verkaufen,3,7,-4,-1,-1,0,0
zählen,2,6,-4,-1,-1,-1,0
lassen,1,3,-2,-1,-1,-1,0
stellen,1,5,-4,-1,-1,0,0
erwarten,6,6,0,0,1,0,0
erwarten,7,6,-1,-1,1,0,0
bringen,3,3,0,0,-1,0,0
gehören,1,3,-2,-1,-1,0,0
liefern,3,3,0,0,-1,0,0
stellen,19,3,-16,-1,1,0,0
sprechen,1,12,-11,-1,-1,-1,0
gehören,2,2,0,0,-1,1,0
fordern,16,2,-14,-1,1,0,0
zeigen,1,3,-2,-1,-1,-1,0
bezeichnen,4,4,0,0,-1,0,0
unterliegen,5,7,2,1,1,0,0
gehen,1,3,2,1,1,0,0
beschreiben,2,6,-4,-1,-1,0,0
verkünden,3,5,2,1,1,0,0
kaufen,5,3,-2,-1,1,0,0
starten,1,3,2,1,1,0,0
liefern,1,12,-11,-1,-1,0,0
erwarten,8,5,-3,-1,1,0,0
lassen,1,2,-1,-1,-1,1,0
geben,2,6,-4,-1,-1,0,0
berichten,2,3,1,1,1,0,0
stehen,1,3,2,1,1,0,0
finden,2,3,-1,-1,-1,0,0
werben,4,2,2,1,-1,0,0
beanstanden,11,3,-8,-1,1,0,0
verfolgen,2,3,1,1,1,0,0
vergeben,6,2,-4,-1,1,0,0
pfeifen,1,3,-2,-1,-1,-1,0
schicken,2,2,0,0,-1,0,0
betreiben,6,3,-3,-1,1,0,0
geben,7,5,-2,-1,1,0,0
üben,1,21,-20,-1,-1,0,0
starten,3,3,0,0,1,0,0
eröffnen,12,2,-10,-1,1,0,0
finden,20,3,-17,-1,1,0,0
starten,5,4,-1,-1,1,0,0
bieten,8,2,6,1,-1,0,0
-,8,4,-4,-1,1,0,0
gehen,1,2,1,1,1,0,0
schicken,4,2,2,1,-1,0,0
verdienen,3,7,-4,-1,-1,0,0
erhöhen,2,3,-1,-1,-1,0,0
untersuchen,9,4,-5,-1,1,0,0
erwarten,15,5,-10,-1,1,0,0
analysieren,2,5,-3,-1,-1,0,0
begrüßen,2,6,-4,-1,-1,0,0
lernen,6,3,-3,-1,1,0,0
verschleudern,3,9,-6,-1,-1,0,0
töten,1,8,-7,-1,-1,-1,0
erhalten,4,5,-1,-1,-1,0,0
liefern,8,8,0,0,1,0,0
stöpseln,2,3,-1,-1,-1,0,0
erfreuen,2,3,1,1,1,0,0
erlernen,3,4,1,1,1,0,0
beherbergen,15,2,-13,-1,1,-1,0
stellen,3,2,1,1,-1,-1,0
vereinen,5,5,0,0,-1,0,0
füttern,2,5,-3,-1,-1,0,0
bekommen,7,3,-4,-1,1,0,0
suchen,19,7,-12,-1,1,0,0
bilden,1,2,-1,-1,-1,-1,0
finden,4,4,0,0,1,0,0
verbinden,2,4,-2,-1,-1,0,0
garantieren,5,3,-2,-1,1,0,0
lehnen,13,8,-5,-1,1,0,0
geben,7,12,5,1,1,0,0
eröffnen,1,7,6,1,1,0,0
liefern,2,3,-1,-1,-1,0,0
nutzen,2,4,2,1,1,0,0
stellen,6,2,4,1,-1,0,0
zeigen,1,4,-3,-1,-1,-1,0
bekommen,3,3,0,0,1,0,0
erklären,2,11,-9,-1,-1,0,0
entlassen,6,4,-2,-1,1,0,0
bekommen,1,3,-2,-1,-1,-1,0
lassen,1,8,-7,-1,-1,-1,0
bleiben,4,3,1,1,-1,0,0
offerieren,1,5,4,1,1,0,0
fassen,13,13,0,0,-1,0,0
nehmen,2,4,-2,-1,-1,0,0
bieten,2,6,-4,-1,-1,0,0
planen,10,3,-7,-1,1,0,0
gleichen,1,3,-2,-1,-1,-1,0
nutzen,1,5,-4,-1,-1,0,0
schicken,2,3,-1,-1,-1,0,0
verbuchen,8,3,-5,-1,1,0,0
spielen,4,4,0,0,1,0,0
setzen,2,7,-5,-1,-1,0,0
vergleichen,3,6,-3,-1,-1,1,0
geben,3,3,0,0,-1,0,0
nehmen,4,3,-1,-1,1,0,0
bringen,10,3,7,1,-1,0,0
gehen,2,15,-13,-1,-1,0,0
verweigern,2,6,-4,-1,-1,0,0
äußern,1,4,-3,-1,-1,-1,0
erweitern,2,12,-10,-1,-1,0,0
beunruhigen,1,11,-10,-1,-1,0,0
unterstützen,5,4,-1,-1,1,0,0
erlauben,11,3,-8,-1,1,0,0
verweigern,10,2,-8,-1,1,0,0
wechseln,1,20,-19,-1,-1,-1,0
verhindern,8,3,-5,-1,1,0,0
sehen,3,11,8,1,1,0,0
bedeuten,11,3,-8,-1,1,0,0
belaufen,1,4,-3,-1,-1,-1,0
nehmen,2,3,1,1,1,0,0
ziehen,8,2,6,1,-1,0,0
veranlassen,4,9,-5,-1,-1,0,0
fertigen,1,3,-2,-1,-1,0,0
ziehen,2,3,-1,-1,-1,0,0
erreichen,3,3,0,0,1,0,0
treffen,6,3,-3,-1,1,0,0
verlieren,2,3,-1,-1,-1,0,0
korrigieren,6,2,4,1,-1,0,0
sprechen,10,3,-7,-1,1,0,0
lassen,1,2,-1,-1,-1,-1,0
schrauben,2,3,-1,-1,-1,0,0
verlegen,2,4,-2,-1,-1,0,0
machen,6,7,1,1,1,0,0
sehen,1,3,-2,-1,-1,0,0
belaufen,1,16,-15,-1,-1,-1,0
erhöhen,2,7,-5,-1,-1,0,0
bringen,4,3,1,1,-1,0,0
fühlen,1,4,-3,-1,-1,-1,0
rechnen,6,2,-4,-1,1,0,0
erreichen,13,7,-6,-1,1,0,0
belaufen,1,11,-10,-1,-1,-1,0
bekommen,10,3,-7,-1,1,1,0
legen,1,2,-1,-1,-1,-1,0
kaufen,3,3,0,0,-1,0,0
machen,1,5,-4,-1,-1,0,0
lassen,12,6,-6,-1,1,0,0
führen,19,5,-14,-1,1,0,0
handeln,1,17,-16,-1,-1,-1,0
erwerben,1,18,-17,-1,-1,0,0
zweifeln,4,5,1,1,1,0,0
machen,3,3,0,0,1,0,0
gründen,5,5,0,0,1,0,0
geben,2,7,-5,-1,-1,0,0
beanspruchen,10,3,-7,-1,1,-1,0
halten,4,2,2,1,-1,0,0
rechnen,22,3,-19,-1,1,0,0
erwarten,12,3,-9,-1,1,0,0
erwarten,10,3,-7,-1,1,0,0
erklären,3,4,-1,-1,-1,0,0
verringern,1,4,-3,-1,-1,-1,0
rechnen,5,4,-1,-1,1,0,0
liefern,7,3,-4,-1,1,0,0
beruhen,5,3,-2,-1,1,0,0
ziehen,2,3,1,1,1,0,0
führen,17,10,7,1,-1,0,0
stellen,19,9,-10,-1,1,0,0
führen,1,2,1,1,1,0,0
bemerken,1,4,-3,-1,-1,-1,0
bekommen,2,3,1,1,1,0,0
erwarten,6,4,-2,-1,1,0,0
spielen,3,7,4,1,1,0,0
stellen,12,3,-9,-1,1,0,0
stellen,4,2,2,1,-1,0,0
teilen,15,5,-10,-1,1,0,0
sehen,4,9,5,1,1,0,0
lehnen,2,6,4,1,1,0,0
geben,3,3,0,0,1,0,0
entwickeln,2,2,0,0,1,0,0
entkommen,4,7,3,1,1,0,0
geben,2,3,1,1,1,0,0
halten,5,2,-3,-1,1,0,0
zahlen,6,4,2,1,-1,0,0
erweitern,2,13,-11,-1,-1,0,0
sehen,2,5,-3,-1,-1,0,0
begründen,2,12,-10,-1,-1,0,0
übernehmen,8,4,4,1,-1,0,0
erwirtschaften,7,3,-4,-1,1,0,0
legen,4,12,8,1,1,0,0
stellen,6,5,1,1,-1,0,0
vermarkten,1,6,-5,-1,-1,-1,0
geben,12,2,-10,-1,1,0,0
stellen,6,2,4,1,-1,0,0
entscheiden,1,3,-2,-1,-1,-1,0
schätzen,2,12,-10,-1,-1,0,0
stehen,1,3,-2,-1,-1,-1,0
setzen,6,3,3,1,-1,0,0
verzeichnen,7,16,-9,-1,-1,0,0
betragen,10,3,-7,-1,1,0,0
melden,2,5,3,1,1,0,0
sorgen,2,2,0,0,1,0,0
schocken,2,8,-6,-1,-1,0,0
verschaffen,3,5,2,1,1,0,0
speichern,2,3,-1,-1,-1,0,0
stellen,5,3,-2,-1,1,0,0
geben,3,2,-1,-1,1,0,0
begrenzen,1,5,-4,-1,-1,0,0
stellen,2,5,-3,-1,-1,0,0
bieten,6,3,3,1,-1,0,0
finden,2,9,7,1,1,0,0
zeigen,12,3,-9,-1,1,0,0
fügen,2,3,-1,-1,-1,0,0
ersetzen,11,8,3,1,-1,0,0
entwickeln,10,5,-5,-1,1,0,0
stellen,2,4,-2,-1,-1,0,0
betreiben,1,2,-1,-1,-1,-1,0
ersetzen,11,6,5,1,-1,0,0
bauen,3,3,0,0,1,0,0
beschreiben,6,3,3,1,-1,0,0
tun,1,3,-2,-1,-1,-1,0
verpassen,2,3,-1,-1,-1,0,0
erweitern,2,3,-1,-1,-1,0,0
beschäftigen,2,4,2,1,1,0,0
erreichen,3,4,1,1,1,0,0
investieren,3,4,-1,-1,-1,0,0
unterstützen,8,3,5,1,-1,0,0
liefern,2,4,-2,-1,-1,0,0
kündigen,5,3,-2,-1,1,0,0
heben,2,4,-2,-1,-1,0,0
erreichen,3,3,0,0,1,0,0
fordern,3,6,-3,-1,-1,0,0
lizenzieren,1,2,-1,-1,-1,0,0
ergeben,1,2,1,1,1,-1,0
brauchen,5,3,2,1,-1,0,0
weisen,2,2,0,0,-1,0,0
bündeln,8,4,4,1,-1,0,0
kommentieren,1,3,-2,-1,-1,-1,0
kosten,4,3,1,1,-1,0,0
verscherbeln,9,3,-6,-1,1,0,0
erhalten,2,3,1,1,1,0,0
bilden,1,3,-2,-1,-1,-1,0
sehen,2,20,-18,-1,-1,0,0
stellen,5,2,3,1,-1,0,0
überprüfen,4,4,0,0,-1,0,0
ermöglichen,6,4,2,1,-1,0,0
ziehen,9,8,-1,-1,1,0,0
erreichen,4,3,1,1,-1,0,0
liefern,15,3,-12,-1,1,0,0
kaufen,6,3,-3,-1,1,0,0
investieren,3,4,-1,-1,-1,0,0
erweitern,4,4,0,0,-1,0,0
richten,1,12,-11,-1,-1,-1,0
unterstützen,1,5,-4,-1,-1,0,0
halten,2,2,0,0,-1,0,0
bringen,2,2,0,0,1,0,0
bringen,3,2,1,1,-1,0,0
geben,11,3,-8,-1,1,0,0
feiern,3,10,7,1,1,0,0
handeln,1,4,-3,-1,-1,-1,0
pflegen,3,3,0,0,1,0,0
setzen,3,3,0,0,1,0,0
lockern,2,11,-9,-1,-1,0,0
setzen,7,4,-3,-1,1,0,0
offenbaren,7,9,2,1,1,0,0
setzen,14,2,-12,-1,1,0,0
geben,3,3,0,0,1,0,0
vergeben,2,3,-1,-1,-1,0,0
teilen,1,6,-5,-1,-1,-1,0
führen,6,2,-4,-1,1,0,0
spiegeln,1,8,-7,-1,-1,-1,0
bieten,15,6,-9,-1,1,0,0
belasten,2,4,-2,-1,-1,0,0
nennen,4,6,2,1,1,0,0
ziehen,1,15,14,1,1,0,0
rühren,1,2,-1,-1,-1,0,0
weiten,2,11,-9,-1,-1,0,0
erreichen,15,3,-12,-1,1,0,0
erwarten,9,4,-5,-1,1,0,0
halten,5,2,-3,-1,1,0,0
betragen,3,7,-4,-1,-1,0,0
erzielen,6,2,-4,-1,1,0,0
beschichten,7,28,-21,-1,-1,0,0
weben,5,4,1,1,-1,0,0
geben,3,7,4,1,1,0,0
rechnen,3,5,2,1,1,0,0
versprechen,14,3,-11,-1,1,0,0
kündigen,7,3,-4,-1,1,0,0
schließen,6,4,-2,-1,1,0,0
verlassen,3,7,4,1,1,0,0
nehmen,5,3,2,1,-1,0,0
treiben,5,14,9,1,1,0,0
finden,1,4,3,1,1,0,0
kombinieren,1,18,-17,-1,-1,0,0
handeln,1,12,-11,-1,-1,-1,0
nutzen,6,5,-1,-1,1,0,0
optimieren,2,4,-2,-1,-1,0,0
weiten,2,4,-2,-1,-1,0,0
nehmen,4,15,-11,-1,-1,0,0
schätzen,7,4,3,1,-1,0,0
schlagen,2,4,2,1,1,0,0
verlangen,2,3,1,1,1,0,0
lassen,2,4,2,1,1,0,0
senden,1,6,5,1,1,0,0
sprechen,1,3,-2,-1,-1,-1,0
machen,1,3,-2,-1,-1,0,0
machen,2,4,-2,-1,-1,0,0
peilen,6,4,-2,-1,1,0,0
machen,2,4,-2,-1,-1,0,0
treiben,1,6,-5,-1,-1,-1,0
laden,2,2,0,0,-1,0,0
geben,10,4,-6,-1,1,-1,0
bekommen,3,3,0,0,1,0,0
veröffentlichen,2,2,0,0,-1,0,0
suchen,3,2,-1,-1,1,0,0
schrauben,6,10,4,1,1,0,0
übertreffen,4,5,-1,-1,-1,0,0
nehmen,4,2,2,1,-1,0,0
merken,1,5,-4,-1,-1,-1,0
zeigen,21,3,-18,-1,1,0,0
bieten,4,3,1,1,-1,0,0
zeigen,8,3,-5,-1,1,0,0
bestehen,1,8,7,1,1,0,0
geben,2,5,-3,-1,-1,0,0
veröffentlichen,6,3,-3,-1,1,0,0
erklären,1,3,2,1,1,0,0
bekommen,1,6,5,1,1,1,0
geben,3,2,-1,-1,1,0,0
karren,6,3,-3,-1,1,0,0
laden,1,3,-2,-1,-1,0,0
erhalten,7,3,-4,-1,1,0,0
bringen,1,2,-1,-1,-1,0,0
bieten,3,2,-1,-1,1,0,0
bieten,8,9,1,1,1,0,0
konfrontieren,2,3,-1,-1,-1,0,0
geben,2,2,0,0,1,0,0
kosten,4,3,-1,-1,1,0,0
zitieren,5,2,-3,-1,1,0,0
bringen,1,3,-2,-1,-1,0,0
reparieren,1,6,-5,-1,-1,-1,0
übernehmen,11,6,-5,-1,1,0,0
handeln,1,10,-9,-1,-1,-1,0
bekommen,2,2,0,0,-1,0,0
bieten,8,4,4,1,-1,0,0
retten,2,4,-2,-1,-1,0,0
belaufen,1,3,-2,-1,-1,-1,0
danken,1,6,-5,-1,-1,0,0
verdienen,1,15,-14,-1,-1,-1,0
gehen,14,6,-8,-1,1,0,0
belaufen,1,4,-3,-1,-1,-1,0
führen,1,18,-17,-1,-1,-1,0
erwarten,10,8,2,1,-1,0,0
führen,6,3,-3,-1,1,0,0
übernehmen,1,2,-1,-1,-1,0,0
bezahlen,2,3,-1,-1,-1,0,0
erhöhen,2,3,1,1,1,0,0
verlieren,7,3,-4,-1,1,0,0
machen,17,5,12,1,-1,0,0
bieten,8,3,-5,-1,1,0,0
versuchen,5,5,0,0,1,0,0
machen,2,3,-1,-1,-1,0,0
bekommen,2,16,-14,-1,-1,0,0
kommentieren,1,19,-18,-1,-1,-1,0
erwarten,8,3,-5,-1,1,0,0
hängen,2,6,4,1,1,0,0
zahlen,4,5,1,1,1,0,0
reagieren,5,7,2,1,1,0,0
steigern,4,6,-2,-1,-1,0,0
präsentieren,1,3,-2,-1,-1,-1,0
erwarten,3,3,0,0,1,0,0
sehen,3,2,-1,-1,1,0,0
verlieren,4,2,2,1,-1,0,0
gewinnen,5,7,-2,-1,-1,0,0
profitieren,4,5,1,1,1,0,0
bekommen,2,2,0,0,1,0,0
sehen,1,3,-2,-1,-1,0,0
bringen,2,7,5,1,1,0,0
stellen,19,3,-16,-1,1,0,0
setzen,3,3,0,0,1,0,0
schlagen,2,5,3,1,1,0,0
rechnen,4,3,-1,-1,1,0,0
nehmen,9,3,-6,-1,1,0,0
empfehlen,4,3,-1,-1,1,0,0
bieten,10,14,-4,-1,-1,0,0
zitieren,14,6,-8,-1,1,0,0
verbuchen,9,3,-6,-1,1,0,0
handeln,1,10,-9,-1,-1,-1,0
erzeugen,2,4,2,1,1,0,0
erhalten,6,3,-3,-1,1,0,0
geben,4,5,1,1,1,0,0
zeigen,1,3,-2,-1,-1,-1,0
hinterlassen,1,8,7,1,1,0,0
bringen,13,3,10,1,-1,0,0
bieten,3,4,1,1,1,0,0
lassen,1,4,-3,-1,-1,-1,0
ändern,3,4,-1,-1,-1,0,0
gehen,4,3,-1,-1,1,0,0
bieten,11,6,-5,-1,1,0,0
treiben,2,2,0,0,-1,0,0
richten,1,7,-6,-1,-1,-1,0
bieten,10,9,-1,-1,1,0,0
erweitern,3,8,-5,-1,-1,0,0
bringen,1,10,-9,-1,-1,-1,0
übernehmen,4,2,-2,-1,1,0,0
gehören,5,3,2,1,-1,0,0
betragen,3,3,0,0,1,0,0
richten,13,2,-11,-1,1,0,0
reagieren,17,13,-4,-1,1,0,0
machen,10,3,-7,-1,1,0,0
handeln,1,2,-1,-1,-1,-1,0
machen,4,2,-2,-1,1,0,0
erwarten,3,7,4,1,1,0,0
überfluten,2,3,-1,-1,-1,0,0
stellen,2,2,0,0,1,0,0
kopieren,2,3,-1,-1,-1,0,0
verzeichnen,2,2,0,0,1,0,0
setzen,1,3,-2,-1,-1,0,0
schicken,3,3,0,0,-1,0,0
verteilen,13,3,-10,-1,1,0,0
überreichen,7,4,-3,-1,1,0,0
träumen,1,2,-1,-1,-1,-1,0
geben,13,3,-10,-1,1,1,0
bestehen,1,8,7,1,1,0,0
erwerben,3,8,5,1,1,0,0
liefern,3,3,0,0,1,0,0
lassen,2,8,6,1,1,0,0
schicken,5,2,3,1,-1,0,0
zahlen,3,6,3,1,1,0,0
erwarten,7,9,-2,-1,-1,0,0
erregen,2,4,-2,-1,-1,0,0
vertreten,16,2,-14,-1,1,0,0
halten,2,6,4,1,1,0,0
gehören,5,6,1,1,1,0,0
spielen,3,2,1,1,-1,0,0
erhalten,7,5,-2,-1,1,0,0
verlieren,3,2,1,1,-1,0,0
beschäftigen,3,4,1,1,1,0,0
geben,13,3,-10,-1,1,0,0
besitzen,4,9,5,1,1,0,0
bauen,2,3,1,1,1,0,0
geben,2,5,-3,-1,-1,0,0
stellen,10,3,-7,-1,1,0,0
empfangen,2,3,-1,-1,-1,0,0
geben,2,5,3,1,1,0,0
gestatten,12,6,-6,-1,1,0,0
bringen,8,4,4,1,-1,0,0
spielen,3,5,2,1,1,0,0
machen,1,4,3,1,1,0,0
befragen,2,6,-4,-1,-1,0,0
besitzen,3,5,2,1,1,0,0
schätzen,4,5,-1,-1,-1,0,0
schicken,11,5,-6,-1,1,0,0
halten,4,3,1,1,-1,0,0
erwarten,3,5,2,1,1,0,0
erweitern,2,13,-11,-1,-1,0,0
nominieren,17,3,-14,-1,1,0,0
geben,2,2,0,0,-1,0,0
kommen,2,3,1,1,1,0,0
sammeln,1,2,1,1,1,0,0
fahren,1,3,-2,-1,-1,0,0
wählen,21,2,-19,-1,1,0,0
starten,3,5,2,1,1,0,0
motivieren,3,2,-1,-1,1,0,0
bieten,1,3,-2,-1,-1,-1,0
ersetzen,5,6,-1,-1,-1,0,0
bieten,10,2,-8,-1,1,0,0
bieten,3,3,0,0,1,0,0
machen,9,3,-6,-1,1,0,0
sehen,2,11,-9,-1,-1,0,0
verbuchen,14,2,-12,-1,1,0,0
verlieren,3,3,0,0,-1,0,0
unternehmen,1,3,-2,-1,-1,-1,0
planen,5,4,-1,-1,1,0,0
geben,2,3,1,1,1,0,0
streichen,2,3,-1,-1,-1,0,0
streichen,8,6,-2,-1,1,0,0
beschränken,2,11,-9,-1,-1,0,0
kündigen,7,3,-4,-1,1,0,0
schalten,5,3,-2,-1,1,0,0
stellen,3,3,0,0,-1,0,0
erhalten,10,3,-7,-1,1,0,0
führen,2,13,-11,-1,-1,0,0
suchen,7,3,-4,-1,1,0,0
klinken,1,5,-4,-1,-1,-1,0
schlagen,4,3,-1,-1,1,0,0
ermöglichen,6,4,-2,-1,1,0,0
investieren,4,3,-1,-1,1,0,0
geben,5,2,-3,-1,1,0,0
nehmen,2,5,3,1,1,0,0
bieten,13,6,7,1,-1,0,0
bieten,6,3,-3,-1,1,0,0
finden,3,3,0,0,-1,0,0
übertreffen,4,3,1,1,-1,0,0
machen,6,3,-3,-1,1,0,0
kaufen,7,2,-5,-1,1,-1,0
führen,5,16,-11,-1,-1,0,0
bieten,4,3,-1,-1,1,0,0
betragen,4,5,1,1,1,0,0
verdienen,3,9,-6,-1,-1,0,0
setzen,3,6,-3,-1,-1,0,0
führen,3,3,0,0,-1,0,0
beliefern,2,3,1,1,1,0,0
zeigen,1,4,-3,-1,-1,-1,0
erhalten,7,2,-5,-1,1,0,0
erwarten,11,2,-9,-1,1,0,0
nehmen,4,3,1,1,-1,0,0
begründen,2,3,1,1,1,0,0
verkaufen,4,4,0,0,-1,0,0
vermieten,4,3,1,1,-1,0,0
erwarten,15,4,-11,-1,1,0,0
halten,1,4,-3,-1,-1,-1,0
beschwören,12,2,-10,-1,1,0,0
stellen,2,2,0,0,-1,0,0
speichern,3,4,-1,-1,-1,0,0
rechnen,8,3,-5,-1,1,0,0
präsentieren,2,8,6,1,1,0,0
erhalten,7,4,-3,-1,1,0,0
verbinden,22,3,-19,-1,1,0,0
bestimmen,5,16,-11,-1,-1,0,0
geben,1,3,2,1,1,0,0
gehören,3,2,-1,-1,1,0,0
bedeuten,2,3,-1,-1,-1,0,0
erhalten,7,5,-2,-1,1,0,0
zahlen,6,2,4,1,-1,0,0
präsentieren,13,2,-11,-1,1,0,0
fertigen,2,3,-1,-1,-1,0,0
stellen,2,16,-14,-1,-1,0,0
untersagen,12,2,-10,-1,1,0,0
setzen,7,3,-4,-1,1,0,0
bieten,2,4,2,1,1,0,0
sagen,2,2,0,0,-1,0,0
sagen,2,2,0,0,1,0,0
bringen,2,2,0,0,-1,0,0
machen,5,4,1,1,-1,0,0
spielen,4,3,-1,-1,1,0,0
geben,4,3,-1,-1,1,0,0
kassieren,4,7,3,1,1,0,0
verzeichnen,2,5,3,1,1,0,0
schätzen,2,5,-3,-1,-1,0,0
wissen,3,3,0,0,-1,0,0
sehen,6,2,-4,-1,1,0,0
geben,1,2,1,1,1,0,0
reagieren,3,4,-1,-1,-1,0,0
investieren,3,8,-5,-1,-1,0,0
schließen,6,5,-1,-1,1,0,0
entsprechen,3,5,2,1,1,0,0
erwarten,6,3,3,1,-1,0,0
investieren,3,2,1,1,-1,0,0
unterstützen,1,15,-14,-1,-1,0,0
machen,4,8,-4,-1,-1,0,0
kommen,2,2,0,0,-1,0,0
helfen,1,3,-2,-1,-1,0,0
beauftragen,1,2,-1,-1,-1,-1,0
plaudern,4,3,1,1,-1,0,0
erzählen,7,5,-2,-1,1,0,0
machen,4,9,-5,-1,-1,0,0
berechnen,3,3,0,0,-1,0,0
schlagen,9,10,1,1,1,0,0
schlagen,2,5,3,1,1,0,0
kündigen,2,3,-1,-1,-1,0,0
verklagen,1,2,-1,-1,-1,0,0
-,2,4,-2,-1,-1,0,0
gründen,13,5,-8,-1,1,0,0
kaufen,3,4,1,1,1,0,0
stellen,3,6,3,1,1,0,0
stellen,9,5,-4,-1,1,0,0
präsentieren,6,3,-3,-1,1,0,0
verweisen,6,4,-2,-1,1,0,0
erwarten,9,4,-5,-1,1,0,0
sehen,2,12,-10,-1,-1,0,0
sehen,3,8,5,1,1,0,0
geben,7,2,-5,-1,1,0,0
stellen,3,3,0,0,1,0,0
begründen,7,4,-3,-1,1,0,0
beenden,5,6,1,1,1,0,0
ersetzen,3,4,-1,-1,-1,1,0
leiten,3,9,-6,-1,-1,0,0
stellen,12,3,-9,-1,1,0,0
entbehren,2,2,0,0,1,0,0
kündigen,2,6,-4,-1,-1,0,0
geben,4,2,-2,-1,1,0,0
geben,6,3,3,1,-1,0,0
sehen,7,2,-5,-1,1,0,0
sehen,5,8,3,1,1,0,0
erhoffen,5,3,-2,-1,1,0,0
stellen,5,2,3,1,-1,0,0
bieten,8,3,5,1,-1,0,0
ziehen,4,5,-1,-1,-1,0,0
beziffern,8,4,4,1,-1,0,0
bringen,5,4,1,1,-1,0,0
verbuchen,6,11,-5,-1,-1,0,0
verwundern,5,7,2,1,1,1,0
errechnen,16,5,-11,-1,1,0,0
extrahieren,8,3,5,1,-1,0,0
setzen,2,5,-3,-1,-1,0,0
vergleichen,1,11,-10,-1,-1,-1,0
verklagen,1,2,-1,-1,-1,0,0
bringen,11,8,3,1,-1,0,0
lassen,1,3,-2,-1,-1,-1,0
stellen,6,3,3,1,-1,0,0
suchen,2,6,-4,-1,-1,0,0
warnen,2,4,-2,-1,-1,0,0
versuchen,1,6,-5,-1,-1,-1,0
verschicken,9,4,-5,-1,1,0,0
bringen,4,2,2,1,-1,0,0
öffnen,2,2,0,0,1,0,0
richten,3,3,0,0,-1,0,0
helfen,2,3,-1,-1,-1,0,0
teilen,3,3,0,0,-1,0,0
geben,3,8,5,1,1,0,0
vereinbaren,8,2,-6,-1,1,0,0
bezahlen,3,2,-1,-1,1,0,0
geben,2,2,0,0,-1,0,0
belaufen,1,7,-6,-1,-1,-1,0
laufen,1,6,-5,-1,-1,0,0
geben,1,3,2,1,1,0,0
handeln,1,4,-3,-1,-1,-1,0
sehen,1,2,-1,-1,-1,0,0
sehen,2,4,2,1,1,0,0
erhalten,2,4,2,1,1,0,0
zeigen,1,3,-2,-1,-1,-1,0
geben,12,3,-9,-1,1,0,0
übernehmen,9,2,-7,-1,1,0,0
dementieren,1,4,-3,-1,-1,-1,0
verlieren,2,3,-1,-1,-1,0,0
bestätigen,10,3,-7,-1,1,0,0
verwenden,2,3,-1,-1,-1,0,0
legen,1,5,-4,-1,-1,-1,0
setzen,2,3,-1,-1,-1,0,0
legen,5,3,-2,-1,1,0,0
finden,13,3,-10,-1,1,0,0
übernehmen,3,3,0,0,-1,0,0
reichen,3,2,1,1,-1,0,0
halten,5,2,-3,-1,1,0,0
tun,1,8,-7,-1,-1,-1,0
benutzen,2,10,-8,-1,-1,0,0
schaffen,2,3,-1,-1,-1,0,0
stellen,1,3,-2,-1,-1,0,0
stellen,2,3,-1,-1,-1,0,0
bringen,2,3,-1,-1,-1,0,0
stellen,6,2,4,1,-1,0,0
verlangen,12,2,-10,-1,1,0,0
nutzen,2,7,-5,-1,-1,0,0
verbinden,3,3,0,0,-1,0,0
finden,1,7,6,1,1,0,0
beklagen,1,2,1,1,1,0,0
verteidigen,3,3,0,0,1,0,0
geben,7,3,-4,-1,1,0,0
stellen,12,3,-9,-1,1,0,0
brauchen,3,4,1,1,1,0,0
erwarten,10,3,-7,-1,1,0,0
führen,5,2,-3,-1,1,0,0
erwarten,14,9,-5,-1,1,0,0
weisen,2,4,2,1,1,0,0
lösen,2,4,2,1,1,0,0
treiben,2,2,0,0,-1,0,0
führen,4,9,-5,-1,-1,0,0
bringen,2,3,-1,-1,-1,0,0
erhoffen,7,3,-4,-1,1,0,0
betreiben,2,5,-3,-1,-1,0,0
erwarten,7,3,-4,-1,1,0,0
führen,9,13,-4,-1,-1,0,0
sprechen,1,6,-5,-1,-1,-1,0
gewinnen,2,3,1,1,1,0,0
präsentieren,13,3,-10,-1,1,0,0
stellen,6,7,1,1,1,0,0
ergeben,2,8,6,1,1,0,0
liefern,2,16,-14,-1,-1,0,0
erklären,6,2,4,1,-1,0,0
schlagen,2,3,1,1,1,0,0
legen,1,3,-2,-1,-1,0,0
stellen,4,3,1,1,-1,0,0
bekommen,3,3,0,0,1,0,0
senken,5,5,0,0,-1,0,0
rechnen,6,4,-2,-1,1,0,0
verkünden,4,3,1,1,-1,0,0
bieten,10,5,-5,-1,1,0,0
kommen,10,3,-7,-1,1,0,0
handeln,1,9,-8,-1,-1,-1,0
stellen,2,3,-1,-1,-1,0,0
wirken,1,3,-2,-1,-1,-1,0
schlagen,2,4,2,1,1,0,0
dokumentieren,2,2,0,0,-1,0,0
finden,1,4,-3,-1,-1,-1,0
verfügen,5,26,-21,-1,-1,0,0
bringen,3,3,0,0,-1,0,0
häufen,1,2,-1,-1,-1,-1,0
steigern,1,3,-2,-1,-1,0,0
bekommen,1,9,-8,-1,-1,-1,0
treffen,10,3,-7,-1,1,0,0
füllen,3,2,1,1,-1,0,0
lassen,1,5,-4,-1,-1,-1,0
wenden,1,14,-13,-1,-1,-1,0
beobachten,8,3,-5,-1,1,0,0
spiegeln,1,5,-4,-1,-1,-1,0
zerhacken,2,4,-2,-1,-1,0,0
bekommen,1,12,-11,-1,-1,-1,0
bereiten,1,3,-2,-1,-1,-1,0
begründen,2,13,-11,-1,-1,0,0
erhalten,12,4,-8,-1,1,0,0
nehmen,2,2,0,0,-1,0,0
erklären,5,2,-3,-1,1,0,0
verfehlen,2,4,-2,-1,-1,0,0
erzeugen,3,3,0,0,1,0,0
versuchen,1,3,-2,-1,-1,-1,0
machen,1,3,-2,-1,-1,-1,0
strafen,3,4,1,1,1,0,0
melden,7,4,-3,-1,1,0,0
wählen,2,5,-3,-1,-1,0,0
beschäftigen,3,8,5,1,1,0,0
gehören,23,2,-21,-1,1,0,0
bieten,4,2,-2,-1,1,0,0
-,1,3,-2,-1,-1,-1,0
sehen,1,2,-1,-1,-1,-1,0
verstehen,1,5,-4,-1,-1,-1,0
begreifen,2,4,-2,-1,-1,0,0
bestehen,8,2,-6,-1,1,0,0
dauern,4,3,-1,-1,1,0,0
nehmen,2,2,0,0,-1,0,0
verletzen,2,3,1,1,1,0,0
veröffentlichen,4,2,2,1,-1,0,0
benutzen,1,8,-7,-1,-1,-1,0
kopieren,2,5,-3,-1,-1,0,0
verlieren,2,2,0,0,1,0,0
blättern,4,3,1,1,-1,0,0
nehmen,7,2,5,1,-1,0,0
vermuten,2,2,0,0,1,0,0
bezeichnen,4,2,-2,-1,1,0,0
vereinbaren,7,4,-3,-1,1,0,0
planen,8,4,-4,-1,1,0,0
zieren,2,3,1,1,1,0,0
zeigen,20,3,-17,-1,1,0,0
erfahren,1,7,-6,-1,-1,-1,0
konstruieren,2,6,4,1,1,0,0
sprechen,9,3,-6,-1,1,0,0
zeigen,1,2,-1,-1,-1,0,0
erwarten,2,2,0,0,1,0,0
geben,2,11,9,1,1,0,0
zahlen,2,3,1,1,1,0,0
strahlen,1,2,-1,-1,-1,0,0
führen,4,5,-1,-1,-1,0,0
erreichen,3,2,-1,-1,1,0,0
belaufen,1,9,-8,-1,-1,-1,0
erwarten,7,10,-3,-1,-1,0,0
geben,17,9,-8,-1,1,0,0
lösen,2,3,1,1,1,0,0
nennen,2,5,-3,-1,-1,0,0
nehmen,1,3,-2,-1,-1,0,0
gehören,4,9,5,1,1,0,0
betreiben,12,2,-10,-1,1,0,0
schicken,6,3,3,1,-1,0,0
bauen,14,5,-9,-1,1,0,0
machen,3,6,-3,-1,-1,0,0
legen,2,2,0,0,1,0,0
beschäftigen,3,5,2,1,1,0,0
sagen,2,3,1,1,1,0,0
erklären,2,4,2,1,1,0,0
entstehen,1,4,-3,-1,-1,0,0
richten,1,4,-3,-1,-1,-1,0
beschwören,2,3,-1,-1,-1,0,0
bauen,2,7,-5,-1,-1,0,0
machen,1,3,-2,-1,-1,-1,0
richten,16,4,-12,-1,1,0,0
meinen,3,7,4,1,1,0,0
nehmen,8,4,-4,-1,1,0,0
bergen,6,4,-2,-1,1,0,0
bezeichnen,3,3,0,0,-1,0,0
schaffen,16,3,-13,-1,1,0,0
arrangieren,4,2,2,1,-1,0,0
ermöglichen,12,3,-9,-1,1,0,0
attackieren,3,11,-8,-1,-1,0,0
fordern,3,3,0,0,1,0,0
bezeichnen,2,2,0,0,1,0,0
beschäftigen,3,3,0,0,1,0,0
betragen,20,3,-17,-1,1,0,0
liefern,3,3,0,0,-1,0,0
erklären,1,4,3,1,1,0,0
geben,9,3,-6,-1,1,0,0
bleiben,1,3,-2,-1,-1,-1,0
ziehen,2,7,-5,-1,-1,0,0
kommentieren,5,4,-1,-1,1,0,0
sehen,3,3,0,0,-1,0,0
erinnern,3,17,-14,-1,-1,0,0
nennen,2,14,-12,-1,-1,0,0
entbinden,6,5,1,1,-1,0,0
bedeuten,9,3,-6,-1,1,0,0
schließen,10,2,8,1,-1,0,0
entsprechen,3,5,2,1,1,0,0
rechnen,4,7,3,1,1,0,0
beschäftigen,2,2,0,0,1,0,0
führen,6,2,-4,-1,1,0,0
rechnen,7,3,-4,-1,1,0,0
versprechen,2,5,-3,-1,-1,0,0
überführen,4,23,-19,-1,-1,0,0
leisten,1,7,-6,-1,-1,0,0
machen,23,6,-17,-1,1,0,0
stellen,14,6,-8,-1,1,0,0
entsprechen,2,3,1,1,1,0,0
rechnen,6,3,3,1,-1,0,0
gewinnen,2,3,-1,-1,-1,0,0
greifen,1,3,-2,-1,-1,0,0
erläutern,2,2,0,0,1,0,0
entfalten,3,3,0,0,-1,0,0
präferieren,2,4,2,1,1,0,0
kommen,1,11,-10,-1,-1,0,0
suchen,2,3,-1,-1,-1,0,0
verkaufen,3,3,0,0,1,0,0
ermöglichen,3,5,-2,-1,-1,0,0
schätzen,7,4,3,1,-1,0,0
halten,6,2,4,1,-1,0,0
halten,11,2,9,1,-1,0,0
erklären,4,13,-9,-1,-1,0,0
nehmen,2,3,-1,-1,-1,0,0
kommentieren,3,5,2,1,1,0,0
geben,2,3,1,1,1,0,0
lesen,5,2,3,1,-1,0,0
überfliegen,4,2,-2,-1,1,0,0
legen,2,2,0,0,-1,0,0
reißen,2,2,0,0,-1,1,0
bedauern,6,3,-3,-1,1,0,0
stimmen,2,3,1,1,1,0,0
stellen,6,2,4,1,-1,0,0
lesen,7,4,3,1,-1,0,0
kaufen,1,3,-2,-1,-1,0,0
teilen,12,3,9,1,-1,0,0
implementieren,2,16,-14,-1,-1,0,0
beseitigen,3,5,2,1,1,0,0
finden,10,2,-8,-1,1,0,0
verbinden,5,11,-6,-1,-1,0,0
führen,5,4,1,1,-1,0,0
untersuchen,6,5,-1,-1,1,0,0
versprechen,8,6,-2,-1,1,0,0
bringen,4,5,-1,-1,-1,0,0
korrigieren,2,2,0,0,-1,0,0
führen,1,8,-7,-1,-1,-1,0
veröffentlichen,1,2,-1,-1,-1,0,0
bezeichnen,2,2,0,0,1,0,0
reduzieren,6,4,2,1,-1,0,0
halten,3,2,1,1,-1,0,0
legen,2,4,-2,-1,-1,0,0
nehmen,3,4,1,1,1,0,0
erwarten,18,4,-14,-1,1,0,0
erhalten,13,2,-11,-1,1,0,0
erklären,2,2,0,0,1,0,0
reagieren,3,9,-6,-1,-1,0,0
schließen,16,4,-12,-1,1,0,0
suchen,10,4,-6,-1,1,0,0
überspielen,1,4,-3,-1,-1,-1,0
bestaunen,2,9,-7,-1,-1,0,0
nehmen,3,3,0,0,1,0,0
richten,1,12,-11,-1,-1,-1,0
sehen,11,6,-5,-1,1,0,0
untergraben,3,6,-3,-1,-1,0,0
zeigen,4,3,-1,-1,1,0,0
führen,2,4,-2,-1,-1,0,0
bekommen,13,2,-11,-1,1,0,0
begründen,2,5,-3,-1,-1,0,0
bekommen,6,3,-3,-1,1,0,0
kaufen,4,4,0,0,-1,0,0
gliedern,1,5,-4,-1,-1,0,0
äußern,2,6,4,1,1,0,0
setzen,1,3,-2,-1,-1,-1,0
erwarten,1,4,3,1,1,0,0
besitzen,2,2,0,0,1,0,0
stellen,3,4,1,1,1,0,0
speichern,2,4,-2,-1,-1,0,0
bringen,2,2,0,0,-1,0,0
wecken,6,9,3,1,1,0,0
sorgen,2,3,1,1,1,0,0
verbuchen,14,3,-11,-1,1,0,0
geben,4,3,-1,-1,1,0,0
verbuchen,6,6,0,0,1,0,0
leiten,6,2,4,1,-1,0,0
bezahlen,1,2,-1,-1,-1,0,0
denken,2,9,7,1,1,0,0
handeln,1,3,-2,-1,-1,-1,0
ziehen,1,2,-1,-1,-1,0,0
verlangen,2,3,1,1,1,0,0
bringen,2,3,-1,-1,-1,0,0
schätzen,3,6,-3,-1,-1,0,0
handeln,1,13,-12,-1,-1,-1,0
machen,10,2,8,1,-1,0,0
diskutieren,1,2,1,1,1,0,0
erzielen,7,4,-3,-1,1,0,0
umsetzen,4,8,4,1,1,0,0
zeichnen,2,3,-1,-1,-1,0,0
lassen,4,5,1,1,1,0,0
gleichen,3,2,-1,-1,1,0,0
meinen,1,3,-2,-1,-1,0,0
nutzen,1,9,-8,-1,-1,0,0
halten,3,2,1,1,-1,0,0
geben,3,7,-4,-1,-1,0,0
sehen,1,2,-1,-1,-1,-1,0
führen,4,13,-9,-1,-1,0,0
verlangen,13,2,-11,-1,1,0,0
beschreiben,2,3,-1,-1,-1,0,0
kommen,7,11,4,1,1,0,0
spekulieren,1,6,5,1,1,0,0
streichen,7,5,-2,-1,1,0,0
bieten,3,4,1,1,1,0,0
sehen,3,3,0,0,1,0,0
vergeben,2,3,-1,-1,-1,0,0
ermöglichen,3,2,-1,-1,1,0,0
sagen,2,4,-2,-1,-1,0,0
präsentieren,4,3,-1,-1,1,0,0
bringen,2,2,0,0,-1,0,0
brauchen,1,3,2,1,1,0,0
erzielen,6,5,-1,-1,1,0,0
belaufen,1,15,-14,-1,-1,-1,0
erwarten,9,3,-6,-1,1,0,0
sehen,8,4,-4,-1,1,0,0
führen,2,22,-20,-1,-1,0,0
demonstrieren,5,3,-2,-1,1,0,0
werben,3,2,-1,-1,1,0,0
übertreffen,11,2,9,1,-1,0,0
legen,2,4,-2,-1,-1,0,0
kaufen,7,9,2,1,1,0,0
planen,9,3,-6,-1,1,0,0
stellen,12,3,-9,-1,1,0,0
verbinden,6,3,3,1,-1,0,0
ziehen,3,6,-3,-1,-1,0,0
sehen,8,3,5,1,-1,0,0
schlagen,1,2,1,1,1,-1,0
warten,8,3,-5,-1,1,1,0
meinen,1,2,-1,-1,-1,-1,0
halten,3,3,0,0,-1,0,0
zitieren,4,4,0,0,1,0,0
lassen,1,3,-2,-1,-1,-1,0
halten,8,2,6,1,-1,0,0
schalten,3,7,-4,-1,-1,0,0
durchlaufen,2,3,-1,-1,-1,0,0
geben,7,3,-4,-1,1,0,0
erläutern,19,3,-16,-1,1,0,0
bieten,18,2,-16,-1,1,0,0
erhoffen,5,4,-1,-1,1,0,0
nutzen,2,5,-3,-1,-1,0,0
verbuchen,2,5,3,1,1,0,0
geben,12,4,-8,-1,1,0,0
verschicken,2,2,0,0,-1,0,0
durchlaufen,2,3,1,1,1,0,0
nutzen,3,2,-1,-1,1,0,0
erreichen,6,5,-1,-1,1,0,0
machen,1,2,1,1,1,0,0
bringen,2,6,4,1,1,0,0
verkaufen,1,2,-1,-1,-1,0,0
erwarten,2,3,1,1,1,0,0
erwirtschaften,8,2,6,1,-1,0,0
finden,3,5,2,1,1,0,0
behandeln,2,4,-2,-1,-1,0,0
liefern,6,3,3,1,-1,0,0
nehmen,2,5,3,1,1,0,0
beschäftigen,11,3,-8,-1,1,0,0
nehmen,3,10,-7,-1,-1,0,0
investieren,4,8,-4,-1,-1,0,0
betreffen,14,5,-9,-1,1,0,0
gehen,9,8,-1,-1,1,0,0
zahlen,2,5,-3,-1,-1,0,0
sehen,2,3,-1,-1,-1,0,0
begründen,3,2,-1,-1,1,0,0
verkaufen,2,3,-1,-1,-1,0,0
stellen,2,2,0,0,-1,0,0
beziffern,4,4,0,0,-1,0,0
verhalten,1,3,-2,-1,-1,-1,0
kosten,4,2,-2,-1,1,0,0
treiben,7,3,4,1,-1,0,0
belaufen,1,5,-4,-1,-1,-1,0
übertragen,1,3,-2,-1,-1,0,0
kennen,4,6,2,1,1,0,0
stellen,4,3,-1,-1,1,0,0
übernehmen,13,4,9,1,-1,0,0
versetzen,1,10,-9,-1,-1,0,0
halten,1,4,-3,-1,-1,-1,0
bringen,2,3,-1,-1,-1,0,0
tragen,3,6,3,1,1,0,0
lassen,2,2,0,0,-1,1,0
erwarten,7,3,-4,-1,1,0,0
verzeichnen,9,5,-4,-1,1,0,0
bringen,2,6,-4,-1,-1,0,0
geben,5,4,1,1,-1,0,0
erwirtschaften,6,2,-4,-1,1,0,0
gehen,1,7,6,1,1,0,0
nehmen,5,12,7,1,1,0,0
schocken,2,2,0,0,-1,0,0
filmen,7,3,4,1,-1,0,0
sehen,5,2,3,1,-1,1,0
geben,2,3,1,1,1,0,0
kommen,1,3,-2,-1,-1,-1,0
schrauben,8,2,6,1,-1,0,0
sehen,5,2,3,1,-1,0,0
erwirtschaften,5,7,2,1,1,0,0
bauen,2,2,0,0,1,0,0
besitzen,2,2,0,0,1,0,0
stellen,8,2,6,1,-1,0,0
planen,4,3,-1,-1,1,0,0
verkaufen,4,3,-1,-1,1,0,0
prophezeien,8,3,-5,-1,1,0,0
handeln,1,3,-2,-1,-1,-1,0
bilden,25,3,-22,-1,1,0,0
streben,6,3,-3,-1,1,0,0
planen,7,5,-2,-1,1,0,0
führen,1,4,3,1,1,0,0
beziffern,13,6,7,1,-1,0,0
erhoffen,9,3,-6,-1,1,0,0
schätzen,7,2,5,1,-1,0,0
überraschen,2,28,-26,-1,-1,0,0
führen,2,6,-4,-1,-1,0,0
machen,2,2,0,0,-1,0,0
setzen,2,2,0,0,-1,0,0
verbannen,2,4,-2,-1,-1,0,0
setzen,1,4,3,1,1,0,0
verbauen,2,5,-3,-1,-1,0,0
bestücken,1,3,-2,-1,-1,-1,0
geben,10,3,7,1,-1,0,0
verwenden,4,3,-1,-1,1,0,0
geben,3,5,2,1,1,0,0
setzen,13,5,-8,-1,1,0,0
sagen,3,3,0,0,1,0,0
liefern,4,2,-2,-1,1,0,0
demonstrieren,7,6,1,1,-1,0,0
liefern,9,4,-5,-1,1,0,0
erreichen,11,3,-8,-1,1,0,0
bieten,15,11,-4,-1,1,0,0
dauern,3,3,0,0,1,0,0
sehen,13,4,-9,-1,1,0,0
äußern,7,10,3,1,1,0,0
stützen,3,2,-1,-1,1,0,0
zahlen,3,2,1,1,-1,0,0
rechnen,3,2,-1,-1,1,0,0
bringen,1,2,-1,-1,-1,0,0
bringen,3,3,0,0,-1,0,0
beherrschen,12,4,-8,-1,1,0,0
sehen,10,6,-4,-1,1,0,0
geben,8,7,-1,-1,1,-1,0
streben,9,3,-6,-1,1,0,0
rechnen,14,3,-11,-1,1,0,0
kontrollieren,4,7,-3,-1,-1,0,0
lesen,1,2,-1,-1,-1,-1,0
geben,2,3,1,1,1,0,0
sehen,11,2,-9,-1,1,-1,0
setzen,8,4,-4,-1,1,0,0
erwarten,2,4,2,1,1,0,0
erhalten,3,4,-1,-1,-1,0,0
ähneln,1,3,-2,-1,-1,-1,0
präsentieren,23,2,-21,-1,1,0,0
nutzen,2,2,0,0,1,0,0
rechnen,2,4,2,1,1,0,0
rechnen,9,3,-6,-1,1,0,0
kosten,6,3,-3,-1,1,0,0
verkaufen,7,4,-3,-1,1,0,0
heben,4,2,-2,-1,1,-1,0
geben,1,2,-1,-1,-1,0,0
verlieren,2,4,-2,-1,-1,0,0
reichen,1,8,-7,-1,-1,0,0
sagen,3,2,1,1,-1,0,0
verlassen,2,2,0,0,-1,0,0
fordern,5,2,-3,-1,1,0,0
setzen,2,2,0,0,-1,0,0
sagen,4,5,-1,-1,-1,0,0
liefern,2,15,-13,-1,-1,0,0
definieren,16,3,-13,-1,1,0,0
begründen,2,9,-7,-1,-1,0,0
suchen,4,5,-1,-1,-1,0,0
präsentieren,5,7,2,1,1,0,0
kosten,2,15,-13,-1,-1,0,0
erreichen,10,7,3,1,-1,0,0
präsentieren,17,10,-7,-1,1,0,0
sagen,2,2,0,0,-1,0,0
zeigen,12,6,-6,-1,1,0,0
erhoffen,7,7,0,0,1,0,0
gehören,10,6,-4,-1,1,0,0
führen,4,3,-1,-1,1,0,0
bieten,3,3,0,0,1,0,0
erhöhen,2,10,-8,-1,-1,0,0
liefern,2,3,1,1,1,0,0
schweigen,1,3,-2,-1,-1,-1,0
erwischen,5,3,-2,-1,1,0,0
beziffern,3,6,-3,-1,-1,0,0
erstellen,9,3,-6,-1,1,0,0
machen,10,3,-7,-1,1,0,0
führen,1,17,-16,-1,-1,-1,0
bringen,1,6,-5,-1,-1,-1,0
speichern,1,3,-2,-1,-1,0,0
tun,3,2,1,1,-1,0,0
finden,2,2,0,0,1,0,0
lassen,2,3,1,1,1,0,0
erzählen,1,5,-4,-1,-1,-1,0
heben,3,14,11,1,1,0,0
sehen,5,7,2,1,1,0,0
geben,5,5,0,0,1,0,0
planen,6,5,-1,-1,1,0,0
hinterlassen,2,4,2,1,1,0,0
untersuchen,2,2,0,0,-1,0,0
erreichen,6,7,-1,-1,-1,0,0
erreichen,3,16,-13,-1,-1,0,0
verbuchen,9,3,-6,-1,1,0,0
geben,2,7,-5,-1,-1,0,0
geben,4,3,-1,-1,1,0,0
bedienen,11,2,-9,-1,1,-1,0
illustrieren,8,2,-6,-1,1,0,0
betreiben,9,2,-7,-1,1,0,0
besitzen,6,2,-4,-1,1,0,0
setzen,6,2,-4,-1,1,0,0
rücken,8,4,4,1,-1,0,0
bieten,1,3,2,1,1,0,0
ermöglichen,8,2,-6,-1,1,0,0
-,22,3,-19,-1,1,0,0
nehmen,1,2,-1,-1,-1,-1,0
hängen,1,3,-2,-1,-1,-1,0
nehmen,1,2,1,1,1,0,0
korrigieren,6,2,4,1,-1,0,0
stellen,3,3,0,0,1,0,0
überrunden,2,2,0,0,1,0,0
setzen,2,4,-2,-1,-1,0,0
zeichnen,1,20,-19,-1,-1,-1,0
geben,2,3,-1,-1,-1,0,0
versprechen,2,4,2,1,1,0,0
päppeln,2,8,-6,-1,-1,0,0
verstoßen,3,7,4,1,1,0,0
stellen,4,2,2,1,-1,0,0
drohen,2,3,-1,-1,-1,0,0
zeigen,2,3,1,1,1,0,0
nehmen,1,4,3,1,1,0,0
verbuchen,6,6,0,0,1,0,0
strafen,2,14,-12,-1,-1,0,0
bekommen,5,5,0,0,1,0,0
bezeichnen,2,4,2,1,1,0,0
bringen,2,7,-5,-1,-1,0,0
erzielen,6,7,1,1,1,0,0
setzen,3,3,0,0,1,0,0
erreichen,2,4,-2,-1,-1,0,0
bieten,2,2,0,0,-1,0,0
reichen,18,3,-15,-1,1,0,0
schalten,10,3,-7,-1,1,0,0
unterstützen,13,4,-9,-1,1,0,0
verzichten,2,3,1,1,1,0,0
sehen,2,14,-12,-1,-1,0,0
ermöglichen,3,3,0,0,1,0,0
machen,8,2,6,1,-1,0,0
handeln,1,5,-4,-1,-1,-1,0
planen,5,4,-1,-1,1,0,0
verbrauchen,3,5,2,1,1,0,0
ziehen,15,3,-12,-1,1,0,0
geben,2,4,2,1,1,0,0
vertreten,12,3,-9,-1,1,0,0
berufen,4,3,-1,-1,1,0,0
formieren,1,3,-2,-1,-1,-1,0
entlassen,2,4,2,1,1,0,0
betragen,3,9,-6,-1,-1,0,0
geben,6,9,-3,-1,-1,0,0
sehen,1,2,1,1,1,0,0
geben,7,2,-5,-1,1,0,0
kosten,8,3,-5,-1,1,0,0
betreiben,9,4,-5,-1,1,0,0
gehen,6,4,2,1,-1,0,0
benötigen,2,4,2,1,1,0,0
erhalten,1,2,-1,-1,-1,0,0
nehmen,7,5,2,1,-1,0,0
reklamieren,6,3,-3,-1,1,0,0
installieren,23,5,-18,-1,1,0,0
erhalten,13,2,-11,-1,1,0,0
bergen,5,3,-2,-1,1,0,0
absolvieren,3,6,-3,-1,-1,0,0
begleiten,1,4,-3,-1,-1,-1,0
finden,1,3,2,1,1,0,0
senken,6,3,3,1,-1,0,0
machen,4,4,0,0,1,0,0
zeigen,6,3,-3,-1,1,0,0
nehmen,1,3,-2,-1,-1,-1,0
senken,2,3,-1,-1,-1,0,0
drücken,4,4,0,0,-1,0,0
stellen,6,3,-3,-1,1,0,0
einnehmen,3,6,3,1,1,0,0
tragen,1,6,-5,-1,-1,-1,0
rechnen,6,3,-3,-1,1,0,0
sehen,18,6,-12,-1,1,0,0
bekräftigen,1,4,-3,-1,-1,0,0
kündigen,5,2,-3,-1,1,0,0
denken,1,2,1,1,1,0,0
bezeichnen,2,7,-5,-1,-1,0,0
starten,6,7,1,1,1,0,0
produzieren,1,4,-3,-1,-1,0,0
beschäftigen,3,3,0,0,1,0,0
gehören,10,5,-5,-1,1,0,0
präsentieren,6,5,-1,-1,1,0,0
prognostizieren,9,3,-6,-1,1,0,0
handeln,1,3,-2,-1,-1,-1,0
sehen,8,4,4,1,-1,0,0
setzen,2,6,-4,-1,-1,0,0
stellen,3,2,1,1,-1,0,0
umfassen,15,3,-12,-1,1,0,0
bringen,18,3,-15,-1,1,0,0
führen,3,6,-3,-1,-1,0,0
erwarten,6,4,-2,-1,1,0,0
schaffen,6,6,0,0,1,0,0
verkaufen,5,4,1,1,-1,0,0
fragen,1,2,-1,-1,-1,-1,0
merken,1,4,-3,-1,-1,-1,0
beschäftigen,1,3,-2,-1,-1,-1,0
äußern,3,5,2,1,1,0,0
verkaufen,5,9,-4,-1,-1,0,0
sorgen,2,2,0,0,1,0,0
lehnen,2,7,5,1,1,0,0
geben,1,3,-2,-1,-1,0,0
schließen,2,2,0,0,1,0,0
geben,7,3,-4,-1,1,0,0
sperren,2,5,-3,-1,-1,0,0
teilen,2,2,0,0,-1,0,0
erweitern,3,11,-8,-1,-1,0,0
handeln,1,10,-9,-1,-1,-1,0
handeln,1,17,-16,-1,-1,-1,0
machen,4,6,2,1,1,0,0
reagieren,6,3,-3,-1,1,0,0
verhelfen,5,3,2,1,-1,0,0
hören,1,6,-5,-1,-1,-1,0
sagen,1,5,-4,-1,-1,0,0
bestimmen,4,2,-2,-1,1,0,0
sorgen,3,2,-1,-1,1,0,0
stehen,2,2,0,0,-1,0,0
gehören,6,9,3,1,1,0,0
wenden,1,17,-16,-1,-1,-1,0
bieten,12,6,6,1,-1,0,0
erwähnen,32,3,-29,-1,1,0,0
bringen,2,5,-3,-1,-1,0,0
erklären,11,11,0,0,-1,0,0
geben,4,7,3,1,1,0,0
beschicken,2,12,-10,-1,-1,0,0
verordnen,3,4,1,1,1,0,0
belaufen,1,4,-3,-1,-1,-1,0
erwarten,8,4,-4,-1,1,0,0
verdreifachen,2,4,-2,-1,-1,0,0
hoffen,6,2,-4,-1,1,0,0
nehmen,2,5,3,1,1,0,0
rechnen,2,4,2,1,1,0,0
beanspruchen,3,3,0,0,1,0,0
machen,1,7,-6,-1,-1,-1,0
meinen,9,9,0,0,-1,0,0
kündigen,9,2,-7,-1,1,0,0
sorgen,2,4,2,1,1,0,0
stellen,23,3,-20,-1,1,0,0
bauen,5,7,-2,-1,-1,0,0
erhalten,3,2,-1,-1,1,0,0
bringen,1,3,-2,-1,-1,0,0
bauen,1,4,-3,-1,-1,0,0
beruhen,8,2,-6,-1,1,0,0
beziffern,7,4,3,1,-1,0,0
kündigen,6,3,-3,-1,1,0,0
halten,5,6,1,1,1,0,0
begründen,2,5,3,1,1,0,0
rufen,2,3,-1,-1,-1,0,0
bringen,2,4,-2,-1,-1,0,0
fordern,1,3,2,1,1,0,0
kaufen,1,4,-3,-1,-1,0,0
rechnen,5,3,-2,-1,1,0,0
beschäftigen,3,2,-1,-1,1,0,0
versprechen,6,3,-3,-1,1,0,0
sehen,5,3,-2,-1,1,0,0
erwarten,4,3,-1,-1,1,0,0
platzieren,1,3,-2,-1,-1,0,0
zeigen,10,3,-7,-1,1,0,0
verfolgen,9,2,-7,-1,1,-1,0
verfügen,3,2,-1,-1,1,0,0
peilen,11,2,-9,-1,1,0,0
gehen,1,2,-1,-1,-1,-1,0
stellen,3,4,-1,-1,-1,0,0
enthalten,12,3,-9,-1,1,0,0
gehen,6,3,-3,-1,1,0,0
nehmen,2,4,-2,-1,-1,0,0
begründen,3,9,-6,-1,-1,0,0
geben,2,7,5,1,1,0,0
prognostizieren,1,2,-1,-1,-1,0,0
machen,17,3,14,1,-1,0,0
schaffen,2,5,-3,-1,-1,0,0
verzichten,13,3,-10,-1,1,0,0
sehen,13,3,-10,-1,1,0,0
handeln,1,2,-1,-1,-1,-1,0
zitieren,12,3,-9,-1,1,0,0
bekräftigen,1,5,-4,-1,-1,-1,0
stellen,2,3,1,1,1,0,0
machen,18,2,-16,-1,1,0,0
begründen,3,2,-1,-1,1,0,0
erwarten,3,2,-1,-1,1,0,0
übernehmen,14,2,-12,-1,1,0,0
zahlen,3,8,5,1,1,0,0
entsprechen,18,2,-16,-1,1,0,0
festigen,6,7,1,1,1,0,0
planen,5,3,-2,-1,1,0,0
geben,2,5,3,1,1,0,0
planen,5,3,-2,-1,1,0,0
legen,3,3,0,0,1,0,0
überraschen,2,3,1,1,1,0,0
schlagen,3,5,-2,-1,-1,0,0
betrachten,2,2,0,0,-1,0,0
verlieren,2,3,-1,-1,-1,0,0
verlieren,2,5,-3,-1,-1,0,0
bezeichnen,7,2,5,1,-1,0,0
richten,5,3,-2,-1,1,0,0
übernehmen,10,3,-7,-1,1,0,0
sehen,4,3,1,1,-1,0,0
gehören,10,3,-7,-1,1,0,0
halten,7,4,3,1,-1,0,0
erstrecken,1,13,-12,-1,-1,-1,0
stellen,2,3,-1,-1,-1,0,0
zeichnen,1,4,-3,-1,-1,-1,0
veröffentlichen,7,3,-4,-1,1,0,0
setzen,3,3,0,0,1,0,0
betragen,11,3,-8,-1,1,0,0
begründen,2,2,0,0,-1,0,0
demonstrieren,4,3,-1,-1,1,0,0
zeigen,2,3,1,1,1,0,0
ermöglichen,4,19,-15,-1,-1,0,0
bieten,9,4,-5,-1,1,0,0
geben,8,2,-6,-1,1,-1,0
bieten,1,3,2,1,1,0,0
belaufen,1,4,-3,-1,-1,-1,0
schreiben,2,3,1,1,1,0,0
führen,2,11,-9,-1,-1,0,0
führen,1,2,1,1,1,-1,0
legen,2,12,-10,-1,-1,0,0
halten,11,2,9,1,-1,0,0
geben,6,5,-1,-1,1,0,0
drängen,4,6,2,1,1,0,0
integrieren,6,3,3,1,-1,0,0
leiten,1,2,-1,-1,-1,0,0
bieten,9,4,-5,-1,1,0,0
fordern,2,12,-10,-1,-1,0,0
sehen,11,4,-7,-1,1,0,0
machen,1,5,-4,-1,-1,-1,0
ermöglichen,5,3,-2,-1,1,0,0
stoßen,5,2,-3,-1,1,0,0
schlagen,1,4,3,1,1,0,0
fordern,10,5,-5,-1,1,0,0
wenden,1,12,-11,-1,-1,-1,0
zeigen,1,8,-7,-1,-1,-1,0
honorieren,3,3,0,0,-1,0,0
verabschieden,1,2,-1,-1,-1,-1,0
verlassen,2,7,5,1,1,0,0
-,15,3,-12,-1,1,0,0
berichten,4,3,-1,-1,1,0,0
sehen,10,4,-6,-1,1,0,0
begrüßen,5,3,-2,-1,1,0,0
bieten,9,2,-7,-1,1,0,0
geben,6,6,0,0,1,0,0
kaufen,1,2,-1,-1,-1,0,0
implementieren,4,7,3,1,1,0,0
belassen,1,2,-1,-1,-1,-1,0
bekräftigen,20,2,-18,-1,1,0,0
schaffen,2,5,-3,-1,-1,0,0
stellen,2,3,-1,-1,-1,0,0
bringen,1,7,-6,-1,-1,-1,0
zeigen,1,16,-15,-1,-1,-1,0
machen,6,5,-1,-1,1,0,0
machen,6,4,-2,-1,1,0,0
bilden,2,2,0,0,-1,0,0
geben,14,4,-10,-1,1,0,0
bringen,4,2,2,1,-1,0,0
geben,5,2,-3,-1,1,0,0
verfallen,2,6,4,1,1,0,0
beschreiben,2,4,-2,-1,-1,0,0
beraten,5,4,1,1,-1,0,0
wenden,1,2,-1,-1,-1,0,0
versorgen,1,6,-5,-1,-1,-1,0
sagen,3,2,1,1,-1,0,0
stoßen,2,3,1,1,1,0,0
streben,11,3,-8,-1,1,0,0
unterbreiten,3,4,1,1,1,0,0
geben,4,6,2,1,1,0,0
schnappen,3,3,0,0,-1,0,0
zeigen,1,2,-1,-1,-1,-1,0
legen,4,3,-1,-1,1,0,0
zeigen,1,2,-1,-1,-1,-1,0
hängen,1,4,3,1,1,0,0
wenden,1,13,-12,-1,-1,-1,0
sehen,10,3,-7,-1,1,0,0
stellen,17,3,-14,-1,1,0,0
schlagen,4,3,-1,-1,1,0,0
bringen,3,2,1,1,-1,0,0
kaufen,1,5,-4,-1,-1,-1,0
übernehmen,13,5,-8,-1,1,0,0
verbringen,3,2,1,1,-1,0,0
verteidigen,3,3,0,0,-1,0,0
erwarten,2,4,-2,-1,-1,0,0
schließen,1,2,-1,-1,-1,0,0
lassen,1,2,-1,-1,-1,-1,0
beeinträchtigen,3,4,1,1,1,0,0
zahlen,1,6,-5,-1,-1,0,0
bestätigen,12,8,-4,-1,1,0,0
bezeichnen,3,2,1,1,-1,0,0
zeigen,1,8,-7,-1,-1,-1,0
stoßen,2,4,2,1,1,0,0
verstoßen,3,5,2,1,1,0,0
beanspruchen,5,8,3,1,1,0,0
bewerten,43,2,-41,-1,1,0,0
ändern,1,4,-3,-1,-1,-1,0
zeigen,1,2,-1,-1,-1,-1,0
stellen,3,3,0,0,1,0,0
nehmen,2,5,3,1,1,0,0
rechnen,8,2,-6,-1,1,0,0
fassen,1,2,1,1,1,0,0
bieten,2,3,-1,-1,-1,0,0
prüfen,16,2,-14,-1,1,-1,0
präsentieren,1,3,-2,-1,-1,-1,0
erklären,1,5,-4,-1,-1,0,0
kaufen,3,4,-1,-1,-1,0,0
schließen,5,3,-2,-1,1,0,0
kündigen,19,4,-15,-1,1,0,0
finden,6,3,-3,-1,1,0,0
präsentieren,1,4,-3,-1,-1,-1,0
versetzen,2,2,0,0,-1,0,0
versetzen,4,10,-6,-1,-1,0,0
erleiden,4,10,-6,-1,-1,0,0
verringern,1,4,-3,-1,-1,-1,0
erwarten,8,4,-4,-1,1,0,0
ermöglichen,7,2,-5,-1,1,0,0
ermöglichen,2,2,0,0,1,0,0
machen,1,2,-1,-1,-1,0,0
setzen,3,3,0,0,1,0,0
fordern,14,7,-7,-1,1,0,0
werfen,11,3,-8,-1,1,0,0
erhalten,17,3,-14,-1,1,0,0
begründen,2,4,-2,-1,-1,0,0
bringen,1,2,-1,-1,-1,0,0
richten,7,3,-4,-1,1,0,0
weisen,1,3,2,1,1,0,0
genießen,3,4,1,1,1,0,0
machen,7,3,-4,-1,1,0,0
bezeichnen,1,9,-8,-1,-1,-1,0
erwarten,15,3,-12,-1,1,0,0
lassen,18,5,-13,-1,1,0,0
liefern,7,4,-3,-1,1,0,0
richten,3,12,-9,-1,-1,0,0
geben,4,3,-1,-1,1,0,0
übernehmen,3,5,2,1,1,0,0
erzielen,7,3,-4,-1,1,0,0
legen,2,4,2,1,1,0,0
denken,13,2,-11,-1,1,0,0
bestätigen,6,3,3,1,-1,0,0
halten,10,2,8,1,-1,0,0
sehen,2,5,3,1,1,0,0
erlangen,4,4,0,0,1,0,0
entscheiden,1,3,-2,-1,-1,-1,0
entwickeln,5,4,-1,-1,1,0,0
bieten,15,4,-11,-1,1,0,0
bekommen,2,4,2,1,1,0,0
legen,3,3,0,0,1,0,0
erzielen,6,4,-2,-1,1,0,0
errechnen,2,3,1,1,1,0,0
begutachten,1,2,-1,-1,-1,-1,0
versuchen,1,4,-3,-1,-1,-1,0
sehen,2,5,3,1,1,0,0
geben,3,5,2,1,1,0,0
geben,2,3,-1,-1,-1,0,0
schließen,12,4,-8,-1,1,0,0
begründen,3,7,-4,-1,-1,0,0
sehen,2,2,0,0,-1,0,0
machen,2,3,1,1,1,0,0
betragen,4,4,0,0,1,0,0
erzielen,6,9,-3,-1,-1,0,0
erreichen,3,10,-7,-1,-1,0,0
betreiben,5,6,1,1,1,0,0
demonstrieren,11,3,8,1,-1,0,0
betrachten,2,5,-3,-1,-1,0,0
drosseln,2,4,2,1,1,0,0
unterstützen,8,14,6,1,1,0,0
betreiben,1,8,-7,-1,-1,0,0
bringen,3,3,0,0,-1,0,0
nutzen,2,4,-2,-1,-1,0,0
erreichen,6,5,-1,-1,1,0,0
enthalten,3,4,1,1,1,0,0
büßen,5,3,-2,-1,1,0,0
verzichten,12,2,-10,-1,1,0,0
unterzeichnen,4,6,2,1,1,0,0
planen,2,6,4,1,1,0,0
handeln,1,5,-4,-1,-1,-1,0
spülen,2,5,-3,-1,-1,0,0
bringen,3,3,0,0,-1,0,0
sehen,6,5,-1,-1,1,0,0
berufen,3,2,1,1,-1,0,0
übernehmen,6,7,-1,-1,-1,0,0
weisen,1,2,1,1,1,0,0
entlasten,3,5,-2,-1,-1,0,0
schreiben,2,2,0,0,-1,0,0
nehmen,2,3,-1,-1,-1,0,0
zahlen,5,4,-1,-1,1,1,0
wenden,1,4,-3,-1,-1,-1,0
versorgen,2,2,0,0,-1,0,0
erwarten,11,4,-7,-1,1,0,0
sehen,2,8,-6,-1,-1,0,0
profitieren,3,3,0,0,1,0,0
erweitern,4,12,-8,-1,-1,0,0
sehen,2,3,-1,-1,-1,0,0
beschreiben,9,4,-5,-1,1,0,0
bringen,3,2,1,1,-1,0,0
schleichen,1,4,-3,-1,-1,-1,0
sehen,2,3,1,1,1,0,0
veranlassen,7,7,0,0,-1,0,0
sehen,6,2,4,1,-1,0,0
weisen,2,4,2,1,1,0,0
betragen,8,16,-8,-1,-1,0,0
machen,1,3,-2,-1,-1,-1,0
betragen,2,6,-4,-1,-1,0,0
betreiben,1,4,-3,-1,-1,-1,0
erwarten,26,7,-19,-1,1,0,0
verschieben,1,4,-3,-1,-1,0,0
verschieben,6,10,-4,-1,-1,0,0
begründen,2,4,-2,-1,-1,0,0
nehmen,5,3,-2,-1,1,0,0
lassen,5,2,3,1,-1,0,0
schätzen,2,5,-3,-1,-1,0,0
lassen,3,2,1,1,-1,0,0
erwarten,3,4,1,1,1,0,0
präsentieren,3,2,1,1,-1,0,0
betragen,5,2,-3,-1,1,0,0
geben,11,2,-9,-1,1,0,0
lizenzieren,2,4,-2,-1,-1,0,0
gründen,10,3,-7,-1,1,0,0
schließen,1,4,-3,-1,-1,-1,0
entstehen,2,3,-1,-1,-1,0,0
erwarten,6,5,-1,-1,1,0,0
fordern,5,3,2,1,-1,0,0
erhalten,2,11,9,1,1,0,0
eröffnen,5,5,0,0,1,0,0
richten,1,7,-6,-1,-1,-1,0
betreiben,6,2,-4,-1,1,0,0
bieten,1,4,-3,-1,-1,0,0
legen,3,12,9,1,1,0,0
geben,4,2,-2,-1,1,0,0
bekommen,16,8,-8,-1,1,0,0
tun,1,2,-1,-1,-1,-1,0
erwirtschaften,6,5,-1,-1,1,0,0
spülen,3,6,-3,-1,-1,0,0
stellen,3,2,1,1,-1,0,0
halten,19,2,-17,-1,1,0,0
-,2,2,0,0,-1,0,0
machen,4,2,-2,-1,1,0,0
betreiben,3,4,1,1,1,0,0
kommentieren,5,7,2,1,1,0,0
organisieren,12,7,-5,-1,1,0,0
stoßen,2,3,1,1,1,0,0
erreichen,3,4,1,1,1,0,0
danken,2,3,-1,-1,-1,0,0
geben,11,4,-7,-1,1,0,0
jagen,2,2,0,0,-1,0,0
üben,1,2,-1,-1,-1,-1,0
fühlen,1,3,-2,-1,-1,-1,0
feiern,2,4,2,1,1,0,0
setzen,1,3,-2,-1,-1,-1,0
veröffentlichen,4,3,-1,-1,1,0,0
verkaufen,1,3,-2,-1,-1,-1,0
überschreiten,5,2,3,1,-1,0,0
begrüßen,3,4,-1,-1,-1,0,0
löschen,5,4,-1,-1,1,0,0
finden,1,7,-6,-1,-1,0,0
verkaufen,7,2,5,1,-1,0,0
erlauben,12,4,-8,-1,1,0,0
zahlen,2,8,-6,-1,-1,0,0
bringen,11,2,-9,-1,1,0,0
begründen,9,4,5,1,-1,0,0
gewähren,6,3,-3,-1,1,0,0
handeln,1,14,-13,-1,-1,-1,0
handeln,1,8,-7,-1,-1,-1,0
entwickeln,13,4,-9,-1,1,0,0
sprühen,3,2,1,1,-1,0,0
erhalten,3,4,1,1,1,0,0
erhalten,16,4,-12,-1,1,0,0
nehmen,1,2,1,1,1,0,0
sorgen,2,2,0,0,1,0,0
nehmen,2,3,1,1,1,0,0
vermarkten,2,6,-4,-1,-1,0,0
stellen,4,3,1,1,-1,0,0
nutzen,4,2,-2,-1,1,0,0
enthalten,11,3,-8,-1,1,0,0
stoßen,3,3,0,0,1,0,0
unterstützen,5,4,-1,-1,1,0,0
bewältigen,5,2,3,1,-1,0,0
zeigen,1,5,-4,-1,-1,-1,0
kommentieren,1,2,-1,-1,-1,-1,0
verwandeln,2,3,-1,-1,-1,0,0
zeigen,20,2,-18,-1,1,0,0
stellen,7,2,-5,-1,1,0,0
vereinen,8,7,1,1,-1,0,0
stellen,3,20,-17,-1,-1,0,0
weisen,2,9,7,1,1,0,0
verwandeln,2,6,-4,-1,-1,0,0
erhalten,12,2,-10,-1,1,0,0
geben,2,6,4,1,1,0,0
versprechen,9,2,-7,-1,1,0,0
produzieren,6,2,4,1,-1,0,0
kündigen,5,2,-3,-1,1,0,0
verbinden,1,4,-3,-1,-1,0,0
speichern,1,3,-2,-1,-1,0,0
erweitern,2,10,-8,-1,-1,0,0
kündigen,4,4,0,0,1,0,0
erhalten,12,2,-10,-1,1,0,0
investieren,3,3,0,0,-1,0,0
beziffern,3,5,-2,-1,-1,0,0
kosten,2,4,2,1,1,0,0
stellen,5,3,-2,-1,1,0,0
speichern,1,3,-2,-1,-1,0,0
stellen,3,7,-4,-1,-1,0,0
belaufen,1,3,-2,-1,-1,-1,0
zeigen,2,7,-5,-1,-1,0,0
leisten,4,2,-2,-1,1,0,0
bereiten,1,7,-6,-1,-1,-1,0
fahren,1,3,-2,-1,-1,0,0
denken,5,4,-1,-1,1,0,0
verarbeiten,1,7,-6,-1,-1,0,0
berechnen,4,4,0,0,1,0,0
bieten,19,2,-17,-1,1,0,0
verzichten,13,2,-11,-1,1,0,0
übertreffen,4,3,1,1,-1,-1,0
vereinen,5,5,0,0,-1,0,0
stellen,14,2,12,1,-1,0,0
schreiben,2,12,-10,-1,-1,0,0
fordern,4,2,2,1,-1,0,0
verlangen,5,2,-3,-1,1,0,0
verbringen,2,3,-1,-1,-1,0,0
entwickeln,1,4,-3,-1,-1,0,0
sagen,3,3,0,0,1,0,0
enthalten,24,10,-14,-1,1,0,0
zeichnen,1,3,-2,-1,-1,-1,0
verbessern,2,7,-5,-1,-1,0,0
drohen,2,2,0,0,-1,0,0
stellen,2,7,-5,-1,-1,0,0
reagieren,11,3,-8,-1,1,0,0
kündigen,1,9,-8,-1,-1,-1,0
bauen,2,3,-1,-1,-1,0,0
speichern,6,3,3,1,-1,0,0
vermitteln,1,2,-1,-1,-1,-1,0
bringen,11,4,-7,-1,1,0,0
ermitteln,6,4,-2,-1,1,0,0
kosten,2,4,-2,-1,-1,0,0
erzeugen,2,5,3,1,1,0,0
sparen,11,2,-9,-1,1,0,0
berechnen,6,7,1,1,1,0,0
richten,1,3,-2,-1,-1,-1,0
finden,1,6,-5,-1,-1,0,0
zitieren,2,3,-1,-1,-1,0,0
bieten,1,2,-1,-1,-1,0,0
geben,2,3,-1,-1,-1,0,0
erweitern,3,9,-6,-1,-1,0,0
durchsuchen,1,2,-1,-1,-1,0,0
erwarten,1,2,1,1,1,0,0
hoffen,3,12,9,1,1,0,0
fordern,2,6,-4,-1,-1,0,0
bieten,2,3,1,1,1,0,0
sehen,2,3,-1,-1,-1,0,0
sehen,9,2,-7,-1,1,0,0
verklagen,4,11,-7,-1,-1,0,0
zahlen,6,3,-3,-1,1,0,0
laden,2,3,-1,-1,-1,0,0
speichern,1,3,-2,-1,-1,-1,0
üben,1,2,-1,-1,-1,-1,0
sorgen,4,8,4,1,1,0,0
wagen,3,6,3,1,1,0,0
zeigen,1,3,-2,-1,-1,-1,0
sehen,1,13,-12,-1,-1,-1,0
finden,5,3,2,1,-1,0,0
geben,2,3,-1,-1,-1,0,0
halten,2,5,-3,-1,-1,0,0
verschicken,1,6,-5,-1,-1,-1,0
bieten,3,4,1,1,1,0,0
entfernen,2,3,-1,-1,-1,0,0
portieren,2,2,0,0,-1,0,0
schließen,2,4,2,1,1,0,0
übernehmen,7,9,2,1,1,0,0
handeln,1,12,-11,-1,-1,-1,0
reichen,18,3,15,1,-1,0,0
geben,3,3,0,0,1,0,0
bieten,3,3,0,0,-1,-1,0
geben,5,4,-1,-1,1,0,0
testen,2,7,-5,-1,-1,0,0
handeln,1,6,-5,-1,-1,-1,0
handeln,1,10,-9,-1,-1,-1,0
wechseln,2,4,2,1,1,0,0
präsentieren,7,2,-5,-1,1,0,0
annullieren,10,3,-7,-1,1,0,0
bezahlen,2,3,-1,-1,-1,0,0
untersuchen,9,5,-4,-1,1,0,0
verwenden,4,2,2,1,-1,0,0
machen,4,13,-9,-1,-1,0,0
verlangen,5,7,2,1,1,0,0
befinden,7,7,0,0,-1,0,0
verlangen,7,3,-4,-1,1,0,0
stellen,2,2,0,0,-1,0,0
werfen,2,5,3,1,1,0,0
geben,16,3,-13,-1,1,0,0
bieten,4,3,-1,-1,1,0,0
kosten,2,8,6,1,1,0,0
bieten,11,2,-9,-1,1,0,0
suchen,7,2,-5,-1,1,0,0
stellen,5,4,-1,-1,1,0,0
stehen,3,3,0,0,1,0,0
kosten,2,2,0,0,-1,0,0
ordnen,1,2,-1,-1,-1,0,0
füllen,1,3,-2,-1,-1,-1,0
beherrschen,11,2,-9,-1,1,0,0
liegen,3,3,0,0,1,0,0
gehören,2,2,0,0,-1,0,0
ermöglichen,1,3,-2,-1,-1,0,0
weisen,1,3,-2,-1,-1,0,0
liefern,3,4,-1,-1,-1,0,0
stellen,4,7,3,1,1,0,0
verfügen,4,6,2,1,1,0,0
befragen,3,12,9,1,1,0,0
handeln,1,12,-11,-1,-1,-1,0
spiegeln,4,3,-1,-1,1,0,0
erhalten,6,4,2,1,-1,0,0
bieten,5,5,0,0,1,0,0
betreiben,3,8,-5,-1,-1,0,0
präsentieren,5,9,4,1,1,0,0
machen,5,7,-2,-1,-1,0,0
bieten,1,2,1,1,1,0,0
bringen,8,4,-4,-1,1,0,0
benötigen,4,2,-2,-1,1,0,0
bekommen,2,2,0,0,1,0,0
unterdrücken,1,2,1,1,1,0,0
beziehen,4,7,-3,-1,-1,0,0
bewegen,3,3,0,0,-1,0,0
begründen,2,3,-1,-1,-1,0,0
veröffentlichen,9,3,-6,-1,1,0,0
ermöglichen,9,3,-6,-1,1,0,0
übertragen,6,3,3,1,-1,0,0
bieten,20,2,-18,-1,1,-1,0
erhoffen,1,3,-2,-1,-1,-1,0
handeln,1,14,-13,-1,-1,-1,0
bezahlen,3,7,-4,-1,-1,0,0
holen,2,2,0,0,-1,0,0
bekommen,6,5,-1,-1,1,0,0
liefern,5,3,-2,-1,1,0,0
leiten,1,5,-4,-1,-1,0,0
liefern,12,9,-3,-1,1,0,0
speichern,5,3,-2,-1,1,0,0
zeigen,3,3,0,0,-1,0,0
ermitteln,5,3,2,1,-1,0,0
finden,2,2,0,0,1,0,0
bieten,9,3,6,1,-1,0,0
benötigen,3,2,1,1,-1,0,0
kosten,6,4,-2,-1,1,1,0
handeln,1,10,-9,-1,-1,-1,0
verkaufen,5,3,-2,-1,1,0,0
hinterlassen,3,2,-1,-1,1,0,0
stellen,1,3,-2,-1,-1,0,0
beschleunigen,3,3,0,0,-1,0,0
nutzen,5,3,-2,-1,1,0,0
kosten,7,3,-4,-1,1,0,0
entdecken,6,5,1,1,-1,0,0
heizen,1,4,-3,-1,-1,-1,0
nehmen,2,2,0,0,1,0,0
überholen,5,3,2,1,-1,0,0
verhalten,1,10,-9,-1,-1,-1,0
verkaufen,4,4,0,0,-1,0,0
planen,7,2,-5,-1,1,0,0
handeln,1,16,-15,-1,-1,-1,0
bieten,3,2,1,1,-1,0,0
bringen,5,2,3,1,-1,0,0
setzen,3,4,1,1,1,0,0
führen,3,3,0,0,-1,0,0
siedeln,1,18,-17,-1,-1,-1,0
rüsten,1,12,-11,-1,-1,-1,0
umfassen,2,2,0,0,1,-1,0
lassen,1,4,-3,-1,-1,-1,0
kosten,5,3,-2,-1,1,0,0
liefern,3,5,2,1,1,0,0
lassen,2,3,1,1,1,0,0
zerstören,1,2,-1,-1,-1,-1,0
verbinden,2,2,0,0,-1,0,0
planen,9,4,5,1,-1,0,0
schalten,2,3,-1,-1,-1,0,0
legen,2,5,3,1,1,0,0
kosten,2,2,0,0,1,0,0
bieten,2,2,0,0,-1,0,0
streichen,5,3,2,1,-1,0,0
stellen,1,3,-2,-1,-1,0,0
nennen,11,3,-8,-1,1,0,0
liefern,6,3,3,1,-1,0,0
integrieren,2,3,-1,-1,-1,0,0
spielen,4,2,-2,-1,1,0,0
veröffentlichen,7,3,-4,-1,1,0,0
ziehen,2,4,-2,-1,-1,0,0
verlieren,2,2,0,0,1,0,0
betreiben,2,3,-1,-1,-1,0,0
unterstützen,3,3,0,0,1,0,0
richten,1,3,-2,-1,-1,-1,0
verschieben,1,2,-1,-1,-1,0,0
benötigen,2,4,-2,-1,-1,0,0
entwickeln,8,5,-3,-1,1,0,0
sammeln,1,4,-3,-1,-1,0,0
nutzen,1,3,-2,-1,-1,0,0
bezahlen,8,4,-4,-1,1,0,0
bewirken,1,3,2,1,1,1,0
führen,2,2,0,0,1,0,0
entwickeln,5,2,-3,-1,1,0,0
gründen,6,10,-4,-1,-1,0,0
kombinieren,4,4,0,0,-1,0,0
speichern,3,3,0,0,-1,0,0
geben,2,4,-2,-1,-1,0,0
brauchen,4,3,-1,-1,1,0,0
stellen,10,7,-3,-1,1,0,0
senken,2,4,2,1,1,0,0
rüsten,3,4,-1,-1,-1,0,0
läuten,5,5,0,0,1,0,0
packen,2,3,-1,-1,-1,0,0
kombinieren,2,5,-3,-1,-1,0,0
drücken,2,3,1,1,1,0,0
stellen,3,4,1,1,1,0,0
erwähnen,6,4,2,1,-1,0,0
setzen,2,9,-7,-1,-1,0,0
bieten,7,2,-5,-1,1,0,0
verlangen,4,3,-1,-1,1,0,0
setzen,2,5,-3,-1,-1,0,0
übertakten,2,6,-4,-1,-1,0,0
kühlen,2,5,-3,-1,-1,0,0
erkennen,2,3,-1,-1,-1,0,0
verlangen,1,6,5,1,1,0,0
liefern,11,3,-8,-1,1,0,0
nehmen,1,3,2,1,1,0,0
beziffern,2,5,-3,-1,-1,0,0
handeln,1,12,-11,-1,-1,-1,0
geben,21,5,-16,-1,1,0,0
bieten,6,4,-2,-1,1,0,0
gewähren,3,3,0,0,1,0,0
setzen,2,3,-1,-1,-1,0,0
bringen,19,3,-16,-1,1,0,0
verschenken,5,7,2,1,1,0,0
bringen,5,3,2,1,-1,0,0
verschieben,9,4,5,1,-1,0,0
versammeln,5,5,0,0,1,0,0
beginnen,7,3,-4,-1,1,0,0
präsentieren,9,3,-6,-1,1,0,0
dienen,7,9,2,1,1,0,0
übertragen,4,2,2,1,-1,0,0
schaffen,7,4,-3,-1,1,0,0
finden,1,5,4,1,1,0,0
bitten,4,2,-2,-1,1,0,0
enthalten,11,7,-4,-1,1,0,0
handeln,1,10,-9,-1,-1,-1,0
stellen,1,7,-6,-1,-1,-1,0
kosten,2,2,0,0,1,0,0
reduzieren,6,5,1,1,-1,0,0
liefern,3,5,2,1,1,0,0
kosten,4,4,0,0,1,0,0
machen,1,4,-3,-1,-1,-1,0
beginnen,8,3,-5,-1,1,0,0
verkaufen,2,3,-1,-1,-1,0,0
handeln,1,8,-7,-1,-1,-1,0
bieten,3,3,0,0,1,0,0
setzen,8,3,5,1,-1,0,0
kosten,2,4,2,1,1,0,0
erreichen,5,7,2,1,1,0,0
nehmen,1,3,2,1,1,0,0
erreichen,13,2,-11,-1,1,0,0
hängen,1,3,-2,-1,-1,-1,0
verbraten,2,7,-5,-1,-1,0,0
sehen,2,2,0,0,-1,0,0
pflegen,9,3,-6,-1,1,0,0
erzeugen,7,3,-4,-1,1,0,0
setzen,5,2,-3,-1,1,0,0
kosten,2,2,0,0,1,0,0
durchbrechen,1,2,-1,-1,-1,0,0
bauen,2,12,-10,-1,-1,0,0
überholen,5,12,-7,-1,-1,0,0
erzielen,5,4,-1,-1,1,0,0
beschleunigen,2,3,-1,-1,-1,0,0
stellen,2,5,-3,-1,-1,0,0
drohen,1,12,-11,-1,-1,0,0
fertigen,3,4,-1,-1,-1,0,0
stellen,8,6,-2,-1,1,0,0
kosten,2,5,-3,-1,-1,0,0
senken,4,4,0,0,-1,0,0
geben,16,2,-14,-1,1,0,0
pflegen,13,5,-8,-1,1,0,0
demonstrieren,9,11,-2,-1,-1,0,0
bieten,5,4,-1,-1,1,0,0
rüsten,19,5,14,1,-1,0,0
rüsten,1,13,-12,-1,-1,-1,0
bestätigen,13,3,-10,-1,1,0,0
verlieren,2,3,1,1,1,0,0
finden,1,3,-2,-1,-1,0,0
stellen,7,3,-4,-1,1,0,0
verbrauchen,5,2,-3,-1,1,0,0
erzielen,4,4,0,0,1,0,0
bringen,3,5,2,1,1,0,0
erweitern,1,3,-2,-1,-1,0,0
führen,5,3,2,1,-1,0,0
handeln,1,9,-8,-1,-1,-1,0
fertigen,2,11,-9,-1,-1,0,0
stellen,11,3,-8,-1,1,0,0
verheizen,3,3,0,0,1,0,0
erben,3,10,-7,-1,-1,0,0
integrieren,3,3,0,0,-1,0,0
zeigen,2,3,-1,-1,-1,0,0
bringen,4,3,1,1,-1,0,0
holen,4,4,0,0,1,0,0
lesen,3,5,-2,-1,-1,0,0
machen,4,2,-2,-1,1,0,0
kaufen,9,4,-5,-1,1,0,0
nutzen,4,11,7,1,1,0,0
kosten,2,4,2,1,1,1,0
stellen,2,15,-13,-1,-1,0,0
führen,2,6,-4,-1,-1,0,0
handeln,1,15,-14,-1,-1,-1,0
betreiben,2,3,-1,-1,-1,0,0
liefern,2,5,-3,-1,-1,0,0
lindern,4,4,0,0,1,0,0
schalten,10,3,7,1,-1,0,0
geben,3,3,0,0,-1,0,0
setzen,2,4,-2,-1,-1,0,0
vergleichen,3,3,0,0,-1,0,0
geben,2,10,-8,-1,-1,0,0
kaufen,2,3,-1,-1,-1,0,0
bringen,1,7,-6,-1,-1,0,0
präsentieren,13,3,-10,-1,1,0,0
überprüfen,2,3,-1,-1,-1,0,0
verwenden,1,3,2,1,1,0,0
sehen,4,2,-2,-1,1,0,0
erkennen,2,6,-4,-1,-1,0,0
zeigen,4,9,5,1,1,0,0
speichern,2,3,-1,-1,-1,0,0
bieten,3,4,-1,-1,-1,0,0
bringen,2,3,-1,-1,-1,0,0
tauschen,4,5,1,1,1,0,0
handeln,1,14,-13,-1,-1,-1,0
kündigen,3,4,-1,-1,-1,0,0
stellen,2,4,2,1,1,0,0
erlauben,8,2,-6,-1,1,0,0
stellen,10,3,-7,-1,1,0,0
stellen,16,5,-11,-1,1,0,0
überholen,1,2,-1,-1,-1,0,0
setzen,2,2,0,0,1,0,0
zahlen,2,15,-13,-1,-1,0,0
setzen,2,5,3,1,1,1,0
erwarten,23,2,-21,-1,1,0,0
setzen,1,2,-1,-1,-1,0,0
verkaufen,8,3,-5,-1,1,0,0
bestätigen,4,6,-2,-1,-1,0,0
gelingen,1,4,-3,-1,-1,0,0
kommentieren,5,7,-2,-1,-1,0,0
stellen,4,8,4,1,1,0,0
stellen,2,7,-5,-1,-1,0,0
kündigen,4,6,2,1,1,0,0
nennen,5,3,-2,-1,1,0,0
kosten,5,7,2,1,1,0,0
machen,3,5,-2,-1,-1,0,0
gelingen,2,3,-1,-1,-1,0,0
erwähnen,2,3,1,1,1,0,0
sehen,2,4,-2,-1,-1,0,0
steuern,4,7,-3,-1,-1,0,0
geben,10,3,-7,-1,1,0,0
erwerben,12,10,2,1,-1,0,0
handeln,1,7,-6,-1,-1,-1,0
verbinden,2,4,-2,-1,-1,0,0
entsprechen,4,2,-2,-1,1,0,0
bringen,2,3,-1,-1,-1,0,0
bieten,10,5,-5,-1,1,0,0
kosten,2,4,2,1,1,0,0
profitieren,3,2,1,1,-1,1,0
benötigen,6,4,-2,-1,1,0,0
stellen,1,8,-7,-1,-1,0,0
verlangen,4,2,-2,-1,1,0,0
liefern,2,2,0,0,-1,0,0
finden,2,11,-9,-1,-1,0,0
verkaufen,3,4,1,1,1,0,0
beherrschen,2,3,1,1,1,0,0
lancieren,3,3,0,0,-1,0,0
vereinen,3,2,1,1,-1,1,0
zeigen,2,4,-2,-1,-1,0,0
erweitern,4,8,-4,-1,-1,0,0
zeigen,1,8,-7,-1,-1,0,0
verhelfen,2,4,-2,-1,-1,0,0
gönnen,2,4,-2,-1,-1,0,0
verbrauchen,7,4,-3,-1,1,1,0
sparen,4,7,3,1,1,0,0
schlagen,2,9,7,1,1,0,0
präsentieren,5,19,-14,-1,-1,0,0
bringen,2,2,0,0,-1,0,0
spielen,4,4,0,0,1,0,0
stellen,1,13,-12,-1,-1,0,0
geben,5,5,0,0,-1,0,0
wählen,1,2,-1,-1,-1,0,0
setzen,9,2,-7,-1,1,0,0
legen,2,8,-6,-1,-1,0,0
geben,12,2,-10,-1,1,0,0
präsentieren,4,3,-1,-1,1,0,0
mangeln,13,3,-10,-1,1,0,0
zeigen,8,5,-3,-1,1,0,0
peilen,22,3,-19,-1,1,0,0
geben,2,3,1,1,1,0,0
verkaufen,4,4,0,0,1,0,0
strecken,2,4,-2,-1,-1,0,0
entscheiden,1,5,-4,-1,-1,-1,0
verwalten,2,13,-11,-1,-1,0,0
zitieren,2,3,-1,-1,-1,0,0
finden,1,8,7,1,1,0,0
stellen,2,5,-3,-1,-1,0,0
senken,2,3,-1,-1,-1,0,0
bauen,1,2,-1,-1,-1,0,0
schließen,2,4,-2,-1,-1,0,0
nehmen,4,10,-6,-1,-1,0,0
statten,2,7,-5,-1,-1,0,0
bringen,2,2,0,0,-1,0,0
bauen,4,2,-2,-1,1,0,0
versprechen,2,4,2,1,1,0,0
zeigen,2,2,0,0,1,-1,0
verbinden,2,7,-5,-1,-1,0,0
stellen,5,8,3,1,1,0,0
festigen,5,6,1,1,1,0,0
versprechen,2,3,1,1,1,0,0
verhelfen,2,9,-7,-1,-1,0,0
fertigen,4,2,2,1,-1,0,0
geben,2,3,1,1,1,0,0
kosten,2,6,4,1,1,0,0
verbessern,7,4,-3,-1,1,0,0
sehen,3,6,3,1,1,0,0
versprechen,6,5,-1,-1,1,0,0
bieten,4,4,0,0,1,0,0
verwenden,5,2,3,1,-1,0,0
veranstalten,16,3,-13,-1,1,0,0
bringen,1,3,-2,-1,-1,-1,0
pflegen,3,3,0,0,1,0,0
schieben,2,2,0,0,-1,0,0
geben,1,3,-2,-1,-1,-1,0
bekommen,8,3,-5,-1,1,0,0
bieten,2,12,-10,-1,-1,0,0
erwähnen,2,16,-14,-1,-1,0,0
projizieren,4,3,1,1,-1,0,0
halten,2,3,-1,-1,-1,0,0
bauen,3,3,0,0,-1,0,0
nehmen,2,4,-2,-1,-1,0,0
verkaufen,4,3,1,1,-1,0,0
erlauben,3,3,0,0,-1,0,0
picken,5,4,-1,-1,1,0,0
wiegen,3,5,2,1,1,0,0
kosten,3,2,-1,-1,1,0,0
bekommen,14,2,-12,-1,1,0,0
befördern,4,15,-11,-1,-1,0,0
liefern,3,6,-3,-1,-1,0,0
erhöhen,2,8,-6,-1,-1,0,0
kombinieren,2,9,-7,-1,-1,0,0
legen,3,2,1,1,-1,0,0
hageln,1,3,-2,-1,-1,0,0
tun,1,2,-1,-1,-1,-1,0
verkaufen,1,3,-2,-1,-1,0,0
konvertieren,2,7,-5,-1,-1,0,0
synchronisieren,1,4,-3,-1,-1,0,0
legen,2,18,-16,-1,-1,0,0
legen,9,4,-5,-1,1,0,0
führen,2,4,2,1,1,0,0
betragen,2,5,3,1,1,0,0
berechnen,4,2,-2,-1,1,0,0
stellen,10,3,7,1,-1,0,0
bestätigen,2,3,-1,-1,-1,0,0
übermitteln,2,4,2,1,1,0,0
erhoffen,9,6,-3,-1,1,0,0
stellen,1,23,-22,-1,-1,-1,0
ergänzen,2,3,-1,-1,-1,0,0
legen,6,2,4,1,-1,0,0
kosten,2,2,0,0,1,0,0
erreichen,10,5,5,1,-1,0,0
erreichen,4,2,-2,-1,1,0,0
kosten,2,2,0,0,1,0,0
beinhalten,13,2,-11,-1,1,-1,0
stehen,7,4,-3,-1,1,0,0
eröffnen,3,5,-2,-1,-1,0,0
implementieren,8,3,5,1,-1,0,0
stellen,5,3,-2,-1,1,0,0
halten,9,2,7,1,-1,0,0
verbieten,3,9,-6,-1,-1,0,0
öffnen,1,2,-1,-1,-1,0,0
sammeln,4,2,2,1,-1,0,0
erfordern,7,4,-3,-1,1,0,0
kosten,2,2,0,0,1,0,0
kündigen,8,3,-5,-1,1,0,0
nennen,12,6,-6,-1,1,0,0
liefern,6,3,-3,-1,1,0,0
erhoffen,8,6,-2,-1,1,0,0
reduzieren,4,10,-6,-1,-1,1,0
erhöhen,2,3,-1,-1,-1,0,0
handeln,1,28,-27,-1,-1,-1,0
melden,3,6,-3,-1,-1,-1,0
begrüßen,3,10,-7,-1,-1,0,0
präsentieren,3,3,0,0,1,0,0
bestehen,5,5,0,0,1,0,0
registrieren,3,8,-5,-1,-1,0,0
nutzen,2,4,-2,-1,-1,0,0
zitieren,5,15,-10,-1,-1,0,0
tragen,7,4,3,1,-1,0,0
enthalten,6,4,-2,-1,1,0,0
betragen,6,2,4,1,-1,0,0
sparen,2,2,0,0,-1,0,0
bauen,1,3,-2,-1,-1,0,0
erkennen,1,2,-1,-1,-1,0,0
geben,2,2,0,0,-1,0,0
geben,3,2,1,1,-1,0,0
schicken,2,4,-2,-1,-1,0,0
schlagen,2,5,3,1,1,0,0
übertreffen,4,18,-14,-1,-1,0,0
dauern,3,3,0,0,1,0,0
erklären,1,14,-13,-1,-1,-1,0
übertreffen,3,3,0,0,-1,0,0
finden,13,2,-11,-1,1,0,0
kündigen,1,4,3,1,1,0,0
geben,17,2,-15,-1,1,0,0
erweitern,4,3,1,1,-1,0,0
unterstützen,4,10,-6,-1,-1,0,0
finden,1,2,-1,-1,-1,-1,0
handeln,1,7,-6,-1,-1,-1,0
erweitern,2,3,-1,-1,-1,0,0
merken,3,4,1,1,1,0,0
wenden,2,17,-15,-1,-1,0,0
fügen,2,4,-2,-1,-1,0,0
werfen,3,5,-2,-1,-1,0,0
sammeln,2,3,1,1,1,0,0
vermeiden,11,2,-9,-1,1,-1,0
schicken,2,3,-1,-1,-1,0,0
enthalten,23,2,-21,-1,1,0,0
geben,7,2,-5,-1,1,0,0
enthalten,17,3,-14,-1,1,0,0
bieten,6,2,4,1,-1,0,0
erzielen,8,3,-5,-1,1,0,0
beantragen,11,6,-5,-1,1,0,0
nehmen,1,2,-1,-1,-1,0,0
demonstrieren,9,4,-5,-1,1,0,0
testen,2,5,-3,-1,-1,0,0
registrieren,3,2,-1,-1,1,0,0
zeigen,17,3,-14,-1,1,0,0
stellen,11,3,-8,-1,1,0,0
erhalten,2,2,0,0,1,0,0
fordern,2,2,0,0,-1,0,0
nehmen,3,2,1,1,-1,0,0
suchen,2,10,-8,-1,-1,0,0
ersetzen,2,10,-8,-1,-1,0,0
liefern,8,6,-2,-1,1,0,0
planen,3,3,0,0,1,0,0
umfassen,8,3,-5,-1,1,0,0
bauen,8,3,-5,-1,1,0,0
installieren,4,3,-1,-1,1,0,0
bauen,1,8,-7,-1,-1,0,0
halten,1,3,2,1,1,0,0
schreiben,1,7,-6,-1,-1,-1,0
schicken,2,4,-2,-1,-1,0,0
präsentieren,2,3,-1,-1,-1,0,0
handeln,1,13,-12,-1,-1,-1,0
beschreiben,4,3,-1,-1,1,0,0
kündigen,4,4,0,0,1,0,0
speichern,2,4,-2,-1,-1,0,0
demonstrieren,1,12,-11,-1,-1,-1,0
suchen,3,3,0,0,1,0,0
benötigen,3,3,0,0,1,0,0
rechnen,8,3,-5,-1,1,0,0
ziehen,7,10,-3,-1,-1,0,0
greifen,2,4,-2,-1,-1,0,0
bauen,1,7,-6,-1,-1,-1,0
verlieren,1,2,-1,-1,-1,0,0
nutzen,2,2,0,0,-1,1,0
fordern,17,2,-15,-1,1,0,0
bekommen,1,2,-1,-1,-1,0,0
quittieren,12,3,9,1,-1,0,0
verlieren,2,2,0,0,1,0,0
führen,3,9,-6,-1,-1,0,0
sehen,4,5,1,1,1,0,0
bewahren,1,16,-15,-1,-1,-1,0
erhoffen,7,2,-5,-1,1,0,0
konvertieren,4,2,2,1,-1,0,0
benötigen,2,3,1,1,1,0,0
sparen,2,4,-2,-1,-1,0,0
legen,3,14,-11,-1,-1,0,0
rufen,2,3,1,1,1,0,0
beinhalten,7,2,-5,-1,1,0,0
präsentieren,4,7,3,1,1,0,0
wählen,5,7,2,1,1,1,0
unterlegen,9,2,7,1,-1,0,0
veröffentlichen,5,2,-3,-1,1,0,0
unterstützen,6,3,-3,-1,1,0,0
bedeuten,14,2,-12,-1,1,0,0
verbieten,1,2,-1,-1,-1,1,0
adressieren,4,3,-1,-1,1,0,0
präsentieren,12,4,-8,-1,1,0,0
folgen,27,3,-24,-1,1,0,0
finden,6,3,-3,-1,1,0,0
legen,7,4,3,1,-1,0,0
stellen,8,2,6,1,-1,0,0
bekommen,2,3,-1,-1,-1,-1,0
erläutern,7,7,0,0,1,0,0
liefern,2,4,2,1,1,0,0
forcieren,4,4,0,0,1,0,0
integrieren,4,4,0,0,-1,0,0
honorieren,2,2,0,0,-1,0,0
reklamieren,10,2,-8,-1,1,-1,0
handeln,1,6,-5,-1,-1,-1,0
unterstützen,4,16,-12,-1,-1,0,0
ersetzen,6,8,-2,-1,-1,0,0
geben,3,5,2,1,1,0,0
reklamieren,8,2,6,1,-1,1,0
gewähren,10,4,-6,-1,1,0,0
geben,3,3,0,0,1,0,0
evaluieren,2,13,-11,-1,-1,0,0
äußern,1,2,-1,-1,-1,-1,0
geben,1,2,-1,-1,-1,-1,0
bieten,10,4,-6,-1,1,0,0
befreien,1,3,-2,-1,-1,0,0
liefern,1,4,-3,-1,-1,0,0
bieten,10,8,2,1,-1,0,0
führen,1,3,-2,-1,-1,0,0
handeln,1,10,-9,-1,-1,-1,0
erwerben,9,2,-7,-1,1,0,0
belaufen,1,4,-3,-1,-1,-1,0
kosten,9,3,-6,-1,1,1,0
finanzieren,1,2,-1,-1,-1,-1,0
stellen,11,3,-8,-1,1,0,0
belaufen,1,3,-2,-1,-1,-1,0
ermöglichen,8,11,-3,-1,-1,0,0
bieten,3,4,1,1,1,0,0
planen,5,3,2,1,-1,0,0
bieten,15,4,-11,-1,1,0,0
belaufen,1,4,-3,-1,-1,-1,0
lizenzieren,1,3,-2,-1,-1,0,0
streben,6,4,-2,-1,1,0,0
erheben,1,3,2,1,1,0,0
erklären,2,2,0,0,-1,0,0
produzieren,2,3,1,1,1,0,0
bieten,6,7,1,1,1,0,0
nehmen,5,3,2,1,-1,0,0
melden,9,4,-5,-1,1,0,0
machen,6,8,2,1,1,0,0
zeigen,6,2,-4,-1,1,0,0
übertreffen,1,20,-19,-1,-1,0,0
stellen,4,21,-17,-1,-1,0,0
zahlen,2,6,4,1,1,0,0
investieren,5,4,1,1,-1,0,0
nehmen,2,2,0,0,-1,0,0
verhindern,12,3,-9,-1,1,0,0
beliefern,2,5,-3,-1,-1,0,0
winken,1,2,-1,-1,-1,-1,0
ergänzen,2,4,-2,-1,-1,0,0
informieren,2,3,-1,-1,-1,0,0
sparen,4,4,0,0,1,0,0
mahnen,1,2,-1,-1,-1,0,0
sehen,4,3,-1,-1,1,0,0
reduzieren,5,3,2,1,-1,0,0
verursachen,6,3,-3,-1,1,0,0
bedienen,1,10,-9,-1,-1,-1,0
äußern,1,2,-1,-1,-1,-1,0
bringen,1,2,-1,-1,-1,0,0
bieten,3,3,0,0,1,0,0
geben,3,3,0,0,1,0,0
nehmen,2,2,0,0,-1,0,0
beobachten,4,2,-2,-1,1,0,0
stellen,4,2,2,1,-1,0,0
reflektieren,3,3,0,0,1,0,0
halten,1,4,3,1,1,0,0
sehen,2,3,-1,-1,-1,0,0
halten,1,2,-1,-1,-1,-1,0
sehen,7,8,-1,-1,-1,0,0
bieten,2,2,0,0,-1,0,0
bringen,12,4,8,1,-1,0,0
wiegen,3,2,-1,-1,1,0,0
versprechen,6,3,-3,-1,1,0,0
vergleichen,4,12,-8,-1,-1,0,0
steigern,2,11,-9,-1,-1,0,0
verbuchen,3,7,4,1,1,0,0
steuern,4,3,-1,-1,1,0,0
erwarten,9,4,-5,-1,1,0,0
sprechen,1,8,-7,-1,-1,-1,0
meinen,19,2,-17,-1,1,-1,0
moderieren,2,5,3,1,1,0,0
übernehmen,5,3,-2,-1,1,0,0
nutzen,3,3,0,0,-1,0,0
rechnen,1,3,2,1,1,0,0
weisen,2,2,0,0,-1,1,0
dokumentieren,4,6,-2,-1,-1,0,0
geben,6,3,-3,-1,1,0,0
führen,6,8,-2,-1,-1,0,0
bedrohen,1,2,1,1,1,0,0
melden,6,3,-3,-1,1,0,0
führen,1,6,-5,-1,-1,-1,0
erwarten,7,4,3,1,-1,0,0
-,2,2,0,0,1,0,0
sprechen,3,20,-17,-1,-1,0,0
sehen,4,4,0,0,1,0,0
nutzen,6,4,-2,-1,1,0,0
geben,3,7,4,1,1,0,0
deuten,2,2,0,0,-1,0,0
bestehen,45,4,-41,-1,1,0,0
verdoppeln,4,3,1,1,-1,0,0
besitzen,11,2,-9,-1,1,0,0
reichen,3,3,0,0,1,0,0
handeln,1,3,-2,-1,-1,-1,0
stellen,16,2,14,1,-1,0,0
rechnen,5,2,-3,-1,1,0,0
bezeichnen,13,3,-10,-1,1,0,0
erwecken,12,2,-10,-1,1,0,0
wünschen,5,4,1,1,-1,0,0
stellen,2,5,-3,-1,-1,0,0
stellen,3,5,2,1,1,0,0
unterhalten,39,4,-35,-1,1,0,0
äußern,2,5,3,1,1,0,0
stellen,7,3,-4,-1,1,0,0
beherrschen,4,3,1,1,-1,0,0
sehen,3,7,4,1,1,0,0
bieten,10,7,-3,-1,1,0,0
pressen,1,2,-1,-1,-1,0,0
sehen,8,3,5,1,-1,0,0
geben,2,16,-14,-1,-1,0,0
entsprechen,4,13,9,1,1,0,0
äußern,2,9,-7,-1,-1,0,0
geben,4,2,-2,-1,1,0,0
passen,3,2,-1,-1,1,0,0
beziehen,1,2,1,1,1,0,0
versprechen,6,3,-3,-1,1,0,0
blockieren,14,6,8,1,-1,0,0
besitzen,6,4,-2,-1,1,0,0
nutzen,12,6,-6,-1,1,0,0
verschaffen,1,2,1,1,1,0,0
bringen,2,2,0,0,-1,0,0
erhalten,1,2,-1,-1,-1,0,0
gelingen,2,4,-2,-1,-1,0,0
übersetzen,4,2,2,1,-1,0,0
sehen,11,5,-6,-1,1,0,0
verfehlen,7,3,4,1,-1,0,0
reflektieren,2,3,-1,-1,-1,0,0
umfassen,11,8,-3,-1,1,0,0
zeigen,10,3,-7,-1,1,0,0
vergleichen,6,4,2,1,-1,0,0
richten,1,25,-24,-1,-1,-1,0
sehen,1,6,-5,-1,-1,-1,0
wissen,1,11,-10,-1,-1,-1,0
stellen,20,3,-17,-1,1,0,0
wünschen,5,16,11,1,1,0,0
entwickeln,2,4,-2,-1,-1,0,0
kommentieren,16,8,-8,-1,1,0,0
sehen,3,6,-3,-1,-1,0,0
stellen,2,3,-1,-1,-1,0,0
raten,2,2,0,0,1,0,0
gestehen,2,3,-1,-1,-1,0,0
leisten,16,4,-12,-1,1,0,0
begründen,1,7,-6,-1,-1,-1,0
senken,1,2,-1,-1,-1,0,0
deuten,1,7,-6,-1,-1,-1,0
stellen,15,6,-9,-1,1,0,0
sehen,19,4,-15,-1,1,0,0
erwarten,2,13,-11,-1,-1,0,0
bestellen,13,3,-10,-1,1,0,0
umfassen,17,3,-14,-1,1,0,0
melden,7,11,4,1,1,0,0
zählen,4,22,18,1,1,0,0
verfehlen,2,4,-2,-1,-1,0,0
brennen,1,11,-10,-1,-1,0,0
kranken,4,3,-1,-1,1,0,0
stellen,2,6,-4,-1,-1,0,0
eröffnen,1,6,-5,-1,-1,-1,0
wissen,2,5,-3,-1,-1,-1,0
machen,5,2,-3,-1,1,0,0
erzeugen,3,4,-1,-1,-1,0,0
präsentieren,5,4,-1,-1,1,0,0
zählen,2,4,-2,-1,-1,0,0
vereinfachen,4,2,-2,-1,1,-1,0
empfangen,1,6,5,1,1,0,0
nehmen,4,4,0,0,1,0,0
sammeln,5,2,-3,-1,1,0,0
verzeichnen,8,3,-5,-1,1,0,0
sehen,7,8,1,1,1,0,0
erfahren,3,4,1,1,1,0,0
erwarten,3,4,1,1,1,0,0
bezeichnen,3,2,1,1,-1,0,0
versorgen,1,4,-3,-1,-1,-1,0
nutzen,2,4,2,1,1,0,0
erzielen,2,4,-2,-1,-1,0,0
nutzen,3,2,-1,-1,1,0,0
machen,12,3,-9,-1,1,0,0
zeigen,15,5,-10,-1,1,0,0
gelingen,2,7,5,1,1,0,0
benötigen,5,2,-3,-1,1,0,0
screenen,2,6,-4,-1,-1,0,0
ermöglichen,6,3,-3,-1,1,0,0
erhoffen,7,5,-2,-1,1,0,0
rüsten,2,2,0,0,-1,0,0
funken,2,3,-1,-1,-1,0,0
belaufen,1,4,-3,-1,-1,-1,0
stellen,16,3,-13,-1,1,0,0
legen,2,3,-1,-1,-1,0,0
begründen,2,6,-4,-1,-1,0,0
präsentieren,10,3,-7,-1,1,0,0
geben,4,4,0,0,1,0,0
äußern,10,5,-5,-1,1,0,0
begründen,3,16,-13,-1,-1,0,0
geben,4,3,-1,-1,1,0,0
berichten,2,23,-21,-1,-1,0,0
zählen,7,3,-4,-1,1,0,0
nehmen,10,2,-8,-1,1,0,0
empfehlen,21,10,11,1,-1,0,0
schlagen,1,3,-2,-1,-1,0,0
sehen,3,4,-1,-1,-1,0,0
gefährden,4,6,2,1,1,0,0
entsprechen,5,4,-1,-1,1,0,0
schlagen,2,3,1,1,1,0,0
weisen,10,2,-8,-1,1,0,0
stellen,15,3,12,1,-1,0,0
berufen,6,2,4,1,-1,0,0
gehören,3,2,1,1,-1,0,0
reichen,2,8,-6,-1,-1,0,0
suchen,2,2,0,0,-1,0,0
schließen,1,2,-1,-1,-1,-1,0
rechnen,5,2,-3,-1,1,0,0
kosten,5,2,3,1,-1,0,0
treiben,2,3,-1,-1,-1,0,0
stellen,9,2,7,1,-1,0,0
suchen,4,6,2,1,1,0,0
handeln,1,3,-2,-1,-1,-1,0
umfassen,3,2,-1,-1,1,0,0
erwarten,1,2,-1,-1,-1,-1,0
reißen,2,3,-1,-1,-1,0,0
bringen,2,3,-1,-1,-1,0,0
lassen,2,3,-1,-1,-1,0,0
suchen,11,4,-7,-1,1,0,0
machen,1,4,-3,-1,-1,-1,0
geben,3,4,-1,-1,-1,0,0
raten,3,2,-1,-1,1,0,0
vertreiben,11,2,-9,-1,1,-1,0
machen,3,3,0,0,1,0,0
stellen,13,5,-8,-1,1,0,0
öffnen,3,3,0,0,1,0,0
stoßen,3,2,-1,-1,1,0,0
starten,5,2,3,1,-1,0,0
verändern,1,4,-3,-1,-1,-1,0
bieten,3,2,1,1,-1,0,0
enthalten,6,2,-4,-1,1,0,0
bieten,4,2,2,1,-1,0,0
nennen,1,2,-1,-1,-1,-1,0
bringen,2,2,0,0,-1,0,0
verlängern,1,3,-2,-1,-1,0,0
beschäftigen,3,3,0,0,1,0,0
berücksichtigen,8,2,-6,-1,1,0,0
enthalten,4,2,-2,-1,1,0,0
skizzieren,9,3,-6,-1,1,0,0
enthalten,12,2,-10,-1,1,-1,0
erfassen,6,4,-2,-1,1,0,0
rechnen,7,3,-4,-1,1,0,0
erhalten,3,2,-1,-1,1,-1,0
starten,4,9,5,1,1,0,0
umfassen,5,2,-3,-1,1,0,0
geben,4,4,0,0,-1,0,0
stellen,1,8,7,1,1,0,0
spüren,3,3,0,0,-1,0,0
starten,5,6,1,1,1,0,0
geben,6,2,-4,-1,1,0,0
unterliegen,3,7,4,1,1,0,0
schließen,1,2,-1,-1,-1,-1,0
geraten,2,3,1,1,1,0,0
weisen,7,4,-3,-1,1,0,0
verleihen,5,3,-2,-1,1,0,0
handeln,1,6,-5,-1,-1,0,0
bringen,1,5,-4,-1,-1,-1,0
peitschen,1,3,-2,-1,-1,0,0
senken,2,4,-2,-1,-1,0,0
stehen,8,2,6,1,-1,0,0
erwarten,11,7,-4,-1,1,0,0
verschenken,1,2,-1,-1,-1,0,0
belegen,2,3,-1,-1,-1,0,0
kosten,2,2,0,0,1,0,0
sehen,6,4,-2,-1,1,0,0
gehen,3,3,0,0,1,0,0
suchen,3,2,-1,-1,1,0,0
genießen,6,3,-3,-1,1,0,0
stellen,3,4,1,1,1,0,0
machen,3,4,1,1,1,0,0
präsentieren,6,3,-3,-1,1,0,0
zeigen,13,3,-10,-1,1,0,0
bieten,7,4,-3,-1,1,0,0
kennen,1,13,-12,-1,-1,-1,0
fallen,2,2,0,0,-1,0,0
pendeln,1,3,-2,-1,-1,-1,0
verlangen,3,2,-1,-1,1,0,0
bieten,4,2,2,1,-1,0,0
malen,3,3,0,0,-1,0,0
finden,1,5,4,1,1,-1,0
verbinden,4,5,-1,-1,-1,0,0
erhalten,5,9,4,1,1,0,0
preisen,1,2,-1,-1,-1,-1,0
stellen,2,3,-1,-1,-1,0,0
ermöglichen,4,2,-2,-1,1,0,0
schütten,4,3,1,1,-1,0,0
moderieren,5,3,2,1,-1,0,0
richten,2,2,0,0,1,0,0
bringen,5,3,2,1,-1,0,0
zeichnen,1,9,-8,-1,-1,-1,0
handeln,1,12,-11,-1,-1,-1,0
zeigen,3,4,-1,-1,-1,0,0
lesen,7,2,-5,-1,1,-1,0
geben,3,3,0,0,-1,0,0
reagieren,4,6,-2,-1,-1,0,0
übernehmen,2,3,1,1,1,0,0
kündigen,7,3,-4,-1,1,0,0
präsentieren,17,3,-14,-1,1,0,0
setzen,2,2,0,0,-1,0,0
manövrieren,5,3,2,1,-1,0,0
zeigen,1,3,-2,-1,-1,-1,0
zeigen,22,3,-19,-1,1,0,0
lernen,9,3,6,1,-1,0,0
verweisen,3,3,0,0,-1,0,0
verlieren,2,3,-1,-1,-1,0,0
begründen,1,3,-2,-1,-1,-1,0
verständigen,1,2,-1,-1,-1,-1,0
ermöglichen,1,3,2,1,1,0,0
führen,10,4,-6,-1,1,0,0
führen,3,3,0,0,1,0,0
bitten,2,2,0,0,1,0,0
begründen,1,12,-11,-1,-1,-1,0
geben,2,3,-1,-1,-1,0,0
rüsten,1,2,-1,-1,-1,0,0
weisen,8,3,-5,-1,1,0,0
erfordern,4,3,-1,-1,1,0,0
installieren,2,4,-2,-1,-1,0,0
zeichnen,1,5,-4,-1,-1,-1,0
kritisieren,14,6,-8,-1,1,0,0
halten,2,12,-10,-1,-1,0,0
installieren,2,4,-2,-1,-1,0,0
handeln,1,4,-3,-1,-1,-1,0
rechnen,8,2,-6,-1,1,0,0
sorgen,2,3,1,1,1,0,0
spielen,1,5,4,1,1,0,0
geben,2,2,0,0,-1,0,0
unterstützen,2,6,-4,-1,-1,0,0
kündigen,4,3,-1,-1,1,0,0
hoffen,2,2,0,0,1,0,0
handeln,1,6,-5,-1,-1,-1,0
handeln,1,8,-7,-1,-1,-1,0
handeln,1,20,-19,-1,-1,-1,0
verweisen,12,3,-9,-1,1,0,0
erhalten,15,5,10,1,-1,0,0
skizzieren,5,3,-2,-1,1,0,0
bringen,1,2,-1,-1,-1,0,0
zählen,7,3,-4,-1,1,0,0
liefern,1,3,-2,-1,-1,0,0
vergleichen,10,3,7,1,-1,0,0
handeln,1,10,-9,-1,-1,-1,0
geben,7,3,-4,-1,1,0,0
erhalten,3,5,2,1,1,0,0
betragen,2,3,1,1,1,0,0
sehen,2,3,1,1,1,0,0
beheben,39,9,-30,-1,1,0,0
zweifeln,15,10,-5,-1,1,0,0
nehmen,2,3,-1,-1,-1,0,0
bitten,2,4,-2,-1,-1,0,0
erhalten,3,2,1,1,-1,0,0
betragen,8,11,-3,-1,-1,0,0
gehören,2,3,1,1,1,0,0
belaufen,1,4,-3,-1,-1,-1,0
rechnen,2,9,7,1,1,0,0
gehen,1,3,2,1,1,0,0
verbreiten,2,3,1,1,1,0,0
betragen,3,12,-9,-1,-1,0,0
stellen,5,4,-1,-1,1,0,0
halten,14,2,12,1,-1,0,0
werfen,1,4,3,1,1,0,0
verzeichnen,15,3,-12,-1,1,0,0
melden,2,6,4,1,1,0,0
machen,4,3,-1,-1,1,0,0
erwarten,3,4,1,1,1,0,0
verteilen,8,8,0,0,1,0,0
durchsuchen,1,2,-1,-1,-1,0,0
sehen,1,4,-3,-1,-1,0,0
sehen,2,3,1,1,1,0,0
prophezeien,5,4,1,1,-1,0,0
verfügen,14,4,-10,-1,1,0,0
erwarten,13,5,-8,-1,1,0,0
halten,3,4,-1,-1,-1,0,0
benötigen,6,7,-1,-1,-1,0,0
bekommen,2,4,-2,-1,-1,0,0
finden,1,5,-4,-1,-1,-1,0
kündigen,6,3,3,1,-1,0,0
handeln,1,4,-3,-1,-1,-1,0
erhalten,4,3,-1,-1,1,0,0
bieten,1,4,-3,-1,-1,0,0
repräsentieren,1,3,-2,-1,-1,0,0
streben,6,3,-3,-1,1,0,0
tragen,3,3,0,0,1,0,0
bieten,3,2,-1,-1,1,0,0
richten,5,5,0,0,1,0,0
verknüpfen,2,2,0,0,-1,0,0
bieten,11,4,-7,-1,1,0,0
offenbaren,4,7,3,1,1,0,0
halten,6,2,4,1,-1,0,0
wecken,2,5,3,1,1,0,0
planen,5,2,3,1,-1,0,0
modifizieren,4,4,0,0,1,0,0
melden,11,3,-8,-1,1,0,0
planen,8,12,-4,-1,-1,0,0
statten,10,3,7,1,-1,0,0
erwarten,6,3,-3,-1,1,0,0
schaffen,2,8,6,1,1,0,0
stellen,3,2,1,1,-1,0,0
führen,2,13,11,1,1,-1,0
ermöglichen,2,4,2,1,1,0,0
stellen,3,2,-1,-1,1,0,0
kombinieren,2,6,-4,-1,-1,0,0
nutzen,2,7,-5,-1,-1,0,0
sehen,5,3,2,1,-1,0,0
verlangen,7,3,-4,-1,1,0,0
erklären,2,9,-7,-1,-1,0,0
sichern,3,3,0,0,1,0,0
beziffern,6,5,1,1,-1,0,0
erhalten,15,2,-13,-1,1,0,0
zahlen,1,2,-1,-1,-1,-1,0
bieten,2,4,-2,-1,-1,0,0
unterstützen,4,2,-2,-1,1,0,0
erwägen,5,2,-3,-1,1,0,0
bieten,5,4,-1,-1,1,0,0
verlangen,4,8,-4,-1,-1,0,0
stürmen,8,3,-5,-1,1,0,0
sehen,2,10,8,1,1,0,0
verbuchen,4,3,-1,-1,1,0,0
stellen,7,5,-2,-1,1,0,0
erhoffen,6,3,-3,-1,1,0,0
erhoffen,9,4,-5,-1,1,0,0
präsentieren,8,2,-6,-1,1,0,0
peilen,8,2,-6,-1,1,0,0
liefern,10,4,-6,-1,1,0,0
führen,22,5,-17,-1,1,0,0
schätzen,4,6,-2,-1,-1,0,0
betreuen,3,4,1,1,1,0,0
bauen,10,4,-6,-1,1,0,0
ergänzen,2,4,-2,-1,-1,0,0
machen,3,3,0,0,1,0,0
fühlen,1,13,-12,-1,-1,-1,0
demonstrieren,13,5,-8,-1,1,0,0
gehen,2,2,0,0,1,0,0
präsentieren,3,6,3,1,1,0,0
bieten,7,4,-3,-1,1,0,0
präsentieren,19,2,-17,-1,1,0,0
kosten,2,4,2,1,1,0,0
zahlen,2,8,-6,-1,-1,0,0
kündigen,2,5,-3,-1,-1,0,0
begründen,4,5,-1,-1,-1,0,0
nutzen,28,3,-25,-1,1,0,0
finden,8,5,-3,-1,1,0,0
verlängern,1,5,-4,-1,-1,-1,0
bieten,1,3,-2,-1,-1,0,0
verschieben,7,3,4,1,-1,0,0
beziehen,2,9,-7,-1,-1,0,0
öffnen,3,3,0,0,-1,0,0
schließen,1,3,-2,-1,-1,-1,0
versprechen,8,5,-3,-1,1,0,0
benötigen,4,12,8,1,1,0,0
sorgen,2,5,3,1,1,0,0
kosten,2,4,2,1,1,0,0
kosten,5,3,-2,-1,1,0,0
senken,7,7,0,0,-1,0,0
kosten,2,2,0,0,1,0,0
erhalten,9,2,-7,-1,1,0,0
handeln,1,10,-9,-1,-1,-1,0
relativieren,1,3,-2,-1,-1,-1,0
handeln,1,4,-3,-1,-1,-1,0
nutzen,5,3,-2,-1,1,0,0
schieben,7,12,-5,-1,-1,0,0
verlangen,11,2,-9,-1,1,0,0
bestätigen,6,2,-4,-1,1,0,0
bieten,2,3,1,1,1,0,0
bieten,2,5,3,1,1,0,0
verlassen,3,4,-1,-1,-1,0,0
stellen,3,3,0,0,1,0,0
handeln,1,18,-17,-1,-1,-1,0
kündigen,4,3,1,1,-1,0,0
kündigen,2,2,0,0,1,0,0
versprechen,5,3,-2,-1,1,0,0
kosten,4,2,-2,-1,1,0,0
stellen,2,2,0,0,1,0,0
produzieren,7,8,1,1,1,0,0
kündigen,14,3,-11,-1,1,0,0
wechseln,2,9,7,1,1,0,0
zahlen,7,6,-1,-1,1,0,0
reklamieren,2,2,0,0,-1,1,0
bieten,6,11,-5,-1,-1,0,0
zahlen,4,4,0,0,1,0,0
ziehen,2,4,-2,-1,-1,0,0
senken,5,7,-2,-1,-1,0,0
betragen,4,6,-2,-1,-1,0,0
bekommen,3,8,5,1,1,0,0
berechnen,8,5,-3,-1,1,0,0
geben,2,4,2,1,1,0,0
sorgen,2,4,2,1,1,0,0
zahlen,12,5,7,1,-1,0,0
stellen,2,2,0,0,-1,0,0
bestätigen,3,2,-1,-1,1,0,0
planen,1,4,3,1,1,0,0
nennen,17,6,-11,-1,1,0,0
kosten,2,3,1,1,1,0,0
benutzen,5,9,4,1,1,0,0
bieten,4,2,2,1,-1,0,0
bieten,8,2,-6,-1,1,0,0
belasten,3,5,-2,-1,-1,0,0
entsprechen,6,12,6,1,1,0,0
kosten,2,2,0,0,1,0,0
kündigen,2,2,0,0,1,0,0
nennen,2,2,0,0,-1,0,0
bedienen,16,2,-14,-1,1,0,0
kündigen,3,3,0,0,1,0,0
geben,1,3,-2,-1,-1,0,0
sehen,8,3,-5,-1,1,0,0
überprüfen,3,3,0,0,1,0,0
verfügen,2,2,0,0,-1,0,0
erzielen,6,3,-3,-1,1,0,0
geben,3,3,0,0,1,0,0
schieben,4,5,-1,-1,-1,0,0
bieten,4,5,-1,-1,-1,0,0
starten,6,3,-3,-1,1,0,0
machen,2,2,0,0,1,0,0
kosten,2,12,10,1,1,0,0
präsentieren,5,3,-2,-1,1,0,0
stellen,6,2,-4,-1,1,0,0
zeigen,1,2,-1,-1,-1,-1,0
mieten,1,3,2,1,1,0,0
bezeichnen,3,3,0,0,-1,0,0
stellen,12,2,-10,-1,1,0,0
stellen,5,3,2,1,-1,0,0
bieten,9,3,-6,-1,1,0,0
trennen,2,3,-1,-1,-1,0,0
bieten,12,2,-10,-1,1,0,0
senken,5,3,-2,-1,1,0,0
kündigen,9,2,-7,-1,1,0,0
bestätigen,8,2,-6,-1,1,0,0
verlangen,6,5,-1,-1,1,0,0
senken,5,4,1,1,-1,0,0
schätzen,7,5,2,1,-1,0,0
senken,5,3,-2,-1,1,0,0
stellen,4,3,-1,-1,1,0,0
berechnen,2,3,-1,-1,-1,0,0
befürchten,11,4,-7,-1,1,0,0
bedeuten,3,3,0,0,1,0,0
wählen,1,2,-1,-1,-1,0,0
starten,3,2,1,1,-1,0,0
beziffern,7,3,4,1,-1,0,0
geben,4,2,-2,-1,1,0,0
geben,4,3,1,1,-1,0,0
enthalten,8,2,-6,-1,1,0,0
handeln,1,8,-7,-1,-1,-1,0
senken,5,18,-13,-1,-1,0,0
kosten,2,2,0,0,-1,0,0
senken,2,15,-13,-1,-1,0,0
blockieren,1,2,-1,-1,-1,0,0
geben,4,3,-1,-1,1,0,0
bieten,19,3,-16,-1,1,0,0
kosten,5,2,3,1,-1,0,0
bestätigen,5,4,-1,-1,1,0,0
bieten,3,8,5,1,1,0,0
beschränken,2,3,-1,-1,-1,0,0
zahlen,2,3,1,1,1,0,0
zahlen,2,10,-8,-1,-1,0,0
bieten,9,2,-7,-1,1,0,0
umfassen,15,7,-8,-1,1,0,0
schlagen,2,11,9,1,1,0,0
handeln,1,12,-11,-1,-1,-1,0
belaufen,1,9,-8,-1,-1,-1,0
bieten,2,5,3,1,1,0,0
heben,2,3,-1,-1,-1,0,0
knöpfen,2,2,0,0,1,0,0
unterstützen,2,6,-4,-1,-1,0,0
kündigen,10,7,-3,-1,1,0,0
bestehen,7,4,-3,-1,1,0,0
erhöhen,7,3,4,1,-1,0,0
richten,1,3,-2,-1,-1,-1,0
handeln,1,4,-3,-1,-1,-1,0
bringen,16,3,-13,-1,1,0,0
senken,6,3,-3,-1,1,0,0
verlangen,5,6,1,1,1,0,0
kosten,2,2,0,0,-1,0,0
planen,13,2,-11,-1,1,0,0
bieten,11,2,-9,-1,1,0,0
beschädigen,9,3,-6,-1,1,0,0
ordern,2,4,2,1,1,0,0
geben,3,4,-1,-1,-1,0,0
bekommen,1,5,-4,-1,-1,0,0
planen,8,3,-5,-1,1,0,0
begrüßen,5,6,1,1,1,0,0
stellen,4,2,2,1,-1,0,0
gewähren,6,3,-3,-1,1,0,0
kündigen,20,4,-16,-1,1,0,0
geben,1,3,-2,-1,-1,-1,0
übergeben,2,5,-3,-1,-1,0,0
verweigern,2,2,0,0,1,0,0
senken,6,3,-3,-1,1,0,0
stellen,5,2,3,1,-1,0,0
geben,2,3,1,1,1,0,0
verstellen,2,2,0,0,1,0,0
stellen,4,3,-1,-1,1,0,0
erhalten,7,2,-5,-1,1,0,0
heimsen,3,4,1,1,1,0,0
handeln,1,8,-7,-1,-1,-1,0
übermitteln,1,3,-2,-1,-1,-1,0
handeln,1,15,-14,-1,-1,-1,0
reichen,5,5,0,0,1,0,0
suchen,3,2,-1,-1,1,0,0
befragen,4,5,1,1,1,0,0
betreiben,1,3,2,1,1,0,0
handeln,1,21,-20,-1,-1,-1,0
machen,2,4,2,1,1,0,0
sorgen,2,8,6,1,1,0,0
versuchen,1,2,1,1,1,0,0
greifen,2,10,-8,-1,-1,0,0
nehmen,3,7,-4,-1,-1,0,0
geben,1,12,-11,-1,-1,0,0
begründen,3,9,-6,-1,-1,0,0
lassen,2,4,2,1,1,0,0
handeln,1,20,-19,-1,-1,-1,0
bieten,19,3,-16,-1,1,0,0
registrieren,3,2,-1,-1,1,-1,0
stellen,11,3,-8,-1,1,0,0
billigen,4,6,2,1,1,0,0
blockieren,4,2,-2,-1,1,0,0
verlieren,2,4,-2,-1,-1,0,0
betragen,3,4,1,1,1,0,0
halten,5,6,-1,-1,-1,0,0
sehen,2,6,-4,-1,-1,0,0
verbinden,4,4,0,0,1,0,0
nutzen,3,13,-10,-1,-1,0,0
verteidigen,2,3,-1,-1,-1,0,0
finden,1,4,3,1,1,0,0
zeigen,4,3,1,1,-1,0,0
beziehen,4,7,3,1,1,0,0
besitzen,2,2,0,0,1,0,0
erhoffen,3,6,-3,-1,-1,0,0
übernehmen,10,3,-7,-1,1,0,0
gehören,2,3,1,1,1,0,0
versteigern,1,2,-1,-1,-1,0,0
stellen,2,2,0,0,-1,0,0
versteigern,3,4,-1,-1,-1,0,0
verkaufen,2,4,2,1,1,0,0
stellen,3,2,1,1,-1,0,0
stocken,6,3,3,1,-1,0,0
bringen,2,3,-1,-1,-1,0,0
geben,5,3,-2,-1,1,0,0
halten,4,10,-6,-1,-1,0,0
stützen,14,12,2,1,-1,0,0
handeln,1,2,-1,-1,-1,-1,0
rechnen,3,4,1,1,1,0,0
schaffen,2,4,2,1,1,0,0
wissen,2,3,-1,-1,-1,-1,0
handeln,1,7,-6,-1,-1,-1,0
machen,6,3,3,1,-1,0,0
verdienen,1,6,5,1,1,0,0
handeln,1,3,-2,-1,-1,-1,0
verstoßen,4,4,0,0,1,0,0
handeln,1,4,-3,-1,-1,-1,0
betragen,8,2,-6,-1,1,0,0
verbuchen,5,2,-3,-1,1,0,0
bleiben,2,2,0,0,-1,0,0
erreichen,3,3,0,0,1,0,0
bringen,1,11,-10,-1,-1,-1,0
vermitteln,12,2,-10,-1,1,0,0
handeln,1,9,-8,-1,-1,-1,0
legen,1,7,6,1,1,0,0
entgehen,2,3,-1,-1,-1,0,0
kündigen,7,2,-5,-1,1,0,0
kurbeln,4,7,3,1,1,0,0
bieten,4,2,-2,-1,1,0,0
halten,4,10,-6,-1,-1,0,0
deuten,6,4,-2,-1,1,0,0
geben,8,5,-3,-1,1,0,0
kosten,2,2,0,0,1,0,0
betragen,7,3,-4,-1,1,0,0
machen,9,3,-6,-1,1,0,0
statten,1,2,-1,-1,-1,0,0
verkünden,7,7,0,0,1,0,0
übertreffen,4,3,-1,-1,1,0,0
kündigen,3,4,1,1,1,0,0
beginnen,9,2,-7,-1,1,0,0
handeln,1,17,-16,-1,-1,-1,0
versprechen,6,5,-1,-1,1,0,0
besuchen,5,2,-3,-1,1,0,0
überschreiten,3,2,-1,-1,1,0,0
erheben,3,8,5,1,1,0,0
tragen,2,2,0,0,-1,0,0
nehmen,1,11,-10,-1,-1,0,0
entscheiden,2,3,-1,-1,-1,0,0
geben,7,2,-5,-1,1,0,0
erinnern,3,4,-1,-1,-1,0,0
rekrutieren,2,10,-8,-1,-1,0,0
zahlen,1,2,-1,-1,-1,0,0
betragen,3,3,0,0,1,0,0
aufnehmen,2,3,-1,-1,-1,0,0
-,1,6,-5,-1,-1,0,0
handeln,1,9,-8,-1,-1,-1,0
sprechen,1,8,-7,-1,-1,-1,0
verknüpfen,11,7,4,1,-1,0,0
erhoffen,2,5,3,1,1,0,0
verknüpfen,1,2,-1,-1,-1,0,0
geben,21,4,-17,-1,1,0,0
befragen,2,7,5,1,1,0,0
halten,5,6,-1,-1,-1,0,0
empfehlen,1,5,-4,-1,-1,0,0
stellen,14,7,-7,-1,1,0,0
halten,6,4,2,1,-1,0,0
geben,5,4,-1,-1,1,0,0
investieren,3,3,0,0,-1,0,0
ähneln,1,2,-1,-1,-1,0,0
kassieren,4,3,-1,-1,1,0,0
vervierfachen,11,4,-7,-1,1,0,0
kassieren,2,3,1,1,1,0,0
informieren,2,11,-9,-1,-1,0,0
verändern,2,3,1,1,1,0,0
betragen,3,7,4,1,1,0,0
beziffern,7,4,3,1,-1,0,0
verbuchen,2,3,-1,-1,-1,0,0
bieten,4,4,0,0,1,0,0
wissen,1,3,-2,-1,-1,-1,0
betragen,2,5,3,1,1,0,0
vergeben,6,3,-3,-1,1,0,0
gehören,5,7,2,1,1,0,0
berechnen,2,2,0,0,1,0,0
betragen,4,8,-4,-1,-1,0,0
machen,4,3,1,1,-1,0,0
dehnen,2,3,-1,-1,-1,0,0
vergrößern,1,4,-3,-1,-1,-1,0
finanzieren,1,2,-1,-1,-1,-1,0
warnen,2,8,-6,-1,-1,0,0
veröffentlichen,2,3,1,1,1,0,0
machen,4,3,-1,-1,1,0,0
handeln,1,3,-2,-1,-1,-1,0
versetzen,4,3,1,1,-1,0,0
hören,3,3,0,0,1,0,0
bitten,2,2,0,0,-1,0,0
entwickeln,2,2,0,0,1,0,0
stellen,2,3,1,1,1,0,0
sehen,1,5,-4,-1,-1,0,0
erhalten,7,3,-4,-1,1,0,0
organisieren,2,8,-6,-1,-1,0,0
bieten,2,2,0,0,-1,0,0
schlagen,2,3,1,1,1,0,0
geben,2,3,1,1,1,0,0
spielen,1,11,-10,-1,-1,-1,0
unternehmen,3,10,7,1,1,0,0
erhalten,2,6,4,1,1,0,0
nutzen,2,3,1,1,1,0,0
verzeichnen,7,3,-4,-1,1,1,0
bleiben,2,2,0,0,-1,0,0
vermissen,2,2,0,0,1,0,0
tun,1,3,-2,-1,-1,-1,0
erleichtern,3,4,1,1,1,0,0
finden,1,9,8,1,1,0,0
finden,11,6,-5,-1,1,0,0
schlagen,2,3,1,1,1,0,0
unterstützen,6,3,-3,-1,1,0,0
kosten,2,2,0,0,-1,0,0
schlagen,2,4,2,1,1,0,0
bekommen,18,4,-14,-1,1,0,0
missen,2,3,-1,-1,-1,0,0
speichern,5,2,-3,-1,1,0,0
erklären,2,6,-4,-1,-1,0,0
erreichen,3,3,0,0,1,0,0
stellen,12,3,-9,-1,1,0,0
setzen,2,15,-13,-1,-1,0,0
beschränken,1,3,-2,-1,-1,0,0
zeigen,6,7,1,1,1,0,0
verkaufen,6,4,2,1,-1,0,0
schlagen,2,4,2,1,1,0,0
legen,4,5,-1,-1,-1,0,0
stellen,3,3,0,0,1,0,0
bringen,4,2,2,1,-1,0,0
erhoffen,3,4,1,1,1,0,0
lenken,2,6,-4,-1,-1,0,0
nutzen,9,3,-6,-1,1,0,0
neigen,1,3,-2,-1,-1,-1,0
vertreiben,2,3,-1,-1,-1,0,0
richten,1,8,-7,-1,-1,-1,0
führen,1,10,-9,-1,-1,-1,0
schneiden,2,3,1,1,1,0,0
teilen,2,3,-1,-1,-1,0,0
beauftragen,2,5,-3,-1,-1,0,0
äußern,1,16,-15,-1,-1,-1,0
sehen,5,8,-3,-1,-1,0,0
bieten,1,3,2,1,1,0,0
vergleichen,2,12,-10,-1,-1,0,0
versechsfachen,1,3,-2,-1,-1,0,0
betragen,3,3,0,0,1,0,0
betragen,4,9,-5,-1,-1,0,0
stellen,5,2,3,1,-1,0,0
bieten,5,5,0,0,1,0,0
sehen,13,3,-10,-1,1,0,0
kaufen,1,4,-3,-1,-1,0,0
kaufen,3,8,-5,-1,-1,0,0
spielen,3,5,-2,-1,-1,0,0
verlieren,1,10,-9,-1,-1,0,0
handeln,1,14,-13,-1,-1,-1,0
entwickeln,8,2,6,1,-1,0,0
erreichen,6,12,-6,-1,-1,0,0
steigern,1,3,-2,-1,-1,0,0
fassen,1,2,-1,-1,-1,0,0
versprechen,8,3,-5,-1,1,0,0
setzen,3,3,0,0,1,0,0
strafen,5,7,-2,-1,-1,0,0
geben,2,2,0,0,-1,0,0
stellen,7,3,-4,-1,1,0,0
gehören,2,3,1,1,1,0,0
setzen,3,3,0,0,1,0,0
sehen,6,4,-2,-1,1,0,0
vereinbaren,5,4,-1,-1,1,0,0
weisen,2,2,0,0,-1,1,0
überschreiben,2,4,-2,-1,-1,0,0
fahren,2,3,1,1,1,0,0
investieren,4,3,-1,-1,1,0,0
sehen,2,8,-6,-1,-1,0,0
nutzen,3,5,-2,-1,-1,0,0
bringen,3,2,1,1,-1,1,0
bieten,6,2,-4,-1,1,0,0
bereiten,1,4,3,1,1,0,0
sehen,2,5,3,1,1,0,0
sehen,3,3,0,0,-1,0,0
sehen,1,2,-1,-1,-1,-1,0
stellen,1,2,-1,-1,-1,0,0
beschuldigen,1,2,1,1,1,0,0
liefern,2,4,-2,-1,-1,0,0
spiegeln,9,3,-6,-1,1,0,0
bieten,6,15,9,1,1,0,0
bieten,11,4,-7,-1,1,0,0
ermöglichen,6,3,3,1,-1,0,0
rechnen,6,3,-3,-1,1,0,0
kombinieren,4,5,-1,-1,-1,0,0
zeigen,12,4,-8,-1,1,0,0
enthalten,9,15,6,1,1,0,0
bieten,2,6,4,1,1,0,0
finden,5,3,-2,-1,1,0,0
lassen,1,2,-1,-1,-1,-1,0
setzen,9,3,6,1,-1,0,0
verbieten,1,2,-1,-1,-1,1,0
verschaffen,2,8,6,1,1,0,0
führen,2,4,-2,-1,-1,0,0
gestehen,4,6,2,1,1,0,0
sehen,5,3,-2,-1,1,0,0
sehen,2,6,4,1,1,0,0
sorgen,5,4,-1,-1,1,0,0
verlangen,5,3,-2,-1,1,0,0
ermöglichen,8,3,-5,-1,1,0,0
kündigen,2,9,-7,-1,-1,0,0
beherrschen,7,2,-5,-1,1,0,0
sehen,2,2,0,0,-1,0,0
bieten,4,4,0,0,1,0,0
bieten,3,3,0,0,-1,0,0
sehen,2,6,-4,-1,-1,0,0
finden,13,3,-10,-1,1,0,0
präsentieren,3,8,5,1,1,0,0
bieten,7,2,-5,-1,1,-1,0
sehen,2,3,-1,-1,-1,0,0
bewerten,2,3,-1,-1,-1,0,0
speichern,2,3,-1,-1,-1,0,0
bringen,5,5,0,0,-1,0,0
gründen,21,4,-17,-1,1,0,0
überholen,6,6,0,0,1,0,0
liefern,4,3,1,1,-1,0,0
