Verb,NP_len,PP_len,Len_diff,Len,Arg_status,Pronominality,Order
देख,9,2,-7,-1,1,0,1
रख,4,9,5,1,1,0,1
देख,11,3,8,1,-1,0,1
बसा,1,3,-2,-1,-1,0,1
बनवा,6,3,3,1,-1,0,1
कर,3,2,1,1,-1,0,1
निहार,1,3,-2,-1,-1,1,1
कह,1,2,1,1,1,0,1
बना,1,4,-3,-1,-1,1,1
देख,5,2,-3,-1,1,1,1
कर,5,2,3,1,-1,0,1
देख,5,3,-2,-1,1,0,1
डाल,1,3,2,1,1,0,1
जमा,2,3,1,1,1,0,1
ले,1,3,2,1,1,0,1
देख,7,5,-2,-1,1,0,1
बच,4,2,-2,-1,1,1,1
निहार,5,6,1,1,1,0,1
बदल,1,6,-5,-1,-1,1,1
कह,2,4,2,1,1,0,1
दे,1,2,-1,-1,-1,1,1
रख,8,6,-2,-1,1,0,1
दिखा,9,5,-4,-1,1,0,1
निहार,5,7,2,1,1,0,1
रख,6,3,-3,-1,1,0,1
बिता,2,8,6,1,1,0,1
कर,2,2,0,0,-1,0,1
दबा,1,2,1,1,1,0,1
लगा,2,4,2,1,1,0,1
है,3,3,0,0,1,1,1
कर,3,2,1,1,-1,-1,1
बन,3,3,0,0,-1,0,1
रख,6,3,-3,-1,1,0,1
पा,9,6,-3,-1,1,0,1
देख,5,2,-3,-1,1,0,1
बाँट,1,2,-1,-1,-1,1,1
जुड़,6,4,-2,-1,1,0,1
फिल्‍मा,11,3,-8,-1,1,0,1
हरा,5,2,3,1,-1,0,1
उकेर,9,3,-6,-1,1,0,1
देख,2,11,-9,-1,-1,0,1
कर,5,3,2,1,-1,0,1
रह,2,4,-2,-1,-1,0,1
उबाल,3,3,0,0,1,0,1
कर,5,2,-3,-1,1,0,1
रख,2,2,0,0,1,1,1
बना,6,3,-3,-1,1,0,1
बन,10,4,6,1,-1,0,1
बना,5,3,-2,-1,1,0,1
बना,5,2,-3,-1,1,1,1
कर,1,2,-1,-1,-1,0,1
खोल,2,3,1,1,1,0,1
रोक,3,4,1,1,1,0,1
कर,1,2,1,1,1,0,1
दिखा,2,3,1,1,1,0,1
करा,2,2,0,0,1,0,1
ले,2,11,-9,-1,-1,0,1
रख,1,2,1,1,1,0,1
कर,1,5,4,1,1,0,1
करा,2,2,0,0,1,0,1
कर,4,2,-2,-1,1,0,1
कर,7,9,2,1,1,0,1
बना,2,4,2,1,1,0,1
दे,2,2,0,0,1,0,1
उतार,2,2,0,0,-1,0,1
कर,10,5,-5,-1,1,0,1
कर,10,3,-7,-1,1,0,1
कर,2,2,0,0,1,0,1
भेज,2,3,-1,-1,-1,0,1
रख,5,3,-2,-1,1,0,1
जा,7,2,5,1,-1,0,1
कर,2,2,0,0,1,0,1
बता,9,6,3,1,-1,0,1
दे,4,2,-2,-1,1,1,1
बना,1,2,1,1,1,0,1
रख,1,2,-1,-1,-1,1,1
देख,9,5,4,1,-1,0,1
खरीद,1,4,-3,-1,-1,1,1
बना,6,2,4,1,-1,0,1
कर,2,2,0,0,1,0,1
पहना,3,4,1,1,1,0,1
पहन,3,7,-4,-1,-1,0,1
देख,1,3,-2,-1,-1,1,1
सौंप,2,10,-8,-1,-1,0,1
बना,2,2,0,0,-1,0,1
ला,3,3,0,0,1,0,1
रोक,1,2,1,1,1,0,1
कर,7,2,-5,-1,1,0,1
लगा,2,4,2,1,1,0,1
मंगवा,3,2,-1,-1,1,0,1
लगा,3,2,-1,-1,1,0,1
कर,2,2,0,0,1,0,1
कर,2,4,2,1,1,0,1
पड,12,2,-10,-1,1,0,1
कर,6,6,0,0,1,0,1
ले,2,2,0,0,-1,0,1
कर,1,3,2,1,1,0,1
ले,3,2,1,1,-1,0,1
करा,2,6,-4,-1,-1,0,1
कर,9,2,7,1,-1,0,1
कर,7,2,5,1,-1,1,1
मार,2,3,1,1,1,0,1
मार,2,3,1,1,1,0,1
मार,3,5,2,1,1,0,1
मार,2,2,0,0,1,0,1
मार,3,3,0,0,1,0,1
मार,2,3,1,1,1,0,1
मार,2,5,3,1,1,0,1
मार,3,4,1,1,1,0,1
मार,3,4,1,1,1,0,1
मार,2,3,1,1,1,0,1
मार,3,4,1,1,1,0,1
मार,3,5,2,1,1,0,1
मार,4,2,-2,-1,1,0,1
मार,3,4,1,1,1,0,1
मार,3,5,2,1,1,0,1
मार,5,5,0,0,1,0,1
लड,1,7,6,1,1,0,1
बना,2,4,2,1,1,0,1
उखाड,3,2,-1,-1,1,0,1
कह,6,3,-3,-1,1,0,1
चला,3,5,2,1,1,0,1
कर,2,3,1,1,1,0,1
पहुंचा,2,3,-1,-1,-1,0,1
कर,7,4,-3,-1,1,0,1
बढा,4,4,0,0,1,0,1
कर,3,3,0,0,1,0,1
ले,4,2,-2,-1,1,1,1
कर,3,12,9,1,1,0,1
पहुंच,3,11,8,1,1,0,1
पहुंच,3,2,-1,-1,1,0,1
पहुंचा,2,2,0,0,1,0,1
बेच,1,2,1,1,1,0,1
मिल,12,2,10,1,-1,0,1
कर,4,2,2,1,-1,0,1
ले,2,2,0,0,-1,0,1
ले,7,2,5,1,-1,0,1
ले,5,3,2,1,-1,0,1
हटा,1,4,3,1,1,0,1
कर,2,2,0,0,-1,-1,1
मना,2,2,0,0,1,1,1
कर,2,14,12,1,1,0,1
कर,4,2,-2,-1,1,0,1
कर,1,3,2,1,1,0,1
छोड,1,2,-1,-1,-1,0,1
है,3,2,-1,-1,1,1,1
कर,2,2,0,0,1,0,1
परोस,1,4,3,1,1,0,1
कर,1,3,2,1,1,0,1
भुना,6,3,-3,-1,1,0,1
हटा,1,2,1,1,1,0,1
हटा,1,2,1,1,1,0,1
हटा,1,2,1,1,1,0,1
बढ,2,6,4,1,1,0,1
रख,6,2,4,1,-1,0,1
बढा,4,2,-2,-1,1,0,1
जोड,3,3,0,0,-1,0,1
कर,1,5,4,1,1,0,1
जोड,5,5,0,0,-1,0,1
हट,3,2,-1,-1,1,1,1
कर,1,4,3,1,1,0,1
चला,1,2,1,1,1,0,1
कर,4,2,-2,-1,1,1,1
कर,2,2,0,0,1,0,1
फेंक,2,2,0,0,1,1,1
कर,3,2,-1,-1,1,1,1
बना,4,2,-2,-1,1,0,1
ला,3,2,1,1,-1,0,1
आ,6,4,-2,-1,1,0,1
कर,13,3,10,1,-1,0,1
लगा,11,7,-4,-1,1,0,1
दे,1,5,4,1,1,0,1
कर,6,15,9,1,1,0,1
हो,7,3,-4,-1,1,0,1
उगल,1,3,2,1,1,0,1
कर,1,7,6,1,1,0,1
रख,15,4,11,1,-1,0,1
रख,3,4,-1,-1,-1,0,1
कर,2,3,1,1,1,0,1
कर,5,2,3,1,-1,-1,1
कर,2,9,7,1,1,0,1
दिखा,7,3,-4,-1,1,0,1
छोड,3,2,-1,-1,1,1,1
कर,6,5,-1,-1,1,0,1
संभाल,4,3,-1,-1,1,0,1
जता,1,6,5,1,1,0,1
ले,1,2,-1,-1,-1,1,1
बढा,1,3,2,1,1,0,1
जता,1,5,4,1,1,0,1
बह,14,2,-12,-1,1,0,1
आ,1,3,2,1,1,0,1
कर,12,2,-10,-1,1,0,1
चला,1,2,1,1,1,0,1
ले,2,3,-1,-1,-1,0,1
मार,3,23,20,1,1,0,1
कह,1,3,-2,-1,-1,1,1
कर,46,5,-41,-1,1,0,1
हो,2,5,3,1,1,0,1
दे,4,8,-4,-1,-1,0,1
देख,12,19,-7,-1,-1,0,1
गिर,4,3,-1,-1,1,0,1
कर,2,5,-3,-1,-1,0,1
कर,4,4,0,0,1,0,1
छीन,2,3,1,1,1,0,1
नहला,1,2,-1,-1,-1,1,1
कर,8,3,-5,-1,1,0,1
फँसा,1,2,-1,-1,-1,1,1
पहुंच,3,2,1,1,-1,0,1
चुन,4,3,1,1,-1,0,1
मांग,1,2,1,1,1,0,1
दे,2,3,1,1,1,0,1
हो,4,2,-2,-1,1,0,1
हो,13,6,7,1,-1,0,1
भेज,5,3,2,1,-1,0,1
ले,3,2,1,1,-1,0,1
दे,1,4,3,1,1,0,1
कर,4,3,-1,-1,1,0,1
कर,1,2,-1,-1,-1,1,1
कर,1,2,1,1,1,0,1
कर,2,3,1,1,1,0,1
कर,1,3,-2,-1,-1,0,1
संभाल,1,2,1,1,1,0,1
बढा,2,6,4,1,1,0,1
लगा,1,4,3,1,1,0,1
लगा,1,3,2,1,1,0,1
घटा,2,3,1,1,1,0,1
कर,1,14,13,1,1,1,1
झुठला,4,3,-1,-1,1,0,1
झुठला,4,3,-1,-1,1,0,1
कर,3,3,0,0,1,0,1
दिखा,3,3,0,0,1,0,1
हटा,2,2,0,0,1,0,1
हटा,1,2,1,1,1,0,1
हटा,1,2,1,1,1,0,1
रख,7,2,5,1,-1,0,1
पा,1,2,1,1,1,0,1
पा,6,2,-4,-1,1,0,1
कर,5,4,-1,-1,1,0,1
खरीद,2,5,3,1,1,0,1
कर,6,2,-4,-1,1,0,1
कर,1,3,2,1,1,0,1
दे,1,3,2,1,1,0,1
कर,3,5,-2,-1,-1,0,1
जोड,5,2,-3,-1,1,0,1
खुलवा,1,2,1,1,1,1,1
रख,6,2,4,1,-1,0,1
दे,2,5,3,1,1,0,1
निकाल,1,4,3,1,1,0,1
ले,2,4,2,1,1,0,1
कर,1,3,-2,-1,-1,1,1
भेज,2,3,-1,-1,-1,0,1
दे,7,4,-3,-1,1,0,1
बढा,1,2,1,1,1,0,1
कर,3,3,0,0,-1,0,1
रख,3,2,1,1,-1,0,1
चुरा,1,3,2,1,1,0,1
बता,3,6,3,1,1,0,1
चुरा,1,6,5,1,1,0,1
करा,3,5,-2,-1,-1,0,1
चुरा,1,3,2,1,1,0,1
भेज,1,3,2,1,1,0,1
कर,3,3,0,0,-1,0,1
फेंक,4,3,-1,-1,1,0,1
करा,2,6,-4,-1,-1,0,1
ले,1,3,2,1,1,0,1
भेज,3,4,1,1,1,0,1
खोल,6,3,-3,-1,1,0,1
उबार,3,2,1,1,-1,0,1
कर,8,6,2,1,-1,0,1
भेज,2,3,-1,-1,-1,0,1
दे,2,2,0,0,1,0,1
ले,5,2,3,1,-1,0,1
कर,1,3,2,1,1,0,1
फँसा,1,4,-3,-1,-1,1,1
छिपा,4,2,2,1,-1,0,1
कर,4,5,-1,-1,-1,0,1
ला,1,10,9,1,1,0,1
कर,3,3,0,0,1,0,1
बचा,1,2,-1,-1,-1,1,1
देख,2,5,-3,-1,-1,0,1
उठा,1,4,3,1,1,0,1
निबट,2,2,0,0,-1,0,1
लगा,1,2,1,1,1,0,1
लगा,2,2,0,0,1,0,1
रख,1,2,1,1,1,0,1
कर,6,3,3,1,-1,0,1
छोड,1,2,1,1,1,0,1
दे,1,2,1,1,1,0,1
कर,4,3,1,1,-1,0,1
कर,1,3,2,1,1,-1,1
पा,1,3,-2,-1,-1,1,1
कर,1,3,-2,-1,-1,1,1
जीत,2,2,0,0,-1,0,1
छोड,15,4,11,1,-1,0,1
कर,2,3,1,1,1,0,1
कर,1,2,-1,-1,-1,1,1
खेल,1,7,6,1,1,0,1
कर,5,2,-3,-1,1,0,1
कर,2,4,2,1,1,0,1
कर,4,3,1,1,-1,0,1
कर,2,3,1,1,1,0,1
तलाश,1,4,-3,-1,-1,1,1
ले,4,2,2,1,-1,0,1
ले,3,3,0,0,-1,0,1
ले,4,2,2,1,-1,0,1
पहुंच,3,2,-1,-1,1,1,1
कर,7,2,-5,-1,1,0,1
ले,1,2,1,1,1,1,1
डाल,4,2,2,1,-1,0,1
कर,2,3,1,1,1,0,1
बता,5,2,-3,-1,1,0,1
मिल,3,5,2,1,1,0,1
कर,4,4,0,0,-1,0,1
डाल,7,3,4,1,-1,0,1
बढा,1,7,6,1,1,0,1
कर,4,3,-1,-1,1,0,1
डाल,2,2,0,0,-1,0,1
डाल,2,2,0,0,1,0,1
ले,1,6,5,1,1,0,1
करा,1,5,4,1,1,0,1
कर,9,4,5,1,-1,0,1
कर,1,3,2,1,1,0,1
कर,1,8,7,1,1,0,1
पिरो,2,7,-5,-1,-1,0,1
मांग,2,3,1,1,1,0,1
दे,2,2,0,0,1,0,1
दे,6,2,-4,-1,1,0,1
हटा,1,2,1,1,1,0,1
ठहरा,3,8,-5,-1,-1,0,1
कर,2,5,3,1,1,0,1
छिपा,2,2,0,0,1,-1,1
दे,2,3,1,1,1,0,1
कर,2,3,-1,-1,-1,0,1
ले,3,2,1,1,-1,0,1
ले,6,2,4,1,-1,0,1
पहुँचा,10,2,8,1,-1,0,1
कर,3,2,-1,-1,1,0,1
पकड,2,2,0,0,-1,0,1
माप,2,3,1,1,1,0,1
आँक,10,3,7,1,-1,0,1
आँक,10,3,7,1,-1,0,1
दे,1,7,6,1,1,0,1
ले,2,3,1,1,1,0,1
ला,2,3,-1,-1,-1,0,1
ले,5,2,3,1,-1,0,1
ले,3,3,0,0,1,0,1
हटा,7,2,-5,-1,1,0,1
कर,3,3,0,0,1,0,1
रख,1,3,2,1,1,0,1
कर,2,3,-1,-1,-1,0,1
हटा,3,3,0,0,-1,0,1
कर,4,3,-1,-1,1,0,1
दे,2,3,-1,-1,-1,0,1
कर,2,2,0,0,1,1,1
निपट,2,2,0,0,-1,0,1
डाल,1,2,1,1,1,1,1
डाल,1,2,1,1,1,1,1
कर,1,3,2,1,1,0,1
देख,1,3,2,1,1,-1,1
चला,2,3,1,1,1,0,1
लगा,3,6,3,1,1,0,1
मिटा,1,2,1,1,1,0,1
कर,2,3,-1,-1,-1,0,1
पड,6,3,-3,-1,1,0,1
देख,2,3,-1,-1,-1,0,1
देख,3,3,0,0,-1,0,1
कर,4,2,2,1,-1,0,1
कर,6,2,-4,-1,1,0,1
पढ,3,3,0,0,1,0,1
ले,8,2,6,1,-1,0,1
बता,4,2,-2,-1,1,0,1
पा,3,2,-1,-1,1,0,1
उठा,1,2,1,1,1,0,1
जोड,1,2,1,1,1,0,1
सौंप,1,3,-2,-1,-1,0,1
मिल,4,3,-1,-1,1,0,1
कर,9,3,-6,-1,1,0,1
कर,1,3,-2,-1,-1,1,1
कर,3,3,0,0,1,0,1
कर,5,2,-3,-1,1,0,1
खोल,2,4,2,1,1,0,1
रख,2,7,-5,-1,-1,0,1
कर,2,2,0,0,1,0,1
छुडा,5,4,1,1,-1,0,1
बचा,1,2,-1,-1,-1,1,1
लिख,17,2,-15,-1,1,0,1
ले,1,2,1,1,1,0,1
दे,4,4,0,0,1,0,1
कर,1,2,1,1,1,0,1
कर,1,2,1,1,1,0,1
कर,1,2,1,1,1,0,1
खरीद,8,2,-6,-1,1,0,1
रखा,5,6,1,1,1,0,1
बना,6,6,0,0,-1,0,1
रख,5,2,3,1,-1,0,1
कर,1,4,-3,-1,-1,1,1
दिखा,2,2,0,0,1,1,1
दे,1,8,7,1,1,0,1
कर,1,3,2,1,1,0,1
दिखा,3,3,0,0,-1,0,1
कर,1,2,-1,-1,-1,1,1
खरीद,1,3,2,1,1,0,1
निकाल,6,4,-2,-1,1,0,1
कर,2,3,1,1,1,0,1
करा,1,2,1,1,1,0,1
बचा,2,3,-1,-1,-1,0,1
कर,4,8,-4,-1,-1,0,1
कर,2,17,15,1,1,0,1
करा,1,4,3,1,1,0,1
देख,2,2,0,0,-1,0,1
कर,1,3,2,1,1,0,1
कर,2,2,0,0,1,0,1
रोक,3,3,0,0,1,0,1
कर,1,5,-4,-1,-1,0,1
कर,4,2,-2,-1,1,0,1
कर,1,2,1,1,1,0,1
करा,2,4,-2,-1,-1,1,1
अपना,4,3,1,1,-1,0,1
सौंप,3,3,0,0,-1,0,1
दे,3,3,0,0,-1,0,1
जुटा,1,10,9,1,1,0,1
उठा,9,2,-7,-1,1,0,1
सौंप,3,3,0,0,-1,0,1
बन,1,5,4,1,1,0,1
खरीद,3,7,4,1,1,0,1
कह,6,2,4,1,-1,-1,1
कर,5,2,-3,-1,1,0,1
समझ,3,3,0,0,1,0,1
कर,1,5,4,1,1,-1,1
पा,1,3,2,1,1,0,1
था,1,4,3,1,1,0,1
निकाल,5,4,-1,-1,1,0,1
चल,4,2,-2,-1,1,0,1
भेज,2,2,0,0,-1,0,1
कर,2,3,1,1,1,0,1
भेज,2,3,1,1,1,0,1
फैल,1,3,2,1,1,0,1
कर,8,2,6,1,-1,0,1
देख,5,3,-2,-1,1,0,1
पहुंचा,2,2,0,0,-1,0,1
भेज,1,3,2,1,1,-1,1
कह,3,3,0,0,1,0,1
कर,1,21,20,1,1,0,1
कर,6,2,-4,-1,1,0,1
हो,8,17,9,1,1,0,1
बन,1,2,1,1,1,0,1
मार,2,3,1,1,1,0,1
आ,3,3,0,0,1,0,1
कर,3,3,0,0,-1,0,1
कर,1,2,1,1,1,0,1
तोड,1,2,1,1,1,0,1
जुट,4,4,0,0,1,0,1
तोड,2,2,0,0,1,1,1
करा,3,4,1,1,1,0,1
दबोच,1,5,-4,-1,-1,1,1
लगा,2,2,0,0,1,0,1
ले,2,4,2,1,1,0,1
बना,4,3,1,1,-1,0,1
हो,6,2,-4,-1,1,1,1
रोक,4,2,-2,-1,1,0,1
कर,1,3,2,1,1,0,1
हो,11,2,9,1,-1,0,1
बढ,4,3,1,1,-1,0,1
लग,6,2,-4,-1,1,1,1
कर,1,4,3,1,1,0,1
रह,1,6,5,1,1,0,1
चला,1,2,1,1,1,1,1
रख,1,2,-1,-1,-1,1,1
कर,3,3,0,0,-1,0,1
ले,3,3,0,0,-1,0,1
कर,1,2,1,1,1,0,1
रख,7,2,5,1,-1,1,1
देख,2,3,1,1,1,0,1
निकाल,1,2,-1,-1,-1,0,1
बता,4,3,-1,-1,1,0,1
गिरा,2,2,0,0,1,0,1
कर,5,2,-3,-1,1,0,1
कर,1,3,2,1,1,0,1
कर,1,3,2,1,1,-1,1
कर,2,3,1,1,1,0,1
हो,3,2,-1,-1,1,1,1
दे,6,6,0,0,1,0,1
रह,1,2,1,1,1,1,1
मांग,5,5,0,0,1,0,1
लगा,1,5,4,1,1,0,1
करा,1,7,6,1,1,0,1
दे,1,3,2,1,1,0,1
ले,3,2,1,1,-1,-1,1
कर,2,3,1,1,1,0,1
ले,2,3,-1,-1,-1,0,1
था,1,6,5,1,1,0,1
कर,15,3,12,1,-1,0,1
कर,2,3,1,1,1,0,1
बना,3,5,2,1,1,0,1
लगा,4,2,2,1,-1,0,1
चढा,1,2,1,1,1,0,1
झुक,2,4,2,1,1,0,1
हो,7,2,5,1,-1,-1,1
डाल,9,2,7,1,-1,0,1
कर,2,6,4,1,1,0,1
रख,1,3,-2,-1,-1,0,1
कर,1,9,8,1,1,0,1
दे,2,2,0,0,1,0,1
बेच,4,3,1,1,-1,0,1
जुटा,3,2,-1,-1,1,0,1
बेच,4,4,0,0,1,0,1
कर,3,5,2,1,1,0,1
आ,4,3,-1,-1,1,0,1
सुना,3,4,1,1,1,0,1
बन,2,2,0,0,1,1,1
कर,4,2,-2,-1,1,0,1
कर,5,3,2,1,-1,0,1
कर,1,4,3,1,1,0,1
लगा,1,3,2,1,1,0,1
निहार,5,3,-2,-1,1,0,1
रख,4,2,2,1,-1,0,1
कर,3,8,5,1,1,0,1
हो,4,4,0,0,1,0,1
हो,3,5,2,1,1,0,1
दिखा,1,4,3,1,1,0,1
दिखा,3,2,1,1,-1,0,1
दिखा,1,3,-2,-1,-1,1,1
कर,2,3,-1,-1,-1,0,1
कर,1,3,2,1,1,0,1
हो,1,2,-1,-1,-1,0,1
रह,10,2,8,1,-1,-1,1
सुधर,4,4,0,0,1,0,1
पहन,1,2,1,1,1,0,1
पहन,1,6,5,1,1,0,1
बना,2,3,1,1,1,0,1
पा,2,3,1,1,1,0,1
रख,1,3,2,1,1,0,1
कर,1,2,1,1,1,1,1
बेच,1,3,2,1,1,0,1
मार,3,2,-1,-1,1,0,1
दे,8,3,-5,-1,1,0,1
कर,1,2,-1,-1,-1,1,1
बना,2,2,0,0,1,1,1
बना,3,2,-1,-1,1,0,1
घेर,2,2,0,0,-1,0,1
रख,2,2,0,0,-1,0,1
मार,2,2,0,0,1,0,1
बैठ,2,3,-1,-1,-1,1,1
रख,2,2,0,0,-1,0,1
पहुंचा,8,3,5,1,-1,0,1
बना,3,2,1,1,-1,0,1
रह,7,2,-5,-1,1,0,1
लगा,2,5,3,1,1,0,1
रखवा,1,6,5,1,1,0,1
मिल,4,2,-2,-1,1,0,1
कर,13,2,-11,-1,1,0,1
कर,1,2,1,1,1,-1,1
रख,2,5,-3,-1,-1,0,1
चुन,3,4,-1,-1,-1,0,1
कर,4,2,-2,-1,1,0,1
दे,3,6,3,1,1,0,1
कर,1,2,1,1,1,0,1
मार,13,3,-10,-1,1,0,1
भेज,2,2,0,0,1,0,1
भेज,2,2,0,0,1,0,1
भेज,2,2,0,0,1,0,1
मान,7,2,-5,-1,1,0,1
कर,2,4,2,1,1,0,1
रुक,3,4,-1,-1,-1,0,1
जता,4,2,-2,-1,1,0,1
खरीद,4,2,-2,-1,1,0,1
रख,2,7,5,1,1,0,1
कर,1,4,3,1,1,0,1
कर,1,5,4,1,1,0,1
रख,3,2,1,1,-1,0,1
मार,2,2,0,0,1,0,1
मार,6,3,-3,-1,1,0,1
कर,2,2,0,0,1,1,1
नकार,1,2,-1,-1,-1,1,1
कर,1,3,2,1,1,-1,1
लगा,3,3,0,0,-1,0,1
कह,14,3,-11,-1,1,0,1
बेच,4,2,2,1,-1,0,1
कर,2,4,2,1,1,0,1
कर,2,3,1,1,1,0,1
रख,2,4,2,1,1,0,1
निकाल,4,2,-2,-1,1,0,1
कह,2,2,0,0,1,0,1
दफना,2,4,2,1,1,0,1
दफना,2,5,3,1,1,0,1
कर,3,9,-6,-1,-1,0,1
जीत,8,3,5,1,-1,0,1
बना,2,8,6,1,1,0,1
लपक,2,7,5,1,1,0,1
कर,2,3,1,1,1,0,1
लगा,2,5,3,1,1,0,1
बटोर,2,8,6,1,1,0,1
दे,3,2,-1,-1,1,0,1
ले,6,2,4,1,-1,-1,1
कर,6,2,-4,-1,1,0,1
मांग,3,2,-1,-1,1,0,1
रख,3,2,1,1,-1,0,1
रख,2,3,1,1,1,0,1
मिटा,1,2,1,1,1,0,1
कर,2,7,5,1,1,0,1
गा,1,5,4,1,1,0,1
रख,2,4,2,1,1,0,1
करा,4,2,-2,-1,1,0,1
है,4,2,-2,-1,1,1,1
दे,8,3,-5,-1,1,0,1
कर,7,2,-5,-1,1,1,1
दे,1,5,4,1,1,0,1
दे,1,2,1,1,1,0,1
लगा,3,4,1,1,1,0,1
बना,3,8,5,1,1,0,1
दे,7,2,-5,-1,1,1,1
हटा,1,7,6,1,1,0,1
दे,21,11,-10,-1,1,0,1
कर,1,6,5,1,1,0,1
बना,4,3,-1,-1,1,0,1
दे,5,3,-2,-1,1,0,1
कर,1,4,3,1,1,-1,1
पहुँचा,1,4,3,1,1,0,1
पहुँचा,1,3,2,1,1,0,1
कर,5,2,-3,-1,1,1,1
लगा,3,4,-1,-1,-1,0,1
सौंप,1,6,-5,-1,-1,1,1
कर,1,3,-2,-1,-1,1,1
कर,5,2,-3,-1,1,1,1
कर,4,3,-1,-1,1,0,1
दिला,1,2,1,1,1,0,1
कर,2,3,1,1,1,0,1
ला,1,2,1,1,1,0,1
करा,3,2,-1,-1,1,1,1
बेच,6,4,2,1,-1,0,1
बेच,5,4,-1,-1,1,0,1
बढा,4,3,1,1,-1,0,1
कर,3,8,5,1,1,0,1
दे,1,2,1,1,1,0,1
कर,1,6,5,1,1,-1,1
लग,1,4,3,1,1,0,1
खर्च,2,8,6,1,1,0,1
कर,21,2,19,1,-1,0,1
कर,8,4,-4,-1,1,0,1
कर,3,3,0,0,-1,0,1
कह,31,2,-29,-1,1,0,1
कर,5,2,-3,-1,1,0,1
खोल,2,2,0,0,1,0,1
हो,2,2,0,0,1,1,1
अपना,3,3,0,0,-1,0,1
टाल,2,3,1,1,1,0,1
कर,1,7,6,1,1,0,1
कर,1,5,4,1,1,0,1
कर,1,4,3,1,1,0,1
ला,9,4,5,1,-1,0,1
कर,4,2,2,1,-1,0,1
कर,5,2,-3,-1,1,0,1
दे,2,2,0,0,1,0,1
कर,5,3,-2,-1,1,0,1
हटा,3,3,0,0,-1,0,1
कर,2,5,3,1,1,0,1
कर,4,4,0,0,1,0,1
कर,1,3,2,1,1,0,1
हो,6,3,3,1,-1,0,1
बदल,6,3,-3,-1,1,1,1
ले,3,2,-1,-1,1,0,1
चाह,4,6,2,1,1,0,1
भगा,2,3,1,1,1,0,1
बैठा,1,2,1,1,1,0,1
ले,2,2,0,0,1,0,1
देख,3,2,-1,-1,1,1,1
आ,6,3,-3,-1,1,0,1
कर,3,2,-1,-1,1,1,1
बुला,5,3,-2,-1,1,0,1
मिल,2,3,1,1,1,0,1
कर,3,2,-1,-1,1,1,1
बना,3,3,0,0,1,0,1
देख,1,5,4,1,1,0,1
कर,1,5,4,1,1,0,1
निभ,4,3,-1,-1,1,0,1
काट,1,16,-15,-1,-1,0,1
अपना,3,14,11,1,1,0,1
निभा,2,4,2,1,1,0,1
छोड,2,5,-3,-1,-1,0,1
दे,2,2,0,0,-1,0,1
लग,2,2,0,0,1,0,1
कर,1,2,1,1,1,-1,1
ला,2,2,0,0,-1,0,1
करा,1,2,-1,-1,-1,0,1
बना,3,2,-1,-1,1,1,1
है,1,3,2,1,1,0,1
करा,4,3,-1,-1,1,0,1
चला,1,3,2,1,1,0,1
दे,3,5,2,1,1,0,1
भेज,2,2,0,0,1,1,1
हरा,2,4,2,1,1,0,1
है,7,2,-5,-1,1,1,1
है,3,2,-1,-1,1,0,1
ले,5,7,-2,-1,-1,0,1
आ,9,2,-7,-1,1,0,1
कर,1,4,3,1,1,0,1
पिला,4,3,-1,-1,1,0,1
कर,1,3,2,1,1,0,1
रख,1,2,-1,-1,-1,1,1
कर,1,4,3,1,1,0,1
कर,2,9,-7,-1,-1,0,1
छोड़,3,2,-1,-1,1,0,1
दे,3,7,4,1,1,0,1
बना,1,4,3,1,1,0,1
कर,10,10,0,0,1,0,1
झेल,2,3,1,1,1,0,1
हटा,1,10,9,1,1,-1,1
लगा,1,7,6,1,1,0,1
दे,1,2,1,1,1,1,1
ला,5,4,1,1,-1,0,1
कर,15,4,11,1,-1,0,1
कर,2,3,1,1,1,0,1
बढ़ा,5,8,3,1,1,0,1
बढ़ा,2,3,1,1,1,0,1
मान,5,5,0,0,1,0,1
हटा,2,2,0,0,-1,0,1
निकाल,1,2,1,1,1,0,1
रख,6,2,4,1,-1,0,1
थाम,3,2,-1,-1,1,0,1
छोड़,1,2,1,1,1,-1,1
जगा,3,2,-1,-1,1,1,1
देख,4,2,-2,-1,1,0,1
देख,3,2,-1,-1,1,0,1
देख,3,3,0,0,1,0,1
कर,5,5,0,0,1,0,1
सुन,6,2,4,1,-1,0,1
बुला,2,2,0,0,1,0,1
चाहिए,29,2,-27,-1,1,1,1
खा,5,3,2,1,-1,0,1
दे,6,2,-4,-1,1,0,1
आ,3,3,0,0,-1,0,1
कर,3,8,5,1,1,0,1
कर,3,3,0,0,-1,0,1
कर,7,3,-4,-1,1,0,1
कर,2,2,0,0,1,0,1
बुला,1,2,1,1,1,1,1
बना,2,9,7,1,1,0,1
ले,1,2,1,1,1,-1,1
निकल,4,3,-1,-1,1,0,1
निभा,2,3,1,1,1,0,1
बना,3,3,0,0,1,0,1
रोक,6,2,4,1,-1,0,1
जा,2,4,-2,-1,-1,0,1
गँवा,2,3,1,1,1,-1,1
कर,1,3,2,1,1,0,1
खोज,3,4,1,1,1,0,1
दे,5,4,-1,-1,1,0,1
ले,1,2,1,1,1,0,1
बसा,3,2,1,1,-1,0,1
कर,25,4,-21,-1,1,0,1
कर,4,2,-2,-1,1,0,1
रख,5,2,3,1,-1,0,1
कर,12,3,-9,-1,1,0,1
कर,1,4,3,1,1,0,1
सुलझा,3,2,-1,-1,1,0,1
रख,7,2,5,1,-1,0,1
कर,3,3,0,0,1,0,1
बना,2,4,2,1,1,0,1
कर,1,2,1,1,1,0,1
कर,1,3,2,1,1,0,1
कर,1,3,2,1,1,0,1
जता,1,3,2,1,1,0,1
बिछा,2,5,3,1,1,0,1
दे,2,2,0,0,-1,0,1
देख,9,3,-6,-1,1,0,1
बदल,4,4,0,0,-1,0,1
लगा,8,3,-5,-1,1,0,1
मार,2,5,3,1,1,0,1
आ,1,2,1,1,1,0,1
पहुंचा,2,8,-6,-1,-1,0,1
कर,1,7,6,1,1,0,1
कर,2,2,0,0,1,0,1
लड़,1,2,1,1,1,1,1
कर,1,2,1,1,1,0,1
कर,1,5,4,1,1,0,1
कर,5,2,3,1,-1,0,1
बना,3,11,8,1,1,0,1
बना,3,2,-1,-1,1,0,1
चाह,17,2,-15,-1,1,0,1
कर,1,2,1,1,1,0,1
कर,1,3,-2,-1,-1,1,1
कर,5,3,2,1,-1,0,1
देख,9,3,6,1,-1,0,1
बना,5,2,-3,-1,1,1,1
कर,2,4,2,1,1,0,1
ले,3,2,1,1,-1,-1,1
बना,2,2,0,0,1,0,1
बढ़ा,7,4,-3,-1,1,0,1
कर,5,2,-3,-1,1,0,1
बढ़ा,5,2,-3,-1,1,0,1
ले,1,3,2,1,1,0,1
कर,3,2,-1,-1,1,0,1
रख,13,2,11,1,-1,0,1
कर,1,2,-1,-1,-1,1,1
कर,9,3,-6,-1,1,0,1
कर,5,3,2,1,-1,0,1
लगा,1,7,6,1,1,0,1
घुस,8,2,6,1,-1,0,1
खदेड,3,3,0,0,1,0,1
कर,1,2,1,1,1,0,1
कर,3,2,1,1,-1,0,1
कर,2,2,0,0,1,0,1
लगा,1,3,2,1,1,0,1
कर,4,2,2,1,-1,0,1
कर,3,2,1,1,-1,0,1
चाह,7,2,-5,-1,1,1,1
ला,1,4,-3,-1,-1,1,1
ला,4,4,0,0,-1,0,1
लगा,1,5,4,1,1,0,1
जा,3,3,0,0,-1,0,1
लगा,1,8,7,1,1,0,1
लगा,2,4,2,1,1,0,1
कर,31,3,-28,-1,1,0,1
बदल,4,3,1,1,-1,0,1
ले,1,2,1,1,1,0,1
कर,3,4,1,1,1,0,1
ले,3,2,-1,-1,1,0,1
कर,1,2,1,1,1,-1,1
ले,1,16,15,1,1,0,1
जुटा,6,2,-4,-1,1,0,1
बना,2,3,1,1,1,0,1
कर,2,4,-2,-1,-1,0,1
कर,1,3,2,1,1,0,1
कर,2,12,10,1,1,0,1
अपना,2,2,0,0,1,1,1
अपना,2,3,1,1,1,0,1
कर,4,2,2,1,-1,0,1
कर,11,2,-9,-1,1,0,1
करा,3,3,0,0,-1,0,1
कर,2,3,1,1,1,0,1
लगा,1,2,1,1,1,0,1
मार,4,2,2,1,-1,0,1
पहुंचा,1,5,4,1,1,0,1
बना,2,2,0,0,1,0,1
ले,3,2,1,1,-1,-1,1
कह,1,3,2,1,1,-1,1
दे,16,5,-11,-1,1,0,1
रख,5,3,2,1,-1,0,1
बना,1,2,1,1,1,0,1
बढ़ा,3,3,0,0,1,0,1
दे,2,10,8,1,1,0,1
रख,2,3,1,1,1,0,1
कर,1,10,9,1,1,0,1
कर,3,7,4,1,1,0,1
चुन,3,3,0,0,1,1,1
है,2,2,0,0,1,0,1
देख,1,2,1,1,1,0,1
डाल,2,2,0,0,1,0,1
रख,5,2,-3,-1,1,0,1
बता,2,4,-2,-1,-1,0,1
बढ़ा,1,5,4,1,1,0,1
ले,2,14,12,1,1,0,1
कर,3,3,0,0,-1,0,1
बना,3,3,0,0,1,0,1
कर,2,4,-2,-1,-1,0,1
करा,1,3,2,1,1,0,1
खोल,2,4,2,1,1,0,1
जीत,2,4,-2,-1,-1,0,1
कर,3,6,3,1,1,0,1
कर,1,3,-2,-1,-1,0,1
कर,1,2,1,1,1,0,1
ले,1,9,8,1,1,0,1
ले,5,4,-1,-1,1,0,1
बता,7,3,-4,-1,1,0,1
बता,2,5,3,1,1,0,1
है,1,3,2,1,1,0,1
बता,12,2,-10,-1,1,-1,1
कर,5,6,1,1,1,0,1
पहुंचा,8,2,-6,-1,1,1,1
कर,1,3,2,1,1,0,1
हो,4,3,-1,-1,1,1,1
ले,4,2,2,1,-1,0,1
ले,3,2,1,1,-1,0,1
कर,1,2,-1,-1,-1,1,1
मिल,12,3,-9,-1,1,0,1
दे,2,5,3,1,1,0,1
बन,1,2,-1,-1,-1,1,1
कह,1,5,-4,-1,-1,1,1
कर,2,2,0,0,1,0,1
रह,2,2,0,0,1,0,1
ले,2,2,0,0,1,1,1
लगा,3,4,-1,-1,-1,0,1
भर,4,3,1,1,-1,0,1
सौंप,8,9,-1,-1,-1,0,1
कर,8,5,-3,-1,1,0,1
कर,2,2,0,0,1,0,1
ले,3,2,-1,-1,1,1,1
कर,6,7,1,1,1,0,1
मना,2,2,0,0,1,0,1
कर,7,2,5,1,-1,0,1
ठहरा,2,2,0,0,1,1,1
कर,7,2,-5,-1,1,0,1
दे,1,11,10,1,1,0,1
दे,2,13,11,1,1,0,1
कर,6,3,-3,-1,1,0,1
कह,2,2,0,0,1,0,1
कर,3,2,-1,-1,1,0,1
कर,4,3,-1,-1,1,0,1
घट,7,4,3,1,-1,0,1
कर,3,2,-1,-1,1,0,1
छोड़,5,2,3,1,-1,0,1
बना,2,2,0,0,1,1,1
कर,1,3,2,1,1,0,1
खरीद,3,3,0,0,1,0,1
कर,1,2,1,1,1,0,1
कर,7,2,-5,-1,1,0,1
भेज,2,4,-2,-1,-1,0,1
कर,1,6,5,1,1,0,1
बुला,2,2,0,0,-1,-1,1
पहन,3,2,-1,-1,1,0,1
कर,1,3,2,1,1,0,1
बना,3,3,0,0,1,0,1
कर,3,3,0,0,-1,0,1
कर,3,3,0,0,-1,0,1
देख,3,2,1,1,-1,-1,1
सुना,2,5,-3,-1,-1,0,1
बता,3,4,-1,-1,-1,0,1
था,3,5,2,1,1,0,1
दे,2,2,0,0,1,0,1
बना,1,4,-3,-1,-1,1,1
बना,4,3,-1,-1,1,0,1
बना,1,2,1,1,1,0,1
कर,1,6,5,1,1,0,1
निपट,2,2,0,0,-1,0,1
कर,2,5,3,1,1,0,1
कर,1,7,6,1,1,0,1
ले,1,3,-2,-1,-1,1,1
कर,2,13,-11,-1,-1,0,1
रोक,2,6,-4,-1,-1,0,1
कर,1,4,3,1,1,-1,1
ले,1,2,1,1,1,1,1
सिखा,3,3,0,0,1,0,1
दे,4,4,0,0,1,0,1
हो,5,9,4,1,1,0,1
कर,3,3,0,0,-1,0,1
ला,10,2,8,1,-1,0,1
हटा,3,3,0,0,-1,0,1
कर,1,19,18,1,1,-1,1
निपट,3,2,1,1,-1,0,1
बुला,10,3,-7,-1,1,0,1
ले,3,2,1,1,-1,0,1
करा,1,4,-3,-1,-1,1,1
कर,1,8,7,1,1,0,1
कर,2,2,0,0,1,0,1
दे,5,3,-2,-1,1,0,1
जा,3,3,0,0,1,0,1
कर,2,2,0,0,1,0,1
कर,2,4,2,1,1,0,1
कर,1,5,4,1,1,0,1
हो,7,5,2,1,-1,0,0
लगा,3,3,0,0,1,0,0
रख,2,2,0,0,1,0,0
कर,1,6,-5,-1,-1,0,0
बच,2,2,0,0,1,0,0
हटा,4,3,1,1,-1,0,0
हटा,1,2,1,1,1,-1,0
कर,1,3,-2,-1,-1,0,0
कर,1,3,-2,-1,-1,0,0
दे,2,3,-1,-1,-1,0,0
जता,2,3,-1,-1,-1,0,0
कर,1,2,-1,-1,-1,-1,0
पहुंचा,3,4,-1,-1,-1,0,0
कर,1,4,-3,-1,-1,0,0
हटा,2,3,-1,-1,-1,0,0
कर,10,2,8,1,-1,0,0
हटा,2,8,-6,-1,-1,0,0
रख,2,3,-1,-1,-1,0,0
लगा,1,14,-13,-1,-1,0,0
कर,11,2,9,1,-1,-1,0
कर,3,3,0,0,-1,0,0
कर,1,2,-1,-1,-1,0,0
उड़ा,3,2,-1,-1,1,0,0
ले,1,2,-1,-1,-1,0,0
दे,4,3,1,1,-1,0,0
बदल,4,3,-1,-1,1,0,0
बता,6,2,4,1,-1,-1,0
घसीट,12,2,-10,-1,1,-1,0
ले,4,3,-1,-1,1,0,0
हटा,2,2,0,0,1,0,0
कर,1,5,-4,-1,-1,0,0
कह,6,4,2,1,-1,0,0
दे,2,7,-5,-1,-1,0,0
रख,5,2,3,1,-1,0,0
पूछ,2,5,-3,-1,-1,1,0
पूछ,1,2,-1,-1,-1,0,0
ठहरा,2,5,-3,-1,-1,1,0
रख,3,5,-2,-1,-1,0,0
कर,20,3,17,1,-1,0,0
कर,4,2,2,1,-1,-1,0
रख,4,2,-2,-1,1,0,0
लगा,2,4,-2,-1,-1,0,0
कर,2,3,-1,-1,-1,0,0
लगा,2,5,-3,-1,-1,0,0
बढ़ा,3,2,1,1,-1,0,0
कर,15,2,13,1,-1,0,0
कर,2,4,-2,-1,-1,0,0
मना,1,3,2,1,1,-1,0
अपना,3,3,0,0,-1,0,0
बढ़ा,1,3,-2,-1,-1,0,0
बना,7,2,5,1,-1,0,0
दे,2,2,0,0,1,0,0
कर,1,2,1,1,1,-1,0
कर,1,5,-4,-1,-1,0,0
कह,1,2,-1,-1,-1,0,0
कर,3,2,1,1,-1,0,0
है,1,5,-4,-1,-1,0,0
जोड़,3,11,-8,-1,-1,0,0
कर,1,4,-3,-1,-1,1,0
कर,2,3,1,1,1,0,0
चला,5,3,-2,-1,1,0,0
बुला,2,2,0,0,-1,0,0
चला,3,3,0,0,-1,0,0
चला,2,3,1,1,1,0,0
कर,3,9,6,1,1,0,0
चाह,1,3,-2,-1,-1,0,0
कर,2,2,0,0,-1,-1,0
उठा,3,3,0,0,1,0,0
उठा,4,2,2,1,-1,0,0
कर,1,4,-3,-1,-1,0,0
दे,1,2,1,1,1,0,0
उठा,4,3,1,1,-1,0,0
पहुंचा,3,2,-1,-1,1,0,0
लगा,2,3,-1,-1,-1,0,0
लगा,1,2,-1,-1,-1,0,0
लग,1,2,-1,-1,-1,0,0
चुरा,4,2,2,1,-1,0,0
करा,1,3,-2,-1,-1,0,0
ला,2,4,2,1,1,0,0
आ,2,3,-1,-1,-1,0,0
रोक,4,2,2,1,-1,0,0
भेज,3,8,5,1,1,0,0
सुना,1,5,4,1,1,-1,0
लग,4,2,2,1,-1,0,0
ठहरा,4,3,1,1,-1,0,0
मांग,2,3,-1,-1,-1,0,0
बना,3,2,1,1,-1,0,0
कर,15,4,11,1,-1,0,0
रख,4,2,-2,-1,1,0,0
घेर,3,5,-2,-1,-1,0,0
लगा,3,2,1,1,-1,-1,0
रख,4,2,-2,-1,1,0,0
दे,6,3,3,1,-1,0,0
हो,17,2,-15,-1,1,-1,0
कर,2,2,0,0,-1,0,0
कर,2,3,-1,-1,-1,0,0
उमड,1,4,-3,-1,-1,0,0
बना,4,3,1,1,-1,0,0
बना,3,4,-1,-1,-1,0,0
कर,5,3,2,1,-1,0,0
कर,2,23,-21,-1,-1,0,0
मिटा,1,5,-4,-1,-1,0,0
ले,1,2,1,1,1,-1,0
कर,8,3,5,1,-1,0,0
चाह,2,5,-3,-1,-1,0,0
कर,4,2,2,1,-1,0,0
कर,3,2,1,1,-1,-1,0
है,4,3,1,1,-1,0,0
ला,1,5,-4,-1,-1,0,0
कह,2,4,-2,-1,-1,0,0
रह,4,2,2,1,-1,0,0
लग,8,6,2,1,-1,0,0
दिखा,3,2,1,1,-1,0,0
लगा,2,7,-5,-1,-1,0,0
कर,1,5,-4,-1,-1,0,0
टाल,1,3,-2,-1,-1,0,0
कर,4,2,2,1,-1,0,0
रख,2,17,-15,-1,-1,0,0
लगा,5,5,0,0,1,0,0
पा,1,11,-10,-1,-1,1,0
बना,1,7,-6,-1,-1,0,0
कर,2,2,0,0,1,0,0
बदल,4,4,0,0,1,0,0
बता,2,2,0,0,-1,-1,0
करा,2,3,-1,-1,-1,0,0
मिल,2,8,-6,-1,-1,0,0
आ,3,4,-1,-1,-1,0,0
दे,1,2,-1,-1,-1,0,0
दे,1,2,-1,-1,-1,0,0
कर,10,5,-5,-1,1,0,0
कर,4,5,1,1,1,0,0
बना,5,8,-3,-1,-1,0,0
दे,2,4,-2,-1,-1,0,0
उतार,6,2,-4,-1,1,0,0
कह,2,3,-1,-1,-1,1,0
बोल,1,3,-2,-1,-1,1,0
कर,1,3,-2,-1,-1,0,0
कर,3,3,0,0,1,0,0
पिला,4,6,-2,-1,-1,0,0
जोड़,7,3,-4,-1,1,0,0
दे,2,2,0,0,1,0,0
कर,2,6,4,1,1,0,0
चेता,15,2,13,1,-1,0,0
कर,5,2,-3,-1,1,0,0
कर,3,6,-3,-1,-1,0,0
कर,1,4,-3,-1,-1,0,0
हटा,3,5,-2,-1,-1,0,0
रख,2,9,-7,-1,-1,0,0
कर,1,3,-2,-1,-1,0,0
रख,1,3,-2,-1,-1,0,0
छीन,2,2,0,0,1,0,0
रह,3,3,0,0,-1,0,0
रख,2,8,-6,-1,-1,0,0
पा,5,15,-10,-1,-1,0,0
कर,1,3,-2,-1,-1,0,0
चला,1,3,-2,-1,-1,0,0
दे,1,3,-2,-1,-1,0,0
देख,5,3,-2,-1,1,0,0
कर,4,3,1,1,-1,0,0
ले,2,2,0,0,-1,0,0
ले,2,2,0,0,-1,-1,0
कर,3,6,-3,-1,-1,0,0
बुला,1,2,1,1,1,0,0
खटखटा,4,3,1,1,-1,0,0
बना,6,5,1,1,-1,0,0
बढ़,2,2,0,0,-1,0,0
भर,3,3,0,0,-1,0,0
कर,4,5,1,1,1,0,0
कर,4,2,2,1,-1,0,0
बढ़ा,2,2,0,0,1,0,0
कर,11,3,-8,-1,1,0,0
कर,1,3,-2,-1,-1,1,0
बना,4,3,-1,-1,1,0,0
कर,5,3,-2,-1,1,0,0
दे,5,2,3,1,-1,-1,0
कर,2,4,-2,-1,-1,0,0
कर,1,4,-3,-1,-1,0,0
सौंप,3,4,-1,-1,-1,0,0
कर,1,5,4,1,1,-1,0
कर,2,5,-3,-1,-1,0,0
बैठा,3,4,-1,-1,-1,0,0
कर,3,3,0,0,1,0,0
पढ़ा,7,5,2,1,-1,0,0
ले,9,3,-6,-1,1,0,0
खरीद,1,4,-3,-1,-1,0,0
कह,2,9,-7,-1,-1,0,0
कर,4,2,2,1,-1,0,0
कर,1,3,-2,-1,-1,0,0
बना,2,4,-2,-1,-1,0,0
कर,2,3,1,1,1,0,0
ले,4,6,-2,-1,-1,0,0
ले,5,2,-3,-1,1,0,0
मान,13,4,-9,-1,1,0,0
कर,9,2,7,1,-1,-1,0
बढ़ा,12,2,10,1,-1,-1,0
ले,1,5,-4,-1,-1,0,0
ले,1,2,-1,-1,-1,0,0
ले,1,2,-1,-1,-1,0,0
ला,1,3,-2,-1,-1,0,0
कर,2,4,-2,-1,-1,0,0
छोड़,1,11,-10,-1,-1,0,0
कर,2,6,-4,-1,-1,0,0
कर,5,2,3,1,-1,0,0
कर,4,2,2,1,-1,0,0
भुला,5,2,3,1,-1,0,0
जूझ,5,2,3,1,-1,0,0
ले,3,4,1,1,1,0,0
कर,2,18,16,1,1,0,0
कर,2,2,0,0,1,0,0
चाह,2,2,0,0,-1,0,0
बता,1,3,2,1,1,-1,0
जीत,2,3,-1,-1,-1,0,0
कर,1,5,-4,-1,-1,0,0
पहुंचा,2,2,0,0,1,0,0
ले,1,3,-2,-1,-1,0,0
करा,3,3,0,0,1,0,0
बांट,1,2,-1,-1,-1,-1,0
करा,9,3,-6,-1,1,0,0
कर,5,2,3,1,-1,-1,0
दे,2,2,0,0,1,0,0
हो,1,2,-1,-1,-1,0,0
रख,4,2,-2,-1,1,0,0
दबा,1,3,-2,-1,-1,1,0
कर,1,2,-1,-1,-1,0,0
रख,1,2,1,1,1,-1,0
रख,2,3,1,1,1,0,0
कर,4,6,-2,-1,-1,0,0
दिला,2,3,-1,-1,-1,0,0
करा,2,3,1,1,1,0,0
देख,9,12,-3,-1,-1,0,0
चल,2,3,-1,-1,-1,0,0
दे,3,2,1,1,-1,-1,0
कर,2,7,-5,-1,-1,1,0
कर,5,2,3,1,-1,0,0
मार,1,2,-1,-1,-1,0,0
फेंक,2,2,0,0,-1,0,0
फूट,1,7,-6,-1,-1,0,0
दे,4,3,-1,-1,1,0,0
कर,5,3,-2,-1,1,0,0
कर,5,2,-3,-1,1,0,0
निपटा,2,2,0,0,1,0,0
कर,1,4,-3,-1,-1,0,0
निकाल,9,2,-7,-1,1,0,0
मिल,1,2,-1,-1,-1,0,0
कर,2,2,0,0,1,0,0
दे,1,2,-1,-1,-1,0,0
है,1,3,-2,-1,-1,0,0
निकाल,1,2,-1,-1,-1,0,0
कर,1,2,-1,-1,-1,0,0
कर,2,3,-1,-1,-1,0,0
मांग,1,5,-4,-1,-1,0,0
रोक,2,2,0,0,-1,0,0
बढ़ा,1,6,-5,-1,-1,0,0
कर,1,3,-2,-1,-1,0,0
पहुंच,3,3,0,0,-1,0,0
बुला,7,3,-4,-1,1,0,0
कर,12,6,-6,-1,1,0,0
हटा,2,3,1,1,1,0,0
खोल,1,2,-1,-1,-1,0,0
पहुंच,3,11,-8,-1,-1,0,0
दे,1,3,2,1,1,-1,0
कर,1,5,-4,-1,-1,0,0
रिस,1,3,-2,-1,-1,0,0
देख,2,4,-2,-1,-1,0,0
बरत,1,3,-2,-1,-1,0,0
करा,4,3,-1,-1,1,0,0
रख,8,3,-5,-1,1,0,0
कर,3,3,0,0,-1,0,0
कर,3,4,-1,-1,-1,0,0
कर,3,10,-7,-1,-1,0,0
दे,1,4,-3,-1,-1,0,0
कर,1,3,-2,-1,-1,0,0
करा,11,5,6,1,-1,0,0
पकड,4,3,1,1,-1,0,0
रख,7,2,-5,-1,1,0,0
दे,2,3,1,1,1,0,0
कर,2,13,-11,-1,-1,0,0
बना,1,2,-1,-1,-1,0,0
पहुंचा,1,6,-5,-1,-1,0,0
कर,3,3,0,0,-1,0,0
ले,1,3,-2,-1,-1,0,0
कर,10,8,-2,-1,1,0,0
कर,1,3,2,1,1,0,0
दे,2,2,0,0,-1,0,0
समझ,2,3,1,1,1,0,0
कर,4,2,2,1,-1,0,0
रख,3,2,1,1,-1,0,0
रख,1,5,-4,-1,-1,0,0
भेज,1,2,-1,-1,-1,0,0
कर,1,2,1,1,1,-1,0
कर,4,4,0,0,-1,0,0
कर,9,2,-7,-1,1,0,0
दे,1,4,-3,-1,-1,0,0
जीत,1,2,-1,-1,-1,0,0
कर,9,5,4,1,-1,0,0
कर,1,7,-6,-1,-1,0,0
रख,2,2,0,0,1,-1,0
बना,4,16,12,1,1,0,0
कर,4,2,2,1,-1,0,0
कर,1,3,-2,-1,-1,0,0
खिला,2,2,0,0,1,0,0
देख,1,13,-12,-1,-1,0,0
करा,2,4,2,1,1,0,0
चला,1,3,2,1,1,0,0
जोड़,1,3,2,1,1,-1,0
धो,4,2,2,1,-1,0,0
सीख,2,4,-2,-1,-1,0,0
खेल,3,3,0,0,1,0,0
कर,2,3,1,1,1,0,0
जता,2,7,-5,-1,-1,0,0
जता,2,3,-1,-1,-1,0,0
रोक,2,2,0,0,1,0,0
भर,1,2,-1,-1,-1,0,0
कर,6,3,-3,-1,1,0,0
ला,5,2,-3,-1,1,0,0
कर,9,2,7,1,-1,0,0
पढ़,8,2,6,1,-1,0,0
खोल,3,14,11,1,1,0,0
रोक,1,5,-4,-1,-1,0,0
कर,2,12,-10,-1,-1,0,0
ले,2,2,0,0,-1,-1,0
लगा,4,4,0,0,-1,0,0
कर,4,2,2,1,-1,0,0
कर,6,3,3,1,-1,0,0
कर,1,4,-3,-1,-1,0,0
था,1,2,-1,-1,-1,0,0
मंगा,4,6,-2,-1,-1,0,0
उतार,1,5,-4,-1,-1,0,0
छोड़,3,2,1,1,-1,0,0
हटा,2,2,0,0,-1,0,0
हटा,1,3,-2,-1,-1,0,0
जता,2,13,-11,-1,-1,0,0
कर,3,5,-2,-1,-1,0,0
ले,1,5,-4,-1,-1,1,0
ला,1,3,-2,-1,-1,0,0
करा,1,16,15,1,1,-1,0
कर,1,3,-2,-1,-1,0,0
ले,6,4,2,1,-1,0,0
सौंप,5,3,-2,-1,1,0,0
मार,1,5,-4,-1,-1,0,0
मार,6,8,-2,-1,-1,0,0
कर,2,5,-3,-1,-1,0,0
दाग,4,4,0,0,-1,0,0
मार,5,5,0,0,-1,0,0
पढ़ा,1,2,-1,-1,-1,0,0
कर,2,2,0,0,1,0,0
कर,3,3,0,0,-1,0,0
कर,1,2,-1,-1,-1,0,0
उठा,6,3,3,1,-1,0,0
कर,6,8,-2,-1,-1,0,0
उखाड,1,3,-2,-1,-1,0,0
लगा,3,2,1,1,-1,0,0
कर,3,4,-1,-1,-1,0,0
ले,1,9,-8,-1,-1,0,0
सुलझा,2,2,0,0,1,1,0
लड़,1,5,-4,-1,-1,0,0
पहुंचा,9,4,-5,-1,1,0,0
रख,5,2,-3,-1,1,0,0
कर,5,7,2,1,1,0,0
जोड़,2,2,0,0,1,0,0
ले,4,5,-1,-1,-1,0,0
बांट,2,3,1,1,1,0,0
पहुंचा,2,2,0,0,-1,0,0
मान,5,2,-3,-1,1,0,0
बना,3,2,1,1,-1,0,0
बना,4,2,2,1,-1,0,0
कर,1,10,-9,-1,-1,0,0
कर,1,3,-2,-1,-1,1,0
ला,2,5,-3,-1,-1,0,0
रख,2,2,0,0,1,0,0
कर,2,5,3,1,1,0,0
रख,4,3,1,1,-1,0,0
है,1,9,-8,-1,-1,0,0
ले,8,6,2,1,-1,0,0
ले,6,5,1,1,-1,0,0
ले,6,5,1,1,-1,0,0
मांग,4,3,1,1,-1,0,0
रख,1,2,1,1,1,-1,0
रख,5,2,-3,-1,1,0,0
सौंप,2,2,0,0,-1,0,0
ले,3,2,-1,-1,1,0,0
पहुंचा,7,8,1,1,1,0,0
कर,1,3,-2,-1,-1,0,0
कर,6,2,-4,-1,1,0,0
लगा,2,4,-2,-1,-1,0,0
पहुंचा,7,2,-5,-1,1,0,0
रच,4,2,2,1,-1,0,0
खोल,5,2,3,1,-1,0,0
कर,2,2,0,0,1,0,0
हटा,1,10,-9,-1,-1,0,0
रख,19,3,-16,-1,1,0,0
ले,3,2,-1,-1,1,0,0
ले,1,2,-1,-1,-1,0,0
कर,11,3,-8,-1,1,0,0
कर,3,5,-2,-1,-1,0,0
कर,4,4,0,0,-1,0,0
कर,3,5,-2,-1,-1,0,0
कर,2,2,0,0,-1,0,0
कर,3,2,-1,-1,1,0,0
खोल,2,4,-2,-1,-1,0,0
बढ़ा,3,6,-3,-1,-1,0,0
कर,9,6,3,1,-1,0,0
बुला,3,2,1,1,-1,0,0
कर,2,5,3,1,1,0,0
बांध,5,2,-3,-1,1,0,0
रेत,2,4,-2,-1,-1,0,0
कर,3,2,-1,-1,1,0,0
कर,9,3,6,1,-1,-1,0
कर,3,4,1,1,1,0,0
कर,1,3,-2,-1,-1,0,0
कर,3,2,1,1,-1,-1,0
कर,10,9,1,1,-1,0,0
कर,1,2,-1,-1,-1,-1,0
कर,4,5,-1,-1,-1,0,0
बना,24,5,19,1,-1,0,0
निभा,2,6,-4,-1,-1,0,0
ले,1,4,-3,-1,-1,0,0
चला,1,3,-2,-1,-1,0,0
मार,3,2,1,1,-1,0,0
आ,5,2,3,1,-1,0,0
कर,5,3,2,1,-1,0,0
कर,3,4,-1,-1,-1,0,0
कर,3,4,-1,-1,-1,0,0
लुटा,4,3,-1,-1,1,0,0
बना,2,11,-9,-1,-1,0,0
कर,2,3,1,1,1,0,0
बना,3,4,-1,-1,-1,0,0
कर,1,5,-4,-1,-1,0,0
बना,7,3,4,1,-1,0,0
मार,4,2,2,1,-1,-1,0
सुलझा,4,3,-1,-1,1,0,0
कुचल,6,4,-2,-1,1,0,0
कर,1,2,-1,-1,-1,0,0
कर,2,3,-1,-1,-1,0,0
छेड़,1,6,-5,-1,-1,0,0
कर,1,3,-2,-1,-1,0,0
दे,3,3,0,0,-1,0,0
रख,1,4,-3,-1,-1,0,0
दे,1,6,-5,-1,-1,0,0
मान,1,6,-5,-1,-1,0,0
कर,2,6,-4,-1,-1,0,0
कर,3,9,-6,-1,-1,0,0
कर,5,2,3,1,-1,0,0
कर,6,2,-4,-1,1,0,0
कर,1,3,2,1,1,-1,0
बना,1,2,-1,-1,-1,0,0
दिखा,6,10,-4,-1,-1,0,0
कर,1,2,-1,-1,-1,-1,0
कर,3,9,-6,-1,-1,0,0
बता,15,4,11,1,-1,0,0
करा,2,2,0,0,-1,0,0
कर,4,2,-2,-1,1,0,0
दिखा,3,7,4,1,1,0,0
कर,2,5,-3,-1,-1,1,0
कर,2,2,0,0,-1,0,0
हटा,3,3,0,0,-1,0,0
लगा,1,2,-1,-1,-1,0,0
लगा,1,3,-2,-1,-1,0,0
कर,2,3,1,1,1,0,0
कर,9,3,-6,-1,1,0,0
कर,2,3,-1,-1,-1,0,0
कर,8,2,6,1,-1,1,0
कर,12,8,-4,-1,1,0,0
भेज,7,2,-5,-1,1,0,0
करा,1,2,-1,-1,-1,0,0
कर,4,5,-1,-1,-1,0,0
बना,4,4,0,0,-1,0,0
रख,4,2,-2,-1,1,0,0
हटा,2,4,-2,-1,-1,0,0
कर,6,2,-4,-1,1,0,0
कर,12,3,9,1,-1,0,0
कर,9,5,-4,-1,1,0,0
कर,3,2,1,1,-1,-1,0
कह,2,2,0,0,1,0,0
कर,7,3,-4,-1,1,0,0
बढ़ा,1,17,-16,-1,-1,0,0
भेज,4,2,2,1,-1,-1,0
ले,3,2,-1,-1,1,0,0
लटक,6,4,-2,-1,1,0,0
कर,1,2,-1,-1,-1,0,0
रह,2,4,2,1,1,0,0
लगा,1,5,-4,-1,-1,0,0
कर,5,3,-2,-1,1,0,0
दे,1,2,-1,-1,-1,0,0
कर,2,3,-1,-1,-1,0,0
बना,1,2,-1,-1,-1,0,0
बना,2,2,0,0,-1,0,0
मांग,1,4,-3,-1,-1,0,0
कर,16,3,-13,-1,1,0,0
रख,9,2,-7,-1,1,0,0
उठा,13,22,-9,-1,-1,0,0
कर,2,3,-1,-1,-1,0,0
भेज,2,3,-1,-1,-1,0,0
कर,1,2,-1,-1,-1,0,0
कर,2,3,1,1,1,0,0
कर,4,14,-10,-1,-1,0,0
ले,1,2,-1,-1,-1,0,0
दे,5,5,0,0,1,0,0
सौंप,5,2,3,1,-1,0,0
हटा,3,4,1,1,1,0,0
ले,2,5,-3,-1,-1,0,0
बता,1,4,-3,-1,-1,1,0
डाल,3,4,-1,-1,-1,0,0
जान,1,2,1,1,1,-1,0
बना,1,9,-8,-1,-1,0,0
बना,2,2,0,0,-1,0,0
रख,2,4,-2,-1,-1,0,0
भर,1,3,-2,-1,-1,0,0
कस,8,4,-4,-1,1,0,0
लगा,2,12,-10,-1,-1,0,0
ले,1,4,-3,-1,-1,0,0
बता,2,3,-1,-1,-1,0,0
हो,4,2,2,1,-1,-1,0
कर,3,3,0,0,-1,0,0
डाल,4,6,-2,-1,-1,0,0
दिखा,1,3,-2,-1,-1,0,0
डाल,4,2,2,1,-1,0,0
कर,2,3,-1,-1,-1,0,0
रख,5,2,-3,-1,1,0,0
कर,3,3,0,0,1,1,0
कर,1,2,1,1,1,0,0
दे,2,41,39,1,1,0,0
हो,6,3,3,1,-1,0,0
उठा,3,2,1,1,-1,0,0
बना,17,3,14,1,-1,0,0
कर,3,3,0,0,1,0,0
बोल,1,2,-1,-1,-1,1,0
कर,1,4,3,1,1,-1,0
बना,2,2,0,0,-1,0,0
बना,1,2,-1,-1,-1,-1,0
मार,2,3,1,1,1,0,0
कर,9,3,6,1,-1,0,0
करा,1,4,3,1,1,-1,0
खो,1,2,-1,-1,-1,0,0
करा,3,5,2,1,1,0,0
ले,9,2,-7,-1,1,1,0
चला,1,3,-2,-1,-1,0,0
कर,3,5,2,1,1,0,0
कर,4,2,2,1,-1,0,0
चला,2,2,0,0,-1,0,0
ले,1,3,-2,-1,-1,0,0
मिला,1,2,-1,-1,-1,0,0
सुन,7,3,4,1,-1,0,0
कर,2,3,-1,-1,-1,0,0
मांग,4,4,0,0,-1,0,0
कर,4,6,-2,-1,-1,0,0
घटा,5,3,-2,-1,1,0,0
जोड़,4,3,-1,-1,1,0,0
कर,4,4,0,0,-1,0,0
कर,1,5,-4,-1,-1,0,0
रख,3,2,-1,-1,1,0,0
ले,1,4,-3,-1,-1,0,0
बढ़ा,3,6,-3,-1,-1,0,0
कर,3,6,-3,-1,-1,0,0
कर,5,4,1,1,-1,0,0
ले,3,2,-1,-1,1,0,0
मांग,1,3,-2,-1,-1,0,0
दफना,2,11,-9,-1,-1,-1,0
दफना,2,3,1,1,1,0,0
कर,3,3,0,0,-1,0,0
बांध,1,3,2,1,1,-1,0
रख,5,2,-3,-1,1,0,0
हो,2,6,4,1,1,0,0
सुन,3,3,0,0,1,0,0
बदल,1,2,-1,-1,-1,0,0
लग,1,2,-1,-1,-1,0,0
कर,3,2,1,1,-1,0,0
रख,2,3,-1,-1,-1,0,0
बचा,2,2,0,0,1,-1,0
ले,3,2,1,1,-1,-1,0
ले,6,2,4,1,-1,0,0
लगा,3,3,0,0,1,0,0
कर,2,4,-2,-1,-1,0,0
पढ,4,5,-1,-1,-1,0,0
दे,4,8,-4,-1,-1,0,0
जोड,1,5,4,1,1,-1,0
भेज,6,3,-3,-1,1,0,0
चला,1,2,-1,-1,-1,0,0
मार,2,5,-3,-1,-1,0,0
कर,9,2,7,1,-1,0,0
कर,8,3,-5,-1,1,0,0
मिल,6,6,0,0,-1,0,0
कर,2,2,0,0,-1,-1,0
डाल,1,2,-1,-1,-1,0,0
दे,2,3,-1,-1,-1,0,0
मान,3,2,-1,-1,1,0,0
कर,1,3,-2,-1,-1,0,0
कर,2,2,0,0,-1,0,0
घेर,2,5,-3,-1,-1,0,0
ले,3,3,0,0,-1,0,0
उठा,7,3,-4,-1,1,0,0
कर,4,3,1,1,-1,0,0
ले,1,5,-4,-1,-1,0,0
खड़क,1,3,-2,-1,-1,0,0
कर,16,2,14,1,-1,0,0
दे,3,10,-7,-1,-1,0,0
चाह,2,2,0,0,-1,-1,0
कर,12,2,10,1,-1,0,0
कर,2,3,-1,-1,-1,0,0
कर,1,2,-1,-1,-1,-1,0
घसीट,1,5,4,1,1,-1,0
ले,4,3,1,1,-1,0,0
ले,13,3,10,1,-1,0,0
भेज,2,14,-12,-1,-1,0,0
कर,5,3,2,1,-1,0,0
फिसल,3,3,0,0,-1,0,0
मना,1,2,-1,-1,-1,0,0
रोक,2,3,-1,-1,-1,0,0
मंगा,4,2,2,1,-1,0,0
रख,1,2,-1,-1,-1,0,0
हो,4,7,-3,-1,-1,0,0
कर,6,5,-1,-1,1,0,0
दे,3,5,-2,-1,-1,0,0
दे,2,3,-1,-1,-1,0,0
मांग,4,3,1,1,-1,0,0
रह,1,3,-2,-1,-1,0,0
बदल,4,3,-1,-1,1,0,0
कर,10,5,5,1,-1,0,0
दे,1,2,-1,-1,-1,-1,0
लिख,3,9,-6,-1,-1,0,0
छोड,3,5,-2,-1,-1,0,0
खोल,3,2,1,1,-1,0,0
कर,3,3,0,0,-1,0,0
लड,1,4,-3,-1,-1,0,0
कर,8,3,5,1,-1,0,0
कर,7,3,4,1,-1,0,0
कर,17,2,-15,-1,1,0,0
कर,4,3,1,1,-1,0,0
छीन,1,5,4,1,1,-1,0
ले,3,4,1,1,1,0,0
मांग,1,4,-3,-1,-1,0,0
कर,1,2,-1,-1,-1,0,0
उठा,10,4,6,1,-1,0,0
डाल,1,2,-1,-1,-1,0,0
हो,4,3,1,1,-1,-1,0
कर,6,2,4,1,-1,0,0
दे,5,2,-3,-1,1,0,0
आ,4,2,2,1,-1,-1,0
गहरा,1,2,-1,-1,-1,-1,0
पहुंच,2,2,0,0,1,0,0
ले,12,2,10,1,-1,0,0
ले,1,2,-1,-1,-1,0,0
ले,3,4,-1,-1,-1,0,0
कर,2,3,-1,-1,-1,0,0
दे,2,2,0,0,-1,-1,0
कर,5,5,0,0,1,0,0
दे,1,3,-2,-1,-1,0,0
ले,9,7,-2,-1,1,0,0
दे,2,4,-2,-1,-1,0,0
बरत,1,6,5,1,1,-1,0
मना,3,3,0,0,-1,0,0
कर,1,2,-1,-1,-1,0,0
सुझा,2,14,-12,-1,-1,0,0
रख,2,4,-2,-1,-1,0,0
कर,2,3,-1,-1,-1,0,0
दे,3,5,-2,-1,-1,0,0
लगा,3,4,-1,-1,-1,0,0
दिखा,4,2,2,1,-1,0,0
दिख,3,4,1,1,1,0,0
बना,10,3,7,1,-1,0,0
रख,7,3,4,1,-1,0,0
कर,3,2,-1,-1,1,0,0
दे,6,2,-4,-1,1,0,0
बना,6,4,2,1,-1,0,0
कर,13,3,-10,-1,1,0,0
दे,1,6,-5,-1,-1,0,0
कर,8,2,-6,-1,1,0,0
कर,2,4,-2,-1,-1,0,0
तलाश,2,2,0,0,-1,0,0
आ,2,5,3,1,1,0,0
कर,2,2,0,0,-1,0,0
कर,9,3,6,1,-1,0,0
कर,2,3,-1,-1,-1,0,0
कर,1,6,5,1,1,-1,0
मना,5,3,-2,-1,1,0,0
कर,2,3,-1,-1,-1,0,0
रख,5,2,-3,-1,1,0,0
कर,2,7,5,1,1,0,0
रख,2,9,-7,-1,-1,-1,0
मंगा,3,2,1,1,-1,0,0
पहुंचा,1,2,-1,-1,-1,1,0
कर,1,2,-1,-1,-1,-1,0
कर,5,4,1,1,-1,0,0
बदल,3,2,-1,-1,1,0,0
कर,4,22,-18,-1,-1,0,0
कह,10,5,5,1,-1,0,0
करा,3,5,-2,-1,-1,0,0
कर,4,3,1,1,-1,0,0
कर,4,2,2,1,-1,0,0
लगा,3,5,-2,-1,-1,0,0
कर,4,12,-8,-1,-1,0,0
कर,4,2,2,1,-1,0,0
बना,3,4,1,1,1,0,0
लगा,16,12,4,1,-1,0,0
है,1,3,-2,-1,-1,0,0
मंगा,5,3,2,1,-1,0,0
ले,5,2,-3,-1,1,0,0
हटा,4,2,-2,-1,1,0,0
बदल,6,3,3,1,-1,0,0
कर,6,2,4,1,-1,0,0
ले,4,2,2,1,-1,0,0
खिला,1,2,-1,-1,-1,0,0
थम,3,3,0,0,-1,0,0
जोड़,2,6,4,1,1,-1,0
कर,6,5,1,1,-1,0,0
कर,5,16,-11,-1,-1,0,0
कर,5,4,1,1,-1,0,0
है,1,5,-4,-1,-1,1,0
ले,11,2,9,1,-1,0,0
कर,6,5,1,1,-1,0,0
बढ़,3,12,-9,-1,-1,0,0
सुना,1,8,-7,-1,-1,0,0
कर,10,2,8,1,-1,0,0
कह,6,6,0,0,-1,0,0
लगा,1,2,-1,-1,-1,0,0
दे,2,2,0,0,-1,0,0
पहुंचा,2,2,0,0,-1,0,0
बिछा,2,8,-6,-1,-1,0,0
निभा,3,3,0,0,1,0,0
बंट,2,5,-3,-1,-1,0,0
मिल,3,2,1,1,-1,0,0
दे,6,2,4,1,-1,0,0
कर,2,10,8,1,1,0,0
ढक,4,2,2,1,-1,0,0
रोक,6,12,-6,-1,-1,0,0
कर,1,2,-1,-1,-1,0,0
कर,2,2,0,0,1,0,0
हटा,3,2,1,1,-1,0,0
चला,1,4,-3,-1,-1,0,0
कर,2,12,10,1,1,0,0
बना,5,2,3,1,-1,-1,0
अपना,3,4,-1,-1,-1,0,0
कर,1,15,-14,-1,-1,0,0
बना,8,2,6,1,-1,0,0
कर,3,3,0,0,1,0,0
चाह,11,2,9,1,-1,-1,0
कर,4,3,1,1,-1,0,0
बना,9,15,6,1,1,0,0
दे,16,2,14,1,-1,0,0
ले,3,3,0,0,1,0,0
टेक,1,2,-1,-1,-1,0,0
दे,6,3,3,1,-1,0,0
मार,3,6,-3,-1,-1,0,0
कर,5,2,3,1,-1,0,0
चाह,6,3,3,1,-1,0,0
जता,3,4,-1,-1,-1,0,0
जला,3,3,0,0,-1,0,0
भेज,7,3,4,1,-1,0,0
लगा,6,5,-1,-1,1,0,0
कर,3,8,-5,-1,-1,0,0
लगा,1,3,-2,-1,-1,0,0
कर,15,11,4,1,-1,0,0
कर,1,2,1,1,1,-1,0
कर,3,2,1,1,-1,0,0
कर,4,3,1,1,-1,0,0
कर,5,5,0,0,1,0,0
कर,3,3,0,0,-1,0,0
बना,2,5,3,1,1,0,0
लटका,16,3,-13,-1,1,0,0
पहुंचा,2,8,6,1,1,0,0
देख,7,4,3,1,-1,0,0
कर,1,2,1,1,1,-1,0
कर,2,2,0,0,1,0,0
रह,7,6,1,1,-1,0,0
कह,1,2,-1,-1,-1,1,0
कह,1,3,-2,-1,-1,0,0
ले,3,2,-1,-1,1,0,0
आ,2,2,0,0,-1,0,0
लगा,2,2,0,0,-1,0,0
कर,3,2,1,1,-1,0,0
कर,2,2,0,0,-1,0,0
चल,12,2,10,1,-1,0,0
कर,3,2,1,1,-1,-1,0
लग,1,3,-2,-1,-1,0,0
बांध,1,2,-1,-1,-1,0,0
दे,7,3,4,1,-1,0,0
खींच,1,4,-3,-1,-1,0,0
दे,1,2,-1,-1,-1,0,0
कर,1,5,-4,-1,-1,0,0
रख,1,2,-1,-1,-1,0,0
लगा,2,5,-3,-1,-1,0,0
गरमा,1,2,-1,-1,-1,-1,0
रोक,9,2,-7,-1,1,0,0
ले,1,5,-4,-1,-1,0,0
कर,2,3,1,1,1,0,0
कर,4,5,-1,-1,-1,0,0
कर,1,2,-1,-1,-1,0,0
कर,2,2,0,0,-1,0,0
हो,2,4,-2,-1,-1,0,0
फेंक,1,3,-2,-1,-1,0,0
हटा,2,2,0,0,-1,0,0
कर,13,4,9,1,-1,0,0
रोक,2,13,11,1,1,0,0
कर,9,6,3,1,-1,0,0
कर,3,3,0,0,-1,0,0
रख,7,3,4,1,-1,0,0
जमा,1,6,-5,-1,-1,0,0
लौटा,2,3,-1,-1,-1,0,0
दे,1,2,-1,-1,-1,0,0
चला,1,3,-2,-1,-1,0,0
बढ़ा,3,2,1,1,-1,0,0
दे,2,2,0,0,1,0,0
भेज,3,2,1,1,-1,-1,0
रख,6,2,4,1,-1,0,0
लगा,3,5,-2,-1,-1,0,0
कर,2,3,-1,-1,-1,0,0
करा,4,3,1,1,-1,0,0
कर,3,4,1,1,1,0,0
मान,1,2,1,1,1,-1,0
डाल,3,2,-1,-1,1,0,0
दिखा,3,3,0,0,-1,0,0
कर,7,3,4,1,-1,0,0
पा,1,2,-1,-1,-1,0,0
रह,4,2,2,1,-1,0,0
बढा,4,2,2,1,-1,0,0
मिल,1,2,-1,-1,-1,0,0
भर,17,3,-14,-1,1,0,0
जा,2,2,0,0,-1,0,0
दे,1,2,-1,-1,-1,-1,0
पा,2,2,0,0,-1,0,0
सौंप,2,3,-1,-1,-1,0,0
हो,9,3,-6,-1,1,0,0
लगा,1,4,-3,-1,-1,0,0
डाल,1,3,-2,-1,-1,0,0
लगा,18,2,16,1,-1,0,0
दे,3,8,-5,-1,-1,0,0
भेज,5,5,0,0,1,0,0
दे,1,22,-21,-1,-1,0,0
ले,1,2,-1,-1,-1,0,0
ले,1,2,-1,-1,-1,0,0
लड,2,2,0,0,-1,0,0
कर,9,6,-3,-1,1,0,0
रख,2,4,-2,-1,-1,0,0
पा,2,2,0,0,-1,0,0
रख,5,4,-1,-1,1,0,0
कर,4,3,-1,-1,1,0,0
कर,4,4,0,0,-1,0,0
दे,2,2,0,0,-1,0,0
आ,1,12,-11,-1,-1,0,0
कर,2,4,2,1,1,0,0
कर,6,3,-3,-1,1,0,0
कर,11,2,-9,-1,1,0,0
बना,6,2,4,1,-1,0,0
दिखा,1,6,-5,-1,-1,1,0
कर,1,5,-4,-1,-1,1,0
कर,3,2,1,1,-1,0,0
हो,4,5,1,1,1,0,0
डाल,2,2,0,0,-1,0,0
आ,1,2,-1,-1,-1,0,0
कर,1,3,-2,-1,-1,1,0
हो,2,3,-1,-1,-1,0,0
कर,4,3,1,1,-1,0,0
कर,7,4,3,1,-1,0,0
कर,2,5,3,1,1,0,0
कर,3,4,1,1,1,0,0
रख,12,2,-10,-1,1,0,0
बढ़,4,2,2,1,-1,0,0
पहुंच,1,2,1,1,1,-1,0
कर,1,4,-3,-1,-1,0,0
ले,1,6,5,1,1,-1,0
कर,2,5,-3,-1,-1,0,0
उठा,1,14,-13,-1,-1,0,0
कर,2,4,-2,-1,-1,0,0
ला,3,2,-1,-1,1,0,0
लगा,1,3,-2,-1,-1,0,0
करा,17,2,-15,-1,1,0,0
हो,8,2,6,1,-1,0,0
दे,2,2,0,0,1,0,0
भगा,2,2,0,0,1,1,0
बन,1,2,-1,-1,-1,0,0
दे,1,5,-4,-1,-1,0,0
दे,6,3,3,1,-1,0,0
कर,3,20,17,1,1,0,0
कर,2,2,0,0,1,0,0
टकरा,5,2,3,1,-1,0,0
कर,1,2,-1,-1,-1,1,0
कर,5,2,3,1,-1,0,0
लिख,3,3,0,0,-1,0,0
दे,2,3,-1,-1,-1,0,0
हो,1,4,-3,-1,-1,0,0
ले,1,2,-1,-1,-1,0,0
कर,2,3,1,1,1,0,0
फैला,2,2,0,0,-1,0,0
पा,1,3,-2,-1,-1,0,0
हो,5,3,-2,-1,1,0,0
उतार,2,2,0,0,1,0,0
बदल,1,2,1,1,1,-1,0
उतार,2,2,0,0,1,0,0
दे,4,3,1,1,-1,0,0
दे,1,3,-2,-1,-1,0,0
ले,1,2,-1,-1,-1,0,0
कर,6,3,3,1,-1,0,0
कर,6,3,3,1,-1,0,0
कर,3,2,-1,-1,1,0,0
कर,5,2,3,1,-1,0,0
कर,2,13,-11,-1,-1,0,0
ठुकरा,20,3,-17,-1,1,0,0
हो,10,6,4,1,-1,0,0
कर,6,3,-3,-1,1,0,0
बता,7,2,5,1,-1,-1,0
खोद,1,4,-3,-1,-1,0,0
कर,3,5,-2,-1,-1,0,0
हो,4,8,-4,-1,-1,0,0
पा,1,5,-4,-1,-1,0,0
है,1,3,-2,-1,-1,-1,0
कर,2,5,-3,-1,-1,0,0
करा,1,3,-2,-1,-1,0,0
हो,3,3,0,0,1,0,0
बढ,3,2,1,1,-1,0,0
बढ,2,3,1,1,1,0,0
मान,1,3,-2,-1,-1,1,0
कर,5,2,-3,-1,1,0,0
बना,4,2,2,1,-1,0,0
कर,3,2,1,1,-1,0,0
कर,3,3,0,0,-1,0,0
वसूल,2,2,0,0,-1,0,0
कर,3,2,1,1,-1,-1,0
कर,2,5,-3,-1,-1,0,0
ला,1,3,-2,-1,-1,0,0
बना,5,2,3,1,-1,0,0
ले,1,4,-3,-1,-1,0,0
देख,3,6,3,1,1,0,0
दे,1,5,-4,-1,-1,0,0
कर,1,11,-10,-1,-1,0,0
ले,4,2,2,1,-1,0,0
फट,1,5,-4,-1,-1,0,0
निकाल,3,2,-1,-1,1,1,0
कर,6,2,4,1,-1,0,0
कर,7,2,5,1,-1,0,0
ले,2,6,-4,-1,-1,0,0
रख,12,3,9,1,-1,0,0
ले,4,3,1,1,-1,0,0
बढ़,4,3,1,1,-1,0,0
जा,1,2,-1,-1,-1,0,0
भेज,1,2,-1,-1,-1,0,0
भेज,1,2,-1,-1,-1,0,0
दे,2,2,0,0,1,0,0
कर,6,2,-4,-1,1,0,0
लगा,4,2,2,1,-1,0,0
खड़ा,6,2,4,1,-1,0,0
कर,1,2,-1,-1,-1,0,0
गिरा,4,2,-2,-1,1,0,0
कर,2,5,-3,-1,-1,0,0
देख,3,2,1,1,-1,0,0
पहुंचा,4,3,-1,-1,1,0,0
पहुंचा,2,2,0,0,-1,0,0
चला,7,2,5,1,-1,0,0
