Verb,NP_len,PP_len,Len_diff,Len,Arg_status,Pronominality,Order
dedicare,2,5,3,1,1,0,1
mettere,15,2,13,1,-1,0,1
uccidere,2,6,4,1,1,0,1
sfracellare,1,3,2,1,1,1,1
fare,1,8,7,1,1,0,1
fare,2,8,6,1,1,0,1
danneggiare,12,3,9,1,-1,0,1
trascorrere,3,5,2,1,1,0,1
svelare,3,3,0,0,-1,0,1
liberare,2,2,0,0,1,0,1
consegnare,6,6,0,0,1,0,1
fornire,1,6,5,1,1,0,1
realizzare,2,8,6,1,1,0,1
infliggere,2,13,11,1,1,0,1
comprare,3,4,-1,-1,-1,0,1
citare,3,3,0,0,1,0,1
battere,2,3,1,1,1,0,1
rivendicare,5,3,2,1,-1,0,1
leggere,2,6,4,1,1,0,1
leggere,2,3,1,1,1,0,1
avere,7,2,5,1,-1,0,1
saltare,5,2,3,1,-1,0,1
mettere,9,2,7,1,-1,0,1
chiedere,4,6,2,1,1,0,1
collegare,7,7,0,0,1,0,1
unire,7,10,3,1,1,0,1
porre,1,5,4,1,1,0,1
rendere,2,2,0,0,1,0,1
garantire,2,2,0,0,1,0,1
trasformare,5,3,-2,-1,1,0,1
tenere,2,6,4,1,1,0,1
sovrapporre,3,4,-1,-1,-1,0,1
fare,1,3,2,1,1,0,1
prendere,1,3,2,1,1,0,1
portare,6,2,4,1,-1,1,1
affidare,3,27,24,1,1,0,1
dare,2,5,3,1,1,0,1
dare,2,12,10,1,1,0,1
dedicare,2,4,2,1,1,0,1
condurre,3,4,1,1,1,-1,1
contrastare,8,5,3,1,-1,0,1
portare,1,5,4,1,1,0,1
ricevere,1,3,2,1,1,0,1
organizzare,1,4,3,1,1,0,1
finanziare,3,13,10,1,1,0,1
tirare,3,2,1,1,-1,-1,1
invitare,1,2,1,1,1,1,1
cambiare,1,9,8,1,1,0,1
lesinare,2,8,-6,-1,-1,0,1
mettere,2,2,0,0,-1,0,1
presentare,2,5,3,1,1,0,1
mettere,3,6,3,1,1,0,1
frenare,5,8,3,1,1,0,1
alzare,6,9,3,1,1,0,1
varare,11,2,-9,-1,1,0,1
avere,2,5,3,1,1,-1,1
vedere,3,4,-1,-1,-1,0,1
passare,2,5,3,1,1,0,1
decidere,5,4,-1,-1,1,0,1
cullare,5,2,3,1,-1,0,1
trasformare,2,10,8,1,1,0,1
sviluppare,3,3,0,0,-1,0,1
avere,12,2,10,1,-1,0,1
commettere,2,3,1,1,1,0,1
mettere,2,2,0,0,-1,0,1
mandare,2,4,2,1,1,1,1
accomunare,5,3,2,1,-1,0,1
mandare,2,9,7,1,1,0,1
fare,2,4,2,1,1,0,1
dare,5,8,3,1,1,0,1
lasciare,2,3,1,1,1,0,1
studiare,7,2,5,1,-1,0,1
chiedere,2,11,9,1,1,0,1
passare,2,6,4,1,1,0,1
percorrere,3,10,7,1,1,0,1
avere,3,2,-1,-1,1,0,1
toccare,5,2,3,1,-1,0,1
avere,6,2,4,1,-1,0,1
dare,2,3,1,1,1,0,1
filmare,8,2,6,1,-1,0,1
vedere,1,2,1,1,1,1,1
portare,2,2,0,0,-1,0,1
accendere,2,2,0,0,1,0,1
avere,2,2,0,0,1,0,1
collocare,4,7,-3,-1,-1,0,1
formulare,2,2,0,0,1,0,1
mettere,1,3,2,1,1,0,1
demolire,2,2,0,0,-1,0,1
avere,1,2,1,1,1,0,1
bere,1,10,9,1,1,0,1
preparare,2,5,3,1,1,0,1
arrivare,2,3,1,1,1,0,1
rovesciare,6,2,4,1,-1,0,1
dare,1,5,4,1,1,0,1
consentire,4,7,-3,-1,-1,0,1
rivendicare,8,2,6,1,-1,1,1
relegare,1,10,9,1,1,0,1
sostenere,4,2,2,1,-1,0,1
chiamare,6,3,3,1,-1,0,1
discutere,5,5,0,0,-1,0,1
cacciare,5,2,3,1,-1,0,1
vivere,7,11,-4,-1,-1,0,1
minacciare,8,5,3,1,-1,0,1
dare,1,11,10,1,1,0,1
condividere,9,2,7,1,-1,0,1
intaccare,6,3,3,1,-1,0,1
regalare,7,2,5,1,-1,1,1
regalare,14,2,12,1,-1,1,1
mettere,7,4,3,1,-1,0,1
schierare,2,2,0,0,-1,0,1
rilanciare,2,3,-1,-1,-1,0,1
catturare,10,2,8,1,-1,0,1
avere,6,2,4,1,-1,1,1
dare,1,4,3,1,1,0,1
restituire,12,3,9,1,-1,0,1
oscurare,5,4,-1,-1,1,0,1
eliminare,18,5,13,1,-1,0,1
dare,3,8,5,1,1,0,1
cercare,4,8,4,1,1,0,1
trascorrere,2,3,1,1,1,0,1
cadere,5,5,0,0,1,0,1
mandare,1,2,1,1,1,0,1
limitare,2,26,24,1,1,0,1
raccogliere,10,9,-1,-1,1,0,1
affittare,3,2,-1,-1,1,0,1
sganciare,2,3,1,1,1,0,1
legare,1,13,12,1,1,0,1
creare,3,3,0,0,1,0,1
avere,4,8,4,1,1,1,1
portare,6,4,2,1,-1,0,1
mettere,12,2,10,1,-1,0,1
lanciare,2,3,1,1,1,0,1
trasformare,3,4,1,1,1,0,1
inviare,11,3,-8,-1,1,0,1
fare,2,3,1,1,1,0,1
proporre,1,3,2,1,1,1,1
imbarcare,1,3,2,1,1,0,1
ferire,2,10,8,1,1,0,1
mobilitare,6,3,3,1,-1,0,1
puntare,2,13,11,1,1,0,1
portare,9,2,7,1,-1,0,1
vincere,2,2,0,0,1,0,1
sottrarre,9,7,-2,-1,1,0,1
tagliare,2,3,1,1,1,0,1
alleggerire,2,16,14,1,1,0,1
lanciare,2,10,8,1,1,0,1
portare,8,2,6,1,-1,0,1
dare,3,7,4,1,1,0,1
tenere,2,3,-1,-1,-1,0,1
vedere,3,10,7,1,1,1,1
integrare,5,4,-1,-1,1,0,1
risolvere,3,15,12,1,1,0,1
sbandierare,2,3,1,1,1,0,1
risolvere,2,15,13,1,1,0,1
raccogliere,10,6,-4,-1,1,0,1
mettere,2,2,0,0,-1,-1,1
raggiungere,2,12,10,1,1,1,1
togliere,1,5,4,1,1,0,1
sentire,6,4,2,1,-1,0,1
trovare,3,4,1,1,1,0,1
sbandierare,3,3,0,0,1,0,1
assumere,10,6,4,1,-1,0,1
ottenere,4,2,-2,-1,1,0,1
dare,1,15,14,1,1,0,1
raccogliere,3,4,1,1,1,0,1
scegliere,2,3,1,1,1,0,1
donare,2,6,4,1,1,0,1
attraversare,3,2,1,1,-1,0,1
avere,4,28,24,1,1,0,1
trascorrere,8,7,1,1,-1,0,1
volgere,2,14,12,1,1,0,1
lasciare,1,11,10,1,1,0,1
sgombrare,2,6,4,1,1,0,1
dire,3,18,15,1,1,0,1
scrivere,10,3,7,1,-1,0,1
condire,6,3,-3,-1,1,0,1
avere,4,3,1,1,-1,0,1
lasciare,3,4,-1,-1,-1,0,1
trovare,6,9,-3,-1,-1,0,1
avere,1,6,5,1,1,0,1
proporre,1,7,6,1,1,0,1
pubblicare,27,2,25,1,-1,0,1
prenotare,2,4,2,1,1,0,1
scrivere,6,7,1,1,1,0,1
dare,1,21,20,1,1,0,1
assumere,2,5,3,1,1,0,1
riunire,2,4,2,1,1,0,1
recitare,10,6,-4,-1,1,0,1
mettere,13,2,11,1,-1,0,1
portare,3,2,1,1,-1,0,1
vedere,5,5,0,0,-1,0,1
appoggiare,2,4,2,1,1,0,1
mangiare,2,3,-1,-1,-1,0,1
avere,17,2,15,1,-1,0,1
seguire,3,3,0,0,1,1,1
avette,2,3,1,1,1,-1,1
interpretare,5,3,-2,-1,1,0,1
grattare,4,2,2,1,-1,0,1
imbrattare,3,2,1,1,-1,0,1
mescolare,2,3,1,1,1,0,1
stralciare,5,15,10,1,1,0,1
trovare,11,3,8,1,-1,0,1
cercare,1,3,2,1,1,0,1
togliere,11,11,0,0,1,0,1
espellere,4,4,0,0,-1,0,1
ascoltare,1,8,7,1,1,1,1
rivolgere,2,2,0,0,1,0,1
sgombrare,2,3,1,1,1,0,1
mettere,5,2,3,1,-1,0,1
tenere,6,3,3,1,-1,0,1
prendere,1,5,4,1,1,0,1
mantenere,1,4,3,1,1,0,1
assicurare,2,24,22,1,1,0,1
lanciare,2,5,3,1,1,0,1
abbandonare,2,4,2,1,1,0,1
mettere,2,7,5,1,1,0,1
buttare,4,3,-1,-1,1,0,1
passare,2,5,3,1,1,0,1
fare,2,4,2,1,1,0,1
dominare,6,11,5,1,1,0,1
valere,5,6,1,1,1,0,1
scoprire,6,4,2,1,-1,0,1
confermare,1,2,1,1,1,0,1
inviare,2,3,1,1,1,0,1
criticare,9,3,6,1,-1,0,1
utilizzare,1,3,2,1,1,1,1
tenere,1,2,1,1,1,1,1
discutere,8,6,2,1,-1,0,1
mettere,5,2,3,1,-1,0,1
cambiare,2,2,0,0,-1,0,1
utilizzare,3,4,1,1,1,0,1
restituire,2,2,0,0,1,0,1
aggredire,4,3,1,1,-1,0,1
vincere,6,2,4,1,-1,0,1
sbancare,3,7,4,1,1,0,1
stritolare,1,5,4,1,1,1,1
rispettare,5,10,5,1,1,0,1
pensare,1,3,2,1,1,1,1
lacrimare,3,2,-1,-1,1,0,1
avere,2,3,1,1,1,0,1
tagliare,6,3,3,1,-1,0,1
atterrire,3,5,2,1,1,0,1
salutare,2,3,1,1,1,0,1
seguire,2,4,2,1,1,0,1
agguantare,3,7,4,1,1,0,1
finalizzare,4,3,1,1,-1,0,1
inventare,6,24,18,1,1,0,1
tagliare,3,16,13,1,1,0,1
provocare,5,3,-2,-1,1,0,1
ottenere,2,3,-1,-1,-1,0,1
dare,1,3,2,1,1,0,1
congelare,2,5,3,1,1,0,1
battere,14,3,11,1,-1,0,1
fare,5,4,1,1,-1,-1,1
mettere,7,2,5,1,-1,0,1
collaudare,5,3,-2,-1,1,0,1
cedere,1,6,5,1,1,1,1
concentrare,3,21,18,1,1,0,1
vivere,2,9,7,1,1,0,1
lasciare,1,2,1,1,1,0,1
trarre,2,12,10,1,1,0,1
lasciare,7,3,4,1,-1,0,1
sprecare,5,4,-1,-1,1,0,1
segnare,10,3,7,1,-1,0,1
verificare,5,5,0,0,-1,0,1
sostituire,1,2,1,1,1,0,1
prestare,1,2,1,1,1,0,1
cambiare,1,4,3,1,1,0,1
dare,3,7,-4,-1,-1,0,1
esaurire,5,6,-1,-1,-1,1,1
eliminare,5,3,2,1,-1,0,1
fare,8,12,4,1,1,0,1
cercare,5,3,-2,-1,1,0,1
battere,2,6,4,1,1,-1,1
piangere,3,6,3,1,1,0,1
allentare,13,3,10,1,-1,0,1
trarre,3,14,11,1,1,0,1
tirare,7,2,5,1,-1,0,1
commentare,6,2,4,1,-1,0,1
guardare,2,4,2,1,1,0,1
seguire,5,5,0,0,1,0,1
imporre,2,9,7,1,1,0,1
avere,19,2,17,1,-1,0,1
sottoporre,7,2,5,1,-1,-1,1
insegnare,2,3,1,1,1,0,1
abbinare,4,4,0,0,1,0,1
insegnare,1,7,6,1,1,1,1
organizzare,4,4,0,0,-1,0,1
tenere,2,6,4,1,1,0,1
trasformare,5,5,0,0,1,0,1
pigiare,2,3,1,1,1,0,1
battere,2,11,9,1,1,0,1
insegnare,5,3,2,1,-1,0,1
portare,2,3,1,1,1,0,1
sbattere,2,3,1,1,1,0,1
lanciare,7,3,4,1,-1,0,1
togliere,15,2,13,1,-1,0,1
festeggiare,4,4,0,0,-1,0,1
mettere,2,18,16,1,1,0,1
disputare,2,4,2,1,1,0,1
prendere,1,2,-1,-1,-1,0,1
concedere,4,9,5,1,1,0,1
prendere,1,6,5,1,1,0,1
vedere,3,7,4,1,1,0,1
mettere,1,2,1,1,1,1,1
siglare,2,4,-2,-1,-1,0,1
fare,1,4,3,1,1,0,1
consegnare,4,4,0,0,1,0,1
celebrare,6,5,1,1,-1,0,1
ridurre,4,2,2,1,-1,0,1
passare,2,3,1,1,1,0,1
dribblare,2,3,-1,-1,-1,0,1
fare,3,2,-1,-1,1,0,1
scoraggiare,5,16,11,1,1,0,1
vantare,10,10,0,0,1,0,1
accogliere,2,15,13,1,1,0,1
fare,9,3,6,1,-1,0,1
servire,2,2,0,0,1,0,1
dire,2,6,4,1,1,0,1
avere,17,2,15,1,-1,0,1
seguire,5,37,32,1,1,0,1
contenere,5,6,-1,-1,-1,0,1
disporre,2,3,1,1,1,0,1
preferire,7,24,-17,-1,-1,-1,1
ammirare,16,4,12,1,-1,0,1
piegare,4,7,3,1,1,0,1
completare,1,5,4,1,1,1,1
avere,4,2,2,1,-1,0,1
manipolare,2,18,16,1,1,0,1
ricavare,8,3,5,1,-1,0,1
trasformare,2,13,11,1,1,0,1
riparare,6,3,3,1,-1,0,1
rendere,22,4,18,1,-1,0,1
consentire,4,11,7,1,1,0,1
offrire,1,2,1,1,1,0,1
ricordare,4,5,1,1,1,1,1
trovare,1,39,38,1,1,0,1
avere,2,12,10,1,1,0,1
nascondere,9,4,5,1,-1,0,1
realizzare,3,11,8,1,1,0,1
avere,10,2,8,1,-1,0,1
consentire,2,3,1,1,1,0,1
conferire,9,3,6,1,-1,0,1
avere,3,13,-10,-1,-1,0,1
affiancare,24,5,19,1,-1,0,1
decorare,17,2,15,1,-1,0,1
avere,12,2,10,1,-1,0,1
tenere,2,2,0,0,-1,0,1
gratificare,1,2,1,1,1,1,1
dare,4,3,1,1,-1,0,1
mettere,3,2,1,1,-1,0,1
tagliare,1,4,3,1,1,1,1
lavare,2,11,9,1,1,0,1
stimolare,2,4,2,1,1,0,1
esporre,2,3,1,1,1,0,1
stabilire,1,2,1,1,1,1,1
dire,1,14,13,1,1,0,1
appoggiare,2,6,4,1,1,0,1
dare,1,3,2,1,1,0,1
usare,1,4,3,1,1,1,1
passare,1,11,10,1,1,1,1
tenere,2,2,0,0,1,0,1
prendere,1,2,1,1,1,1,1
strizzare,4,3,1,1,-1,0,1
condire,1,7,6,1,1,1,1
instaurare,3,3,0,0,1,-1,1
dare,2,7,5,1,1,0,1
rimpiazzare,5,3,-2,-1,1,0,1
applicare,5,2,3,1,-1,0,1
preparare,2,6,4,1,1,0,1
scrivere,2,15,13,1,1,0,1
ripubblicare,2,3,1,1,1,0,1
accordare,2,5,3,1,1,0,1
fare,2,2,0,0,1,0,1
riportare,11,2,9,1,-1,-1,1
vedere,5,6,1,1,1,0,1
spiazzare,2,7,5,1,1,0,1
celebrare,2,5,3,1,1,0,1
imputare,2,25,23,1,1,0,1
acquistare,4,5,1,1,1,0,1
fare,1,4,3,1,1,1,1
nascondere,6,17,11,1,1,0,1
vedere,2,2,0,0,1,0,1
toccare,7,6,-1,-1,1,0,1
preparare,2,8,6,1,1,0,1
presentare,10,3,7,1,-1,0,1
mettere,27,2,25,1,-1,0,1
chiamare,2,2,0,0,-1,0,1
dare,2,19,17,1,1,0,1
permettere,1,17,16,1,1,1,1
provare,5,15,10,1,1,0,1
dare,2,7,5,1,1,0,1
prendere,14,2,12,1,-1,0,1
dare,4,4,0,0,1,0,1
correre,14,2,12,1,-1,0,1
separare,4,2,-2,-1,1,0,1
passare,3,3,0,0,1,0,1
cercare,1,4,3,1,1,0,1
affrontare,3,13,10,1,1,-1,1
migliorare,5,3,-2,-1,1,0,1
assicurare,2,7,5,1,1,0,1
richiamare,6,16,10,1,1,0,1
considerare,6,2,4,1,-1,0,1
preparare,4,3,1,1,-1,0,1
mettere,18,6,12,1,-1,0,1
spingere,3,5,2,1,1,0,1
avere,4,4,0,0,1,1,1
portare,1,3,2,1,1,1,1
occupare,4,2,2,1,-1,0,1
parlare,2,2,0,0,-1,0,1
seguire,3,7,4,1,1,0,1
analizzare,2,3,-1,-1,-1,0,1
conservare,3,3,0,0,1,0,1
pagare,5,3,2,1,-1,0,1
tenere,5,11,6,1,1,0,1
lasciare,1,3,2,1,1,0,1
denunciare,5,7,-2,-1,-1,0,1
prendere,2,2,0,0,-1,0,1
evadere,2,3,1,1,1,0,1
rinsaldare,2,15,13,1,1,0,1
dare,1,2,1,1,1,1,1
assegnare,4,3,1,1,-1,0,1
recare,1,2,1,1,1,-1,1
costituire,3,7,4,1,1,0,1
sottoporre,5,10,-5,-1,-1,0,1
imporre,11,6,5,1,-1,0,1
regolare,8,7,-1,-1,1,0,1
abbandonare,14,12,-2,-1,1,0,1
obbligare,2,4,2,1,1,0,1
recare,1,3,2,1,1,0,1
chiudere,2,3,-1,-1,-1,0,1
permettere,2,24,22,1,1,-1,1
contemperare,5,6,1,1,1,0,1
avere,1,2,-1,-1,-1,0,1
intendere,36,4,32,1,-1,0,1
esercitare,3,8,5,1,1,0,1
rendere,2,3,1,1,1,-1,1
costituire,7,18,11,1,1,0,1
eseguire,21,16,5,1,-1,0,1
svolgere,3,8,5,1,1,0,1
difendere,3,21,18,1,1,0,1
ritenere,2,5,3,1,1,0,1
minacciare,1,11,10,1,1,0,1
osservare,6,13,7,1,1,0,1
regolare,4,10,6,1,1,0,1
chiedere,2,2,0,0,1,0,1
stabilire,6,4,-2,-1,1,0,1
estendere,2,3,1,1,1,0,1
manifestare,3,6,3,1,1,0,1
appoggiare,3,3,0,0,1,-1,1
acquistare,3,4,1,1,1,0,1
acquistare,6,5,-1,-1,1,0,1
trovare,1,17,16,1,1,0,1
accorciare,2,7,5,1,1,0,1
collocare,2,4,2,1,1,0,1
attraversare,3,6,3,1,1,0,1
fare,1,4,3,1,1,0,1
chiedere,2,7,5,1,1,0,1
rinforzare,1,3,2,1,1,1,1
costruire,1,5,4,1,1,0,1
chiedere,2,3,1,1,1,0,1
cedere,14,4,10,1,-1,0,1
aprire,9,3,-6,-1,1,0,1
preservare,3,9,6,1,1,0,1
porre,5,13,8,1,1,0,1
osservare,3,3,0,0,1,0,1
tutelare,2,13,11,1,1,0,1
ripiantare,1,4,3,1,1,0,1
tenere,1,7,6,1,1,0,1
dare,1,7,6,1,1,0,1
avere,3,48,45,1,1,0,1
aprire,1,7,6,1,1,0,1
aprire,1,12,11,1,1,1,1
aprire,2,15,13,1,1,0,1
avere,2,4,2,1,1,0,1
appoggiare,3,12,9,1,1,0,1
costruire,2,11,9,1,1,0,1
osservare,10,3,7,1,-1,0,1
divertire,1,5,4,1,1,1,1
avere,4,3,-1,-1,1,0,1
assicurare,4,3,1,1,-1,0,1
estrarre,1,3,2,1,1,0,1
recare,1,29,28,1,1,0,1
rappresentare,2,4,2,1,1,0,1
assegnare,2,10,8,1,1,0,1
permettere,1,7,6,1,1,0,1
applicare,14,3,11,1,-1,0,1
tutelare,7,10,3,1,1,0,1
subire,1,11,10,1,1,-1,1
usare,13,2,11,1,-1,0,1
inseguire,1,5,4,1,1,1,1
dovere,1,7,6,1,1,0,1
disciplinare,11,2,9,1,-1,0,1
restituire,1,3,2,1,1,1,1
fare,4,3,-1,-1,1,0,1
recare,2,4,2,1,1,0,1
dovere,5,9,-4,-1,-1,0,1
pagare,22,3,19,1,-1,0,1
chiedere,5,33,28,1,1,0,1
fare,1,13,12,1,1,0,1
attribuire,10,3,7,1,-1,0,1
pagare,15,6,9,1,-1,0,1
pagare,5,3,2,1,-1,0,1
proteggere,5,3,2,1,-1,0,1
attrarre,3,2,1,1,-1,1,1
rivendicare,2,6,4,1,1,-1,1
conseguire,5,6,-1,-1,-1,0,1
restituire,7,6,1,1,-1,0,1
chiedere,9,3,6,1,-1,0,1
ordinare,2,9,7,1,1,0,1
mantenere,2,8,6,1,1,0,1
avere,2,2,0,0,-1,0,1
mantenere,1,7,6,1,1,0,1
operare,22,3,19,1,-1,0,1
avere,28,9,-19,-1,1,0,1
pagare,3,3,0,0,-1,0,1
pretendere,6,11,5,1,1,0,1
restituire,2,3,1,1,1,0,1
precludere,14,3,11,1,-1,0,1
iscrivere,1,3,2,1,1,0,1
pagare,2,6,4,1,1,0,1
cedere,3,10,7,1,1,0,1
fare,3,3,0,0,-1,0,1
imporre,2,3,-1,-1,-1,0,1
togliere,1,6,5,1,1,1,1
aprire,1,6,5,1,1,1,1
indennizzare,2,12,10,1,1,0,1
dovere,13,3,10,1,-1,0,1
uniformare,1,17,16,1,1,1,1
prendere,14,3,11,1,-1,0,1
osservare,6,16,10,1,1,0,1
surrogare,3,8,5,1,1,0,1
pagare,2,13,11,1,1,0,1
restituire,1,5,4,1,1,1,1
restituire,1,7,6,1,1,1,1
prendere,2,7,5,1,1,0,1
assegnare,6,3,3,1,-1,0,1
ritardare,2,3,1,1,1,0,1
vendere,9,8,-1,-1,1,0,1
commettere,1,3,2,1,1,0,1
chiamare,2,2,0,0,-1,0,1
raccogliere,3,12,9,1,1,-1,1
prestare,3,7,-4,-1,-1,1,1
assicurare,3,3,0,0,-1,0,1
avere,1,16,15,1,1,0,1
ottenere,5,9,-4,-1,-1,0,1
dare,1,3,2,1,1,0,1
utilizzare,1,12,11,1,1,1,1
condurre,1,4,3,1,1,0,1
defluire,2,13,11,1,1,0,1
recare,2,6,4,1,1,0,1
condurre,2,4,2,1,1,0,1
attraversare,3,9,-6,-1,-1,0,1
passare,2,4,2,1,1,0,1
condurre,1,4,3,1,1,0,1
rimettere,2,4,2,1,1,0,1
possedere,2,4,2,1,1,0,1
sostituire,2,4,2,1,1,0,1
determinare,5,13,8,1,1,0,1
impedire,18,7,11,1,-1,0,1
mantenere,13,19,6,1,1,0,1
prosciugare,3,7,4,1,1,0,1
separare,3,10,7,1,1,0,1
fare,1,3,2,1,1,0,1
avere,10,63,53,1,1,0,1
procurare,1,3,2,1,1,1,1
avere,1,4,3,1,1,0,1
procurare,1,5,4,1,1,1,1
ottenere,6,11,5,1,1,0,1
ampliare,1,10,9,1,1,1,1
pagare,6,12,6,1,1,0,1
passare,11,4,7,1,-1,0,1
tollerare,11,3,8,1,-1,0,1
porre,1,7,6,1,1,0,1
imporre,9,3,6,1,-1,0,1
lasciare,2,9,7,1,1,0,1
lasciare,2,16,14,1,1,-1,1
avere,1,7,6,1,1,0,1
trasferire,5,12,7,1,1,0,1
recare,1,4,3,1,1,0,1
recare,2,7,5,1,1,0,1
fare,2,3,1,1,1,0,1
impedire,2,2,0,0,1,0,1
chiedere,7,6,-1,-1,1,0,1
permutare,2,2,0,0,-1,1,1
recare,1,3,2,1,1,-1,1
usare,1,9,8,1,1,1,1
togliere,30,7,23,1,-1,0,1
abbandonare,2,5,-3,-1,-1,1,1
apportare,10,3,7,1,-1,0,1
estendere,7,6,-1,-1,1,0,1
impugnare,5,11,6,1,1,0,1
avere,1,12,11,1,1,0,1
avere,1,4,3,1,1,0,1
stabilire,3,8,5,1,1,0,1
avere,1,8,7,1,1,0,1
avere,1,3,2,1,1,0,1
pagare,2,2,0,0,1,0,1
sottrarre,1,10,9,1,1,1,1
rendere,5,3,-2,-1,1,0,1
recare,1,10,9,1,1,0,1
disporre,2,4,2,1,1,0,1
produrre,1,6,5,1,1,1,1
avere,9,2,7,1,-1,0,1
prestare,10,3,7,1,-1,0,1
avere,4,2,2,1,-1,0,1
eseguire,2,4,2,1,1,0,1
stabilire,1,3,2,1,1,1,1
eseguire,2,12,10,1,1,-1,1
impugnare,2,6,4,1,1,0,1
eseguire,3,6,3,1,1,0,1
ricevere,2,3,1,1,1,0,1
avere,6,4,-2,-1,1,0,1
ricevere,2,3,1,1,1,0,1
surrogare,1,4,3,1,1,1,1
prestare,1,3,2,1,1,0,1
sostenere,2,10,8,1,1,0,1
subordinare,2,25,23,1,1,0,1
liberare,2,14,12,1,1,0,1
avere,15,2,13,1,-1,0,1
ottenere,5,3,2,1,-1,0,1
consegnare,3,3,0,0,-1,0,1
liberare,4,8,4,1,1,1,1
sostituire,8,4,4,1,-1,0,1
mantenere,1,4,3,1,1,1,1
liberare,2,8,6,1,1,1,1
imputare,21,4,17,1,-1,-1,1
prestare,1,6,5,1,1,0,1
estinguere,3,7,4,1,1,0,1
rilevare,1,2,1,1,1,1,1
opporre,10,2,8,1,-1,0,1
avere,3,3,0,0,-1,1,1
prestare,1,3,2,1,1,0,1
avere,3,2,1,1,-1,0,1
eseguire,2,7,5,1,1,0,1
porre,5,5,0,0,-1,0,1
assegnare,10,3,7,1,-1,0,1
richiedere,2,3,-1,-1,-1,0,1
opporre,9,3,6,1,-1,0,1
opporre,11,3,8,1,-1,0,1
limitare,8,2,6,1,-1,0,1
riconoscere,5,4,1,1,-1,0,1
svolgere,16,8,8,1,-1,0,1
attuare,5,8,-3,-1,-1,0,1
adeguare,9,10,1,1,1,0,1
tutelare,3,3,0,0,-1,0,1
ripudiare,2,20,18,1,1,0,1
assicurare,5,3,-2,-1,1,0,1
vietare,1,10,9,1,1,1,1
perseguire,2,5,3,1,1,0,1
professare,4,6,2,1,1,0,1
esercitare,2,5,-3,-1,-1,0,1
manifestare,3,11,8,1,1,0,1
fare,1,4,3,1,1,0,1
riconoscere,5,7,2,1,1,0,1
assicurare,16,8,8,1,-1,0,1
tutelare,2,11,9,1,1,0,1
garantire,2,3,1,1,1,0,1
assicurare,2,2,0,0,-1,1,1
dare,2,10,8,1,1,0,1
rendere,2,17,15,1,1,0,1
tutelare,3,3,0,0,1,0,1
assicurare,5,6,-1,-1,-1,1,1
assicurare,4,7,-3,-1,-1,0,1
tutelare,5,3,-2,-1,1,0,1
stipulare,4,17,13,1,1,0,1
recare,1,10,9,1,1,0,1
determinare,9,16,7,1,1,0,1
imporre,3,5,2,1,1,0,1
disporre,1,6,5,1,1,0,1
favorire,2,5,3,1,1,0,1
assicurare,5,4,1,1,-1,0,1
rivolgere,1,3,2,1,1,0,1
parificare,7,3,4,1,-1,0,1
adempiere,1,4,3,1,1,1,1
prestare,1,7,6,1,1,0,1
nominare,7,11,4,1,1,0,1
eleggere,7,4,3,1,-1,0,1
adottare,3,7,4,1,1,0,1
esercitare,3,4,1,1,1,0,1
sottoporre,5,14,9,1,1,0,1
esercitare,5,15,10,1,1,0,1
stabilire,2,12,10,1,1,0,1
adottare,6,4,2,1,-1,0,1
regolare,12,2,10,1,-1,0,1
conferire,3,3,0,0,-1,0,1
autorizzare,32,2,30,1,-1,0,1
nominare,13,4,9,1,-1,0,1
avere,1,11,10,1,1,0,1
convocare,6,3,3,1,-1,0,1
indire,9,3,-6,-1,1,0,1
inviare,1,3,2,1,1,0,1
indire,3,7,4,1,1,0,1
nominare,5,7,-2,-1,-1,0,1
esercitare,2,9,7,1,1,0,1
revocare,2,8,6,1,1,0,1
conseguire,1,4,3,1,1,0,1
stabilire,11,24,13,1,1,0,1
assicurare,11,5,-6,-1,1,0,1
avere,1,12,11,1,1,0,1
eleggere,3,7,4,1,1,0,1
ammettere,7,8,1,1,1,0,1
annullare,6,12,6,1,1,0,1
avere,2,246,244,1,1,0,1
disciplinare,8,4,-4,-1,1,0,1
avere,2,17,15,1,1,0,1
impedire,10,7,-3,-1,1,0,1
concludere,12,13,1,1,1,0,1
disciplinare,7,19,12,1,1,0,1
disciplinare,5,10,5,1,1,0,1
favorire,17,8,-9,-1,1,0,1
applicare,4,20,16,1,1,0,1
effettuare,2,10,8,1,1,0,1
ostacolare,13,3,10,1,-1,0,1
limitare,8,7,-1,-1,1,0,1
fare,3,3,0,0,1,0,1
eleggere,7,4,3,1,-1,0,1
istituire,2,4,-2,-1,-1,0,1
implicare,1,7,6,1,1,0,1
avere,1,8,7,1,1,0,1
regolare,10,7,3,1,-1,0,1
trarre,3,10,7,1,1,-1,1
adeguare,3,16,13,1,1,0,1
distorcere,2,3,1,1,1,0,1
presentare,3,8,5,1,1,0,1
istituire,20,24,4,1,1,0,1
mantenere,2,12,10,1,1,0,1
introdurre,14,20,6,1,1,0,1
fare,1,35,34,1,1,1,1
informare,2,16,14,1,1,0,1
ridurre,6,9,3,1,1,0,1
dare,1,21,20,1,1,0,1
prendere,15,2,13,1,-1,0,1
mettere,13,2,11,1,-1,0,1
facilitare,5,3,-2,-1,1,0,1
dare,2,11,9,1,1,0,1
conseguire,2,11,9,1,1,0,1
permettere,2,16,14,1,1,0,1
promuovere,8,13,5,1,1,0,1
tenere,36,4,32,1,-1,0,1
ridurre,6,4,-2,-1,1,0,1
scambiare,12,10,-2,-1,1,0,1
prendere,3,2,1,1,-1,0,1
fissare,11,6,5,1,-1,0,1
definire,10,8,-2,-1,1,0,1
adottare,50,3,47,1,-1,0,1
organizzare,1,4,3,1,1,0,1
porre,2,4,2,1,1,0,1
eliminare,1,3,2,1,1,0,1
evitare,1,3,2,1,1,0,1
affrontare,7,3,4,1,-1,0,1
centralizzare,15,9,-6,-1,1,-1,1
sostituire,12,3,9,1,-1,0,1
determinare,7,10,3,1,1,0,1
applicare,2,4,2,1,1,0,1
fornire,2,6,4,1,1,0,1
estendere,2,19,17,1,1,0,1
fornire,1,4,3,1,1,0,1
conferire,2,12,10,1,1,0,1
introdurre,2,3,1,1,1,0,1
presentare,1,15,14,1,1,0,1
comportare,10,4,6,1,-1,0,1
schiudere,2,3,1,1,1,0,1
regolare,9,7,2,1,-1,1,1
proclamare,3,4,-1,-1,-1,0,1
passare,2,4,2,1,1,0,1
vincere,3,7,4,1,1,0,1
riunire,14,3,11,1,-1,0,1
citare,8,2,6,1,-1,0,1
offrire,7,7,0,0,1,-1,1
sintonizzare,1,4,3,1,1,1,1
ascoltare,10,4,6,1,-1,-1,1
prendere,3,2,1,1,-1,0,1
appoggiare,2,4,2,1,1,-1,1
spingere,4,34,30,1,1,0,1
lasciare,17,3,14,1,-1,-1,1
concludere,2,3,1,1,1,0,1
esibire,4,3,1,1,-1,0,1
riciclare,2,3,1,1,1,0,1
acquistare,7,17,10,1,1,0,1
trasferire,3,2,-1,-1,1,0,1
avere,3,5,2,1,1,0,1
dividere,2,4,-2,-1,-1,0,1
prendere,19,4,15,1,-1,0,1
investire,3,3,0,0,1,0,1
acquistare,2,7,5,1,1,0,1
tenere,3,3,0,0,-1,0,1
lanciare,2,15,13,1,1,0,1
seguire,4,2,2,1,-1,0,1
guidare,7,4,-3,-1,1,0,1
fare,2,13,11,1,1,-1,1
denunciare,2,6,4,1,1,0,1
depositare,2,6,4,1,1,0,1
confessare,6,2,4,1,-1,0,1
ottenere,3,10,-7,-1,-1,1,1
realizzare,2,6,4,1,1,0,1
minacciare,18,5,-13,-1,1,0,1
difendere,16,8,8,1,-1,0,1
mettere,15,2,13,1,-1,0,1
avere,6,5,1,1,-1,0,1
promettere,1,26,25,1,1,0,1
generare,3,10,7,1,1,0,1
annoverare,10,4,6,1,-1,0,1
riesplodere,3,2,-1,-1,1,0,1
garantire,17,3,14,1,-1,0,1
assistere,1,6,5,1,1,0,1
avere,2,3,1,1,1,-1,1
alimentare,2,2,0,0,1,0,1
distogliere,2,6,4,1,1,0,1
sostituire,4,7,3,1,1,0,1
intrattenere,1,5,4,1,1,0,1
passare,2,3,1,1,1,0,1
moderare,13,4,9,1,-1,0,1
chiudere,9,12,3,1,1,0,1
portare,6,4,2,1,-1,0,1
presentare,5,5,0,0,1,0,1
fare,12,6,6,1,-1,0,1
rastrellare,4,5,1,1,1,0,1
attirare,2,5,-3,-1,-1,0,1
ingoiare,7,5,2,1,-1,0,1
mettere,12,2,10,1,-1,0,1
avere,2,2,0,0,-1,0,1
svuotare,2,4,2,1,1,0,1
imporre,3,6,3,1,1,0,1
evitare,2,2,0,0,-1,0,1
tributare,4,3,-1,-1,1,0,1
lavare,23,4,19,1,-1,0,1
tenere,15,6,9,1,-1,0,1
restituire,1,6,5,1,1,0,1
ascoltare,2,4,2,1,1,0,1
impiantare,8,2,6,1,-1,0,1
comportare,6,4,2,1,-1,0,1
localizzare,10,2,8,1,-1,0,1
collegare,1,5,4,1,1,0,1
fare,1,4,3,1,1,0,1
elaborare,5,26,21,1,1,-1,1
pervenire,2,9,7,1,1,0,1
confermare,4,4,0,0,1,0,1
condurre,9,2,7,1,-1,-1,1
avere,27,4,23,1,-1,0,1
mettere,8,5,3,1,-1,0,1
rimettere,24,2,22,1,-1,0,1
mandare,4,2,2,1,-1,0,1
promettere,5,6,1,1,1,0,1
riconoscere,2,2,0,0,1,0,1
orientare,3,16,13,1,1,0,1
affidare,3,2,-1,-1,1,-1,1
mettere,3,2,1,1,-1,0,1
rivedere,5,2,3,1,-1,0,1
prendere,20,2,18,1,-1,0,1
promettere,5,10,-5,-1,-1,0,1
mettere,12,2,10,1,-1,0,1
avere,5,2,3,1,-1,0,1
assestare,3,45,42,1,1,0,1
prendere,12,2,10,1,-1,0,1
versare,2,2,0,0,-1,0,1
presentare,22,4,18,1,-1,0,1
proclamare,9,4,5,1,-1,0,1
usare,2,5,3,1,1,0,1
fronteggiare,2,15,13,1,1,0,1
ottenere,3,6,3,1,1,0,1
sconfiggere,3,3,0,0,1,0,1
prevedere,6,3,-3,-1,1,0,1
salire,2,3,-1,-1,-1,0,1
inventare,20,6,14,1,-1,0,1
ricevere,2,2,0,0,-1,-1,1
eseguire,7,6,1,1,-1,0,1
presentare,3,6,-3,-1,-1,0,1
fare,2,10,8,1,1,0,1
incentivare,12,5,7,1,-1,0,1
innalzare,8,5,-3,-1,1,0,1
alzare,2,13,11,1,1,0,1
raggiungere,2,2,0,0,1,0,1
annunciare,6,2,-4,-1,1,0,1
nascere,3,2,-1,-1,1,0,1
mettere,1,33,32,1,1,0,1
scaraventare,6,24,18,1,1,0,1
mandare,14,5,9,1,-1,0,1
completare,2,4,2,1,1,0,1
considerare,2,4,2,1,1,0,1
tenere,2,6,4,1,1,0,1
sporcare,2,8,6,1,1,0,1
evitare,2,3,1,1,1,0,1
tenere,1,11,10,1,1,0,1
consegnare,5,2,3,1,-1,0,1
vedere,5,3,-2,-1,1,0,1
portare,7,3,4,1,-1,0,1
ripresentare,1,2,1,1,1,1,1
affilare,2,9,7,1,1,0,1
battere,4,2,-2,-1,1,0,1
dedicare,2,3,1,1,1,0,1
mettere,2,2,0,0,-1,0,1
mettere,8,2,6,1,-1,0,1
dare,1,12,11,1,1,0,1
cercare,1,3,2,1,1,0,1
informare,2,2,0,0,-1,0,1
tappezzare,5,6,1,1,1,0,1
avere,2,11,9,1,1,0,1
perdere,1,5,4,1,1,-1,1
avere,13,9,-4,-1,1,0,1
cogliere,5,3,2,1,-1,0,1
elaborare,14,4,10,1,-1,-1,1
comprare,2,9,7,1,1,-1,1
reggere,10,2,8,1,-1,0,1
estrarre,1,3,2,1,1,1,1
vedere,2,4,2,1,1,0,1
richiamare,2,8,6,1,1,0,1
dare,1,11,10,1,1,0,1
vedere,2,3,1,1,1,0,1
vedere,10,3,7,1,-1,0,1
fare,1,3,2,1,1,1,1
portare,7,6,1,1,-1,0,1
dedicare,7,30,23,1,1,0,1
riportare,17,5,12,1,-1,0,1
rinviare,2,2,0,0,-1,0,1
vedere,2,3,-1,-1,-1,0,1
cogliere,23,2,21,1,-1,0,1
discutere,5,6,-1,-1,-1,0,1
dirigere,6,4,-2,-1,1,0,1
conoscere,30,3,27,1,-1,0,1
celebrare,1,10,9,1,1,0,1
guardare,2,7,5,1,1,0,1
vedere,1,4,3,1,1,1,1
cedere,2,44,42,1,1,0,1
fare,2,9,7,1,1,0,1
scatenare,2,5,3,1,1,0,1
avere,1,4,3,1,1,0,1
avere,4,18,14,1,1,1,1
vedere,8,2,6,1,-1,0,1
toccare,1,2,1,1,1,1,1
vedere,2,3,-1,-1,-1,0,1
vedere,12,3,9,1,-1,0,1
indirizzare,3,8,5,1,1,0,1
proiettare,3,7,4,1,1,0,1
esaminare,2,6,-4,-1,-1,0,1
sfruttare,54,3,51,1,-1,0,1
raggiungere,6,4,2,1,-1,0,1
raggiungere,5,4,1,1,-1,0,1
mettere,14,2,12,1,-1,0,1
avere,5,10,5,1,1,0,1
vedere,4,5,-1,-1,-1,0,1
vedere,10,2,8,1,-1,0,1
prendere,1,2,1,1,1,1,1
perdere,2,3,1,1,1,0,1
vedere,2,2,0,0,-1,0,1
dire,1,6,5,1,1,1,1
dimensionare,1,14,13,1,1,1,1
vedere,37,2,35,1,-1,0,1
trascinare,1,2,1,1,1,1,1
tradurre,1,2,1,1,1,1,1
moltiplicare,1,11,10,1,1,1,1
percorrere,3,3,0,0,1,0,1
tenere,1,4,3,1,1,0,1
togliere,1,5,4,1,1,1,1
invocare,13,6,-7,-1,1,0,1
avere,2,2,0,0,-1,0,1
trasferire,5,6,1,1,1,0,1
trovare,2,11,9,1,1,0,1
cantare,4,2,2,1,-1,0,1
esibire,1,10,9,1,1,1,1
vedere,2,3,1,1,1,0,1
invidiare,21,2,19,1,-1,0,1
trovare,2,2,0,0,1,0,1
avere,4,2,-2,-1,1,0,1
lusingare,1,3,2,1,1,1,1
vedere,5,3,2,1,-1,0,1
vedere,3,3,0,0,1,0,1
avere,9,3,-6,-1,1,0,1
portare,2,3,1,1,1,0,1
fare,2,8,6,1,1,0,1
vedere,2,3,1,1,1,0,1
mangiare,1,4,3,1,1,1,1
portare,2,3,1,1,1,0,1
leggere,2,6,4,1,1,-1,1
catalogare,5,4,-1,-1,1,0,1
mandare,1,2,1,1,1,1,1
sentire,2,3,1,1,1,0,1
passare,2,2,0,0,1,0,1
picchiare,2,4,2,1,1,0,1
fare,2,3,1,1,1,0,1
avere,5,2,3,1,-1,0,1
vedere,9,4,5,1,-1,0,1
combinare,8,4,-4,-1,1,0,1
individuare,2,23,21,1,1,0,1
contrarre,2,23,21,1,1,0,1
levare,2,2,0,0,1,-1,1
dare,23,3,20,1,-1,0,1
trovare,12,4,8,1,-1,0,1
pronunciare,4,3,1,1,-1,0,1
collegare,6,9,3,1,1,0,1
travestire,8,6,-2,-1,1,0,1
invadere,6,3,-3,-1,1,0,1
scaricare,5,2,3,1,-1,1,1
chiamare,14,2,12,1,-1,0,1
chiamare,4,2,2,1,-1,0,1
gettare,1,13,12,1,1,0,1
difendere,7,7,0,0,1,0,1
affacciare,2,3,1,1,1,0,1
prendere,2,3,1,1,1,0,1
apprendere,6,43,37,1,1,0,1
ricevere,11,6,5,1,-1,0,1
restaurare,2,5,3,1,1,0,1
eseguire,1,7,6,1,1,0,1
fare,1,3,2,1,1,0,1
scoprire,9,27,18,1,1,0,1
apportare,2,16,14,1,1,0,1
lasciare,2,3,1,1,1,0,1
registrare,3,5,2,1,1,0,1
considerare,1,3,2,1,1,1,1
lasciare,2,3,1,1,1,0,1
avere,3,3,0,0,1,0,1
rilevare,7,2,5,1,-1,0,1
misurare,3,4,1,1,1,0,1
disturbare,2,6,4,1,1,0,1
fornire,5,8,3,1,1,0,1
comunicare,3,17,-14,-1,-1,0,1
localizzare,2,2,0,0,-1,0,1
proporre,2,13,11,1,1,0,1
produrre,3,5,2,1,1,0,1
sostituire,7,3,-4,-1,1,0,1
saturare,2,3,1,1,1,0,1
fornire,2,3,1,1,1,0,1
rilevare,8,3,5,1,-1,0,1
deviare,4,4,0,0,-1,0,1
produrre,2,6,4,1,1,0,1
riempire,2,3,1,1,1,0,1
installare,2,2,0,0,-1,0,1
focalizzare,4,4,0,0,1,0,1
cambiare,4,2,2,1,-1,0,1
disturbare,2,2,0,0,1,0,1
disperdere,3,4,1,1,1,0,1
disperdere,1,5,4,1,1,1,1
individuare,2,3,1,1,1,0,1
rendere,5,3,2,1,-1,0,1
creare,2,4,2,1,1,0,1
riempire,1,3,2,1,1,1,1
coordinare,3,4,1,1,1,0,1
interrompere,3,12,9,1,1,0,1
ritrasmettere,2,4,2,1,1,0,1
trasmettere,3,8,5,1,1,0,1
effettuare,12,9,-3,-1,1,-1,1
inviare,2,4,2,1,1,0,1
multiplexare,1,3,2,1,1,1,1
portare,3,3,0,0,-1,0,1
aprire,7,2,5,1,-1,0,1
inoculare,4,3,1,1,-1,0,1
abbandonare,11,4,7,1,-1,0,1
concentrare,7,5,-2,-1,1,0,1
concentrare,2,4,2,1,1,0,1
assegnare,2,14,12,1,1,0,1
aprire,2,9,7,1,1,0,1
concedere,2,3,1,1,1,0,1
utilizzare,2,4,-2,-1,-1,0,1
comportare,9,11,2,1,1,0,1
riportare,10,4,6,1,-1,0,1
concludere,3,2,-1,-1,1,0,1
intrattenere,2,7,5,1,1,0,1
alternare,7,3,-4,-1,1,0,1
avvisare,2,7,5,1,1,0,1
avere,3,3,0,0,1,0,1
utilizzare,7,11,4,1,1,0,1
spostare,4,4,0,0,1,0,1
distinguere,4,6,2,1,1,-1,1
fare,1,19,18,1,1,0,1
accettare,3,11,8,1,1,0,1
proteggere,2,3,1,1,1,0,1
essere,2,3,1,1,1,0,1
prevedere,7,56,49,1,1,0,1
conferire,19,3,16,1,-1,0,1
aprire,2,5,3,1,1,0,1
negoziare,2,3,-1,-1,-1,0,1
stabilire,8,3,-5,-1,1,0,1
articolare,4,3,-1,-1,1,0,1
emanare,5,14,9,1,1,0,1
istituire,17,6,11,1,-1,0,1
costruire,3,4,-1,-1,-1,0,1
portare,15,2,13,1,-1,0,1
presentare,11,18,7,1,1,0,1
associare,21,4,17,1,-1,0,1
incontrare,3,36,33,1,1,0,1
coinvolgere,16,3,13,1,-1,0,1
raggiungere,7,3,-4,-1,1,0,1
nominare,2,16,14,1,1,0,1
iniziare,12,5,-7,-1,1,0,1
lanciare,4,6,2,1,1,0,1
presentare,3,11,8,1,1,0,1
accentrare,2,3,1,1,1,0,1
portare,3,3,0,0,1,0,1
montare,5,4,-1,-1,1,0,1
investire,2,4,2,1,1,0,1
togliere,4,6,-2,-1,-1,0,1
fare,1,10,9,1,1,0,1
mantenere,2,4,2,1,1,0,1
quantificare,5,3,-2,-1,1,0,1
coinvolgere,3,27,24,1,1,0,1
trasferire,17,12,5,1,-1,0,1
presentare,10,3,7,1,-1,0,1
ricevere,6,6,0,0,1,0,1
avere,13,2,11,1,-1,0,1
assegnare,2,5,3,1,1,0,1
comportare,2,10,8,1,1,0,1
sviluppare,5,27,22,1,1,0,1
vedere,4,22,18,1,1,0,1
legare,2,2,0,0,-1,1,1
separare,3,10,7,1,1,0,1
dare,7,3,4,1,-1,0,1
recuperare,1,7,6,1,1,1,1
provocare,2,6,-4,-1,-1,0,1
produrre,1,19,18,1,1,0,1
passare,2,11,9,1,1,0,1
indicare,9,6,3,1,-1,0,1
stabilire,3,11,8,1,1,0,1
informare,5,8,3,1,1,0,1
prevedere,2,5,3,1,1,0,1
modificare,9,3,6,1,-1,0,1
prendere,3,2,-1,-1,1,0,1
informare,5,4,-1,-1,1,0,1
porre,1,4,3,1,1,0,1
imporre,29,3,26,1,-1,0,1
utilizzare,2,3,1,1,1,0,1
abolire,8,15,7,1,1,0,1
avere,30,7,23,1,-1,1,1
garantire,5,3,2,1,-1,0,1
privare,2,30,28,1,1,0,1
prevedere,2,4,-2,-1,-1,0,1
consegnare,5,15,-10,-1,-1,0,1
rimborsare,43,4,39,1,-1,0,1
adire,7,4,3,1,-1,0,1
applicare,10,8,-2,-1,1,-1,1
comprendere,33,4,29,1,-1,0,1
rilasciare,9,3,6,1,-1,0,1
sorgere,6,5,1,1,-1,0,1
comunicare,20,3,17,1,-1,0,1
trasmettere,9,3,6,1,-1,0,1
apporre,8,3,-5,-1,1,0,1
importare,6,27,21,1,1,0,1
mettere,2,2,0,0,1,0,1
fabbricare,2,12,10,1,1,0,1
mettere,2,2,0,0,-1,0,1
escludere,4,9,-5,-1,-1,0,1
estendere,2,3,1,1,1,0,1
mettere,2,2,0,0,1,0,1
aumentare,7,3,4,1,-1,0,1
prescrivere,25,28,3,1,1,0,1
escludere,9,3,6,1,-1,0,1
introdurre,1,4,3,1,1,0,1
chiedere,6,6,0,0,1,-1,1
proteggere,2,10,8,1,1,0,1
interpretare,2,8,6,1,1,0,1
interpretare,2,8,6,1,1,0,1
sottoporre,1,5,4,1,1,1,1
parlare,1,2,1,1,1,0,1
trasformare,2,2,0,0,1,0,1
liberare,4,3,-1,-1,1,0,1
impacchettare,3,2,-1,-1,1,0,1
prendere,7,2,5,1,-1,0,1
ricevere,12,15,3,1,1,0,1
condannare,5,4,1,1,-1,0,1
vincere,6,3,-3,-1,1,0,1
vincere,3,4,1,1,1,0,1
comprare,5,3,-2,-1,1,0,1
portare,3,2,-1,-1,1,0,1
prendere,2,2,0,0,1,0,1
ricevere,6,3,-3,-1,1,0,1
mettere,3,2,1,1,-1,0,1
incrementare,2,3,1,1,1,0,1
costruire,2,2,0,0,1,0,1
dirigere,4,3,-1,-1,1,0,1
vincere,4,3,-1,-1,1,0,1
vincere,2,2,0,0,1,0,1
avere,1,2,-1,-1,-1,0,1
vincere,6,3,-3,-1,1,0,1
vincere,5,2,-3,-1,1,0,1
invadere,2,3,1,1,1,0,1
visitare,3,3,0,0,1,0,1
vincere,9,8,-1,-1,1,0,1
partecipare,2,3,-1,-1,-1,0,1
recitare,3,4,1,1,1,0,1
vincere,3,3,0,0,1,0,1
vincere,5,3,-2,-1,1,0,1
lasciare,3,2,1,1,-1,0,1
correre,2,5,3,1,1,-1,1
vincere,5,3,-2,-1,1,0,1
vincere,6,3,-3,-1,1,0,1
dire,1,2,1,1,1,0,1
immatricolare,2,4,2,1,1,0,1
vincere,8,4,-4,-1,1,0,1
rubare,2,3,1,1,1,0,1
impersonare,2,3,1,1,1,0,1
avere,6,6,0,0,1,0,1
prestare,1,3,2,1,1,0,1
sganciare,3,2,-1,-1,1,0,1
avere,3,2,-1,-1,1,0,1
vincere,5,5,0,0,1,0,1
staccare,5,2,3,1,-1,0,1
regolamentare,4,6,2,1,1,0,1
cedere,2,3,1,1,1,0,1
dire,1,2,1,1,1,0,1
cantare,3,2,-1,-1,1,0,1
dire,1,2,1,1,1,1,1
porre,1,5,4,1,1,0,1
restituito,10,8,2,1,-1,0,1
registrare,4,6,-2,-1,-1,0,1
assassinare,1,3,2,1,1,1,1
avere,2,3,-1,-1,-1,0,1
causare,2,3,1,1,1,0,1
separare,1,4,3,1,1,0,1
negare,4,3,1,1,-1,0,1
visitare,1,3,2,1,1,0,1
fare,1,3,2,1,1,0,1
lasciare,10,2,8,1,-1,0,1
vincere,4,3,-1,-1,1,0,1
mettere,3,2,1,1,-1,0,1
riaprire,2,3,1,1,1,0,1
puntare,2,17,15,1,1,0,1
accusare,3,3,0,0,1,0,1
processare,2,2,0,0,-1,0,1
sentire,1,2,-1,-1,-1,0,1
chiedere,14,2,12,1,-1,0,1
vietare,2,11,9,1,1,0,1
fare,1,6,5,1,1,0,1
accettare,2,3,1,1,1,0,1
rimandare,1,4,3,1,1,1,1
mandare,6,2,4,1,-1,0,1
riguardare,8,6,-2,-1,1,0,1
intascare,2,6,4,1,1,0,1
trattare,5,3,2,1,-1,0,1
fare,1,3,2,1,1,0,1
avere,10,3,7,1,-1,0,1
concedere,6,29,23,1,1,0,1
limitare,2,3,-1,-1,-1,0,1
sbattere,2,5,3,1,1,-1,1
accompagnare,2,17,15,1,1,0,1
aggiornare,2,7,5,1,1,0,1
esprimere,3,3,0,0,1,0,1
seguire,6,2,4,1,-1,0,1
inviare,7,4,-3,-1,1,0,1
guardare,3,4,1,1,1,0,1
coinvolgere,1,24,23,1,1,1,1
aiutare,1,7,6,1,1,0,1
affrontare,6,2,4,1,-1,0,1
imporre,3,5,2,1,1,0,1
lasciare,2,3,1,1,1,0,1
lasciare,2,13,11,1,1,-1,1
acquisire,18,2,16,1,-1,0,1
versare,16,2,14,1,-1,0,1
concordare,4,43,39,1,1,0,1
dedicare,10,29,19,1,1,0,1
lasciare,3,5,2,1,1,0,1
esprimere,18,3,15,1,-1,0,1
intendere,42,4,38,1,-1,0,1
offrire,2,10,8,1,1,0,1
concedere,33,2,31,1,-1,1,1
restringere,9,10,1,1,1,0,1
concedere,2,2,0,0,1,0,1
usare,16,10,-6,-1,1,0,1
creare,4,5,1,1,1,0,1
riconoscere,13,4,9,1,-1,0,1
menzionare,5,3,-2,-1,1,0,1
rilasciare,2,10,8,1,1,0,1
cessare,5,3,-2,-1,1,0,1
recitare,7,3,4,1,-1,0,1
recitare,2,3,-1,-1,-1,0,1
trovare,1,11,10,1,1,0,1
utilizzare,15,8,-7,-1,1,0,1
osservare,4,21,17,1,1,0,1
inviare,2,7,5,1,1,0,1
sollevare,5,13,8,1,1,0,1
richiamare,2,15,13,1,1,0,1
prendere,12,2,10,1,-1,0,1
sostenere,11,4,7,1,-1,0,1
fare,3,2,1,1,-1,1,1
sottoporre,2,6,4,1,1,0,1
ottenere,1,4,3,1,1,0,1
esprimere,3,41,38,1,1,0,1
trarre,1,5,4,1,1,0,1
votare,6,2,-4,-1,1,0,1
spiegare,1,3,2,1,1,1,1
divulgare,2,4,2,1,1,0,1
presentare,2,2,0,0,1,-1,1
avere,4,12,8,1,1,0,1
discutere,3,2,-1,-1,1,0,1
esercitare,4,6,2,1,1,0,1
conoscere,2,2,0,0,-1,0,1
discutere,44,2,42,1,-1,0,1
fare,2,4,2,1,1,0,1
mantenere,10,6,4,1,-1,0,1
porre,8,2,6,1,-1,0,1
respingere,2,9,7,1,1,0,1
ringraziare,3,11,8,1,1,0,1
chiudere,2,6,4,1,1,0,1
rilasciare,4,6,2,1,1,0,1
assicurare,3,6,3,1,1,0,1
denunciare,2,3,1,1,1,0,1
colmare,3,5,2,1,1,0,1
chiudere,2,22,20,1,1,0,1
ringraziare,3,45,42,1,1,0,1
accogliere,1,11,10,1,1,0,1
dedicare,1,3,2,1,1,0,1
contenere,2,2,0,0,-1,0,1
integrare,2,9,7,1,1,0,1
dare,2,17,15,1,1,0,1
presentare,6,7,1,1,1,0,1
porre,8,2,6,1,-1,0,1
fornire,3,9,6,1,1,0,1
garantire,5,3,-2,-1,1,0,1
rivestire,2,8,6,1,1,0,1
favorire,3,3,0,0,1,0,1
ringraziare,3,4,1,1,1,0,1
migliorare,1,2,1,1,1,0,1
considerare,2,6,4,1,1,0,1
tenere,17,3,14,1,-1,0,1
dedicare,1,9,8,1,1,1,1
comportare,1,7,6,1,1,0,1
modificare,5,15,10,1,1,0,1
disciplinare,2,4,2,1,1,0,1
fare,4,8,4,1,1,0,1
stabilire,3,4,1,1,1,0,1
modificare,4,7,3,1,1,0,1
ridurre,2,4,2,1,1,0,1
contemplare,4,2,2,1,-1,1,1
riconoscere,17,6,11,1,-1,0,1
concludere,18,4,14,1,-1,0,1
menzionare,12,18,6,1,1,0,1
ottenere,8,10,2,1,1,0,1
mettere,13,2,11,1,-1,-1,1
garantire,3,4,1,1,1,0,1
esigere,11,4,7,1,-1,0,1
analizzare,1,5,4,1,1,1,1
inserire,62,3,59,1,-1,0,1
potenziare,5,9,4,1,1,0,1
tenere,18,2,16,1,-1,0,1
dedicare,2,3,1,1,1,0,1
vedere,9,14,5,1,1,0,1
attirare,3,32,29,1,1,0,1
dare,2,16,14,1,1,0,1
porre,18,3,15,1,-1,0,1
abbandonare,3,32,29,1,1,0,1
trovare,2,8,6,1,1,0,1
costituire,2,14,12,1,1,0,1
ringraziare,4,8,4,1,1,0,1
trovare,3,25,22,1,1,0,1
stabilire,1,12,11,1,1,0,1
ricordare,17,6,11,1,-1,0,1
presentare,2,6,4,1,1,0,1
identificare,16,44,28,1,1,0,1
fornire,1,13,12,1,1,0,1
sfruttare,9,3,6,1,-1,0,1
imprimere,4,7,3,1,1,0,1
rimettere,1,2,1,1,1,1,1
attirare,2,11,9,1,1,0,1
giudicare,6,2,-4,-1,1,0,1
ribadire,19,12,-7,-1,1,0,1
tenere,6,2,4,1,-1,0,1
produrre,3,4,1,1,1,0,1
seguire,2,3,1,1,1,0,1
creare,1,8,7,1,1,0,1
prendere,6,3,3,1,-1,0,1
discutere,1,3,-2,-1,-1,0,1
prendere,1,6,5,1,1,0,1
attribuire,2,16,14,1,1,0,1
svolgere,3,10,7,1,1,0,1
assistere,3,4,1,1,1,0,1
abbandonare,2,3,1,1,1,0,1
prendere,3,2,1,1,-1,0,1
conferire,7,4,3,1,-1,0,1
porre,1,9,8,1,1,0,1
ridare,19,3,16,1,-1,0,1
utilizzare,14,3,11,1,-1,0,1
dare,2,5,3,1,1,0,1
avere,1,32,31,1,1,0,1
riaffermare,32,3,29,1,-1,0,1
promuovere,9,4,-5,-1,1,0,1
perseguire,15,6,9,1,-1,0,1
proclamare,8,90,82,1,1,0,1
promuovere,9,6,3,1,-1,0,1
godere,4,3,1,1,-1,0,1
manifestare,7,16,9,1,1,0,1
diffondere,3,8,5,1,1,0,1
avere,1,49,48,1,1,0,1
comprendere,12,2,10,1,-1,1,1
garantire,11,23,12,1,1,0,1
favorire,6,6,0,0,1,0,1
soddisfare,15,4,-11,-1,1,0,1
rendere,5,2,-3,-1,1,0,1
acquistare,1,4,3,1,1,0,1
registrare,1,2,1,1,1,1,1
condividere,3,3,0,0,1,-1,1
vedere,8,4,-4,-1,1,0,1
ricevere,6,3,-3,-1,1,0,1
iscrivere,1,2,1,1,1,1,1
aggiungere,3,5,2,1,1,0,1
ricevere,2,2,0,0,1,0,1
ricevere,1,4,3,1,1,0,1
ottenere,1,3,2,1,1,1,1
effettuare,6,4,-2,-1,1,0,1
inserire,7,14,7,1,1,0,1
aggiungere,4,4,0,0,1,0,1
impostare,9,6,-3,-1,1,0,1
aggiungere,4,4,0,0,1,0,1
rivelare,4,2,2,1,-1,1,1
migliorare,7,8,1,1,1,0,1
connettere,1,7,6,1,1,1,1
scegliere,3,8,5,1,1,0,1
costruire,2,5,3,1,1,0,1
tenere,2,2,0,0,-1,0,1
modificare,3,3,0,0,1,0,1
raggiungere,3,4,1,1,1,0,1
rappresentare,7,3,4,1,-1,0,1
connettere,1,10,9,1,1,1,1
gestire,3,3,0,0,-1,0,1
avere,6,2,4,1,-1,0,1
ottenere,13,2,11,1,-1,0,1
ricevere,4,5,1,1,1,0,1
limitare,2,4,2,1,1,0,1
riservare,3,6,3,1,1,-1,1
avere,3,4,1,1,1,0,1
visualizzare,4,5,1,1,1,0,1
causare,2,7,5,1,1,0,1
avere,1,6,5,1,1,0,1
fare,1,4,3,1,1,0,1
interrompere,2,5,3,1,1,0,1
cambiare,3,7,4,1,1,-1,1
aggiungere,4,4,0,0,-1,0,1
svolgere,3,3,0,0,1,0,1
trascorrere,2,2,0,0,1,0,1
mandare,2,3,1,1,1,0,1
dare,2,3,1,1,1,0,1
scortare,1,3,2,1,1,1,1
provare,3,10,7,1,1,0,1
leggere,2,5,3,1,1,0,1
attribuire,3,4,1,1,1,0,1
riformare,5,7,2,1,1,1,1
seguire,3,2,-1,-1,1,0,1
creare,3,4,1,1,1,0,1
leggere,3,4,1,1,1,0,1
dissuadere,1,8,7,1,1,1,1
produrre,3,35,32,1,1,0,1
cercare,10,2,8,1,-1,0,1
scrivere,2,11,9,1,1,0,1
fondare,3,5,2,1,1,0,1
causare,3,3,0,0,1,0,1
trarre,1,17,16,1,1,0,1
avere,2,3,1,1,1,0,1
sostenere,5,3,-2,-1,1,0,1
dare,2,3,1,1,1,0,1
trasporre,5,6,-1,-1,-1,0,1
rivedere,3,3,0,0,1,0,1
ricoprire,4,6,2,1,1,0,1
ripetere,2,6,4,1,1,0,1
causare,2,8,6,1,1,-1,1
trascorrere,1,8,7,1,1,0,1
trascorrere,3,31,28,1,1,0,1
esprimere,1,19,18,1,1,0,1
trovare,11,13,2,1,1,0,1
spingere,1,3,2,1,1,1,1
avere,2,8,6,1,1,0,1
ricevere,2,20,18,1,1,0,1
includere,1,7,6,1,1,-1,1
costruire,3,5,2,1,1,0,1
dare,1,3,2,1,1,0,1
vedere,2,4,2,1,1,0,1
dare,4,4,0,0,1,0,1
bilanciare,5,7,2,1,1,0,1
pervadere,2,5,3,1,1,0,1
aprire,2,7,5,1,1,0,1
utilizzare,13,8,-5,-1,1,0,1
trarre,15,2,13,1,-1,0,1
preferire,1,2,1,1,1,0,1
rappresentare,5,3,2,1,-1,0,1
adorare,1,9,8,1,1,0,1
dare,10,3,7,1,-1,0,1
scrivere,3,3,0,0,1,-1,1
confermare,2,9,7,1,1,0,1
creare,3,5,2,1,1,0,1
avere,2,7,5,1,1,0,1
paragonare,1,14,13,1,1,1,1
identificare,1,5,4,1,1,0,1
ottenere,3,6,3,1,1,0,1
cambiare,3,5,2,1,1,0,1
sapere,2,2,0,0,-1,0,1
interpretare,2,5,3,1,1,0,1
comprare,5,2,3,1,-1,0,1
trascorrere,2,7,5,1,1,0,1
sposare,4,3,-1,-1,1,0,1
avere,3,8,5,1,1,0,1
causare,4,4,0,0,1,0,1
lasciare,3,6,3,1,1,0,1
passare,3,11,8,1,1,0,1
dare,2,3,-1,-1,-1,0,1
porre,1,7,6,1,1,0,1
vedere,2,5,3,1,1,0,1
fare,2,12,10,1,1,1,1
avere,1,4,3,1,1,0,1
mettere,6,2,4,1,-1,0,1
introdurre,4,20,16,1,1,0,1
alimentare,5,14,9,1,1,0,1
dare,1,31,30,1,1,0,1
offrire,5,9,-4,-1,-1,0,1
aggiungere,3,4,-1,-1,-1,0,1
portare,4,2,2,1,-1,0,1
vedere,4,15,11,1,1,0,1
avere,2,2,0,0,-1,0,1
instaurare,3,4,1,1,1,0,1
individuare,9,3,6,1,-1,0,1
fare,5,8,3,1,1,0,1
avere,3,2,1,1,-1,0,1
valutare,2,16,14,1,1,0,1
adattare,3,4,1,1,1,0,1
calibrare,7,7,0,0,1,0,1
donare,4,10,6,1,1,0,1
descrivere,3,16,13,1,1,0,1
contrapporre,2,3,1,1,1,0,1
combinare,3,7,4,1,1,0,1
mostrare,7,3,4,1,-1,0,1
dare,10,4,6,1,-1,0,1
conservare,6,5,-1,-1,1,0,1
lasciare,3,7,4,1,1,0,1
rivivere,6,4,-2,-1,1,0,1
descrivere,9,7,-2,-1,1,0,1
dovere,1,2,1,1,1,1,1
tradurre,1,2,1,1,1,0,1
sottolineare,5,4,1,1,-1,-1,1
condannare,1,7,6,1,1,0,1
avere,3,2,-1,-1,1,0,1
tradurre,3,7,4,1,1,0,1
attribuire,3,6,3,1,1,0,1
considerare,1,7,6,1,1,1,1
interpretare,3,13,10,1,1,0,1
dare,3,4,1,1,1,0,1
rendere,4,5,1,1,1,0,1
rilasciare,5,7,2,1,1,0,1
fare,1,3,2,1,1,0,1
imbottire,5,6,1,1,1,0,1
mettere,1,2,1,1,1,1,1
ingerire,2,3,1,1,1,0,1
pompare,5,4,1,1,-1,0,1
cedere,2,3,1,1,1,0,1
apprezzare,6,3,-3,-1,1,0,1
proteggere,3,7,4,1,1,0,1
sostenere,6,4,-2,-1,1,0,1
investire,5,6,1,1,1,0,1
assillare,2,5,3,1,1,0,1
portare,20,2,18,1,-1,0,1
creare,8,10,2,1,1,-1,1
vedere,14,3,11,1,-1,0,1
fornire,3,7,-4,-1,-1,0,1
incoraggiare,2,3,-1,-1,-1,0,1
trasformare,6,13,7,1,1,0,1
spianare,2,4,2,1,1,0,1
fissare,3,5,2,1,1,0,1
avere,5,9,4,1,1,-1,1
sorprendere,2,10,8,1,1,0,1
sostenere,1,3,2,1,1,1,1
imporre,3,9,6,1,1,0,1
sviluppare,9,24,15,1,1,0,1
mostrare,1,6,5,1,1,0,1
fornire,1,4,3,1,1,0,1
lanciare,3,6,3,1,1,0,1
superare,4,3,1,1,-1,0,1
dimostrare,3,27,24,1,1,0,1
salvare,2,4,2,1,1,0,1
sostenere,8,4,-4,-1,1,0,1
integrare,3,6,3,1,1,0,1
richiedere,6,16,10,1,1,0,1
scoraggiare,4,4,0,0,1,0,1
sviluppare,4,13,9,1,1,0,1
offrire,2,6,4,1,1,0,1
combinare,1,8,7,1,1,1,1
aprire,4,17,13,1,1,0,1
aumentare,5,4,-1,-1,1,0,1
ricostruire,2,5,3,1,1,0,1
causare,2,19,17,1,1,0,1
mantenere,2,4,2,1,1,0,1
cedere,2,6,4,1,1,0,1
ricordare,17,3,14,1,-1,-1,1
offrire,3,5,2,1,1,0,1
avere,4,8,4,1,1,1,1
affondare,2,19,17,1,1,0,1
erogare,1,4,3,1,1,0,1
ricevere,1,26,25,1,1,0,1
crescere,8,10,2,1,1,0,1
sentire,3,5,2,1,1,0,1
lasciare,4,2,2,1,-1,0,1
invidiare,3,21,18,1,1,0,1
esacerbare,7,6,-1,-1,1,0,1
porre,2,7,5,1,1,0,1
fare,1,3,2,1,1,1,1
ridurre,5,6,1,1,1,-1,1
consentire,6,5,-1,-1,1,0,1
attirare,6,4,-2,-1,1,0,1
lasciare,9,2,7,1,-1,0,1
rispecchiare,10,3,7,1,-1,0,1
valutare,40,3,37,1,-1,0,1
confrontare,2,27,25,1,1,-1,1
iniziare,2,6,4,1,1,0,1
sostenere,3,13,10,1,1,0,1
offrire,8,4,-4,-1,1,0,1
attingere,1,4,3,1,1,0,1
dovere,1,15,14,1,1,1,1
promuovere,8,21,13,1,1,0,1
fondare,3,6,3,1,1,0,1
creare,4,3,-1,-1,1,0,1
offrire,1,12,11,1,1,0,1
lasciare,18,5,13,1,-1,0,1
offrire,12,5,7,1,-1,0,1
coltivare,4,10,6,1,1,0,1
portare,16,2,14,1,-1,0,1
ridurre,2,5,3,1,1,0,1
offrire,16,4,12,1,-1,0,1
trasformare,5,6,1,1,1,0,1
dichiarare,2,12,10,1,1,0,1
trascorrere,1,4,3,1,1,0,1
dedicare,2,4,2,1,1,0,1
avere,10,2,8,1,-1,0,1
fare,3,12,9,1,1,0,1
sfruttare,2,3,-1,-1,-1,0,1
comportare,8,16,8,1,1,0,1
dedicare,2,3,1,1,1,0,1
riconoscere,10,4,6,1,-1,0,1
considerare,5,2,-3,-1,1,0,1
riportare,9,7,-2,-1,1,0,1
sollevare,2,13,11,1,1,0,1
rendere,6,8,2,1,1,0,1
promuovere,7,3,-4,-1,1,0,1
ricostruire,2,5,3,1,1,0,1
promuovere,2,2,0,0,1,0,1
legare,5,16,11,1,1,0,1
tenere,26,2,24,1,-1,0,1
fiaccare,2,6,4,1,1,0,1
considerare,2,8,6,1,1,0,1
spostare,2,4,2,1,1,0,1
manipolare,2,7,5,1,1,0,1
funzionare,2,4,2,1,1,0,1
impiegare,7,3,-4,-1,1,0,1
trasformare,1,3,2,1,1,1,1
armare,1,5,4,1,1,0,1
negoziare,7,24,17,1,1,0,1
incrementare,5,8,3,1,1,0,1
ammassare,3,3,0,0,1,-1,1
risolvere,2,5,3,1,1,0,1
assoggettare,4,4,0,0,1,0,1
incorporare,8,4,-4,-1,1,0,1
porre,1,14,13,1,1,0,1
avere,5,6,1,1,1,0,1
condurre,5,9,4,1,1,0,1
condurre,2,7,5,1,1,0,1
lanciare,2,5,3,1,1,0,1
controllare,1,23,22,1,1,1,1
mettere,9,2,7,1,-1,0,1
vedere,2,9,7,1,1,0,1
consacrare,2,4,2,1,1,0,1
evitare,6,17,11,1,1,0,1
dare,1,5,4,1,1,0,1
passare,3,6,3,1,1,0,1
portare,23,2,21,1,-1,0,1
smettere,1,7,6,1,1,1,1
esplodere,8,7,-1,-1,1,0,1
mettere,7,5,-2,-1,1,0,1
togliere,2,5,3,1,1,0,1
mettere,2,3,1,1,1,0,1
togliere,2,3,1,1,1,0,1
verso,4,3,-1,-1,1,0,1
mettere,4,9,5,1,1,0,1
disporre,2,3,1,1,1,0,1
dedicare,3,6,3,1,1,0,1
fondare,4,6,2,1,1,0,1
scrivere,8,3,5,1,-1,0,1
mettere,10,6,4,1,-1,0,1
dare,2,4,2,1,1,0,1
sostituire,5,4,-1,-1,1,0,1
conservare,5,3,2,1,-1,0,1
funzionare,2,3,1,1,1,0,1
riempire,5,3,2,1,-1,0,1
spendere,2,19,17,1,1,0,1
dedicare,6,12,6,1,1,0,1
vedere,7,3,4,1,-1,0,1
mettere,1,3,2,1,1,1,1
divertire,1,3,2,1,1,0,1
cercare,1,7,6,1,1,0,1
liberare,1,4,3,1,1,1,1
ritrovare,1,14,13,1,1,0,1
stringere,2,4,2,1,1,0,1
presentare,5,4,-1,-1,1,0,1
realizzare,1,4,3,1,1,0,1
seguire,5,2,3,1,-1,0,1
proteggere,2,9,7,1,1,0,1
mettere,2,3,1,1,1,0,1
lavare,2,4,2,1,1,0,1
asciugare,2,3,1,1,1,0,1
comprare,2,5,3,1,1,0,1
usare,2,3,1,1,1,0,1
versare,2,3,1,1,1,0,1
consegnare,4,6,-2,-1,-1,0,1
collegare,1,5,4,1,1,1,1
tagliare,1,2,1,1,1,1,1
mettere,9,3,6,1,-1,0,1
frullare,1,5,4,1,1,1,1
mettere,19,3,16,1,-1,0,1
frullare,1,5,4,1,1,1,1
pubblicare,1,2,1,1,1,0,1
leggere,4,3,-1,-1,1,0,1
vedere,3,3,0,0,-1,0,1
scegliere,2,2,0,0,1,0,1
scegliere,2,2,0,0,-1,0,1
fare,2,5,3,1,1,0,1
soffrire,2,4,2,1,1,0,1
cantare,5,6,1,1,1,0,1
giocare,2,4,2,1,1,0,1
prendere,2,14,12,1,1,0,1
assegnare,3,14,11,1,1,0,1
togliere,2,3,-1,-1,-1,0,1
accettare,2,4,2,1,1,0,1
prendere,1,6,5,1,1,0,1
dare,3,6,3,1,1,0,1
portare,6,7,1,1,1,0,1
vincere,6,17,11,1,1,0,1
dipingere,2,3,-1,-1,-1,0,1
dare,2,3,1,1,1,0,1
fare,2,4,2,1,1,0,1
vincere,2,6,4,1,1,0,1
avere,3,4,1,1,1,0,1
togliere,4,3,1,1,-1,0,1
comprare,3,7,4,1,1,0,1
uccidere,11,3,8,1,-1,0,1
dichiarare,1,3,2,1,1,0,1
risolvere,2,4,2,1,1,0,1
studiare,3,6,3,1,1,0,1
incontrare,2,12,10,1,1,0,1
vincere,3,4,1,1,1,0,1
vincere,2,4,2,1,1,0,1
tenere,2,3,1,1,1,0,1
mettere,5,3,-2,-1,1,0,1
trattenere,5,3,2,1,-1,0,1
uscire,2,3,1,1,1,0,1
rompere,2,3,1,1,1,0,1
danneggiare,5,5,0,0,1,0,1
pulire,5,8,3,1,1,0,1
spruzzare,10,8,2,1,-1,0,1
comprare,2,8,6,1,1,0,1
mettere,6,3,-3,-1,1,0,1
appoggiare,6,5,-1,-1,1,0,1
scorrere,2,3,1,1,1,0,1
prendere,2,3,1,1,1,0,1
coprire,2,3,1,1,1,0,1
proteggere,2,6,4,1,1,0,1
spalmare,4,8,4,1,1,0,1
proteggere,2,6,4,1,1,0,1
passare,6,3,3,1,-1,0,1
spalmare,6,3,3,1,-1,0,1
riparare,6,3,3,1,-1,0,1
portare,3,2,1,1,-1,0,1
mettere,1,3,2,1,1,1,1
proteggere,8,3,5,1,-1,0,1
ricoprire,5,9,4,1,1,0,1
fermare,1,4,3,1,1,1,1
chiudere,4,3,-1,-1,1,0,1
consigliare,10,2,8,1,-1,0,1
stendere,4,3,-1,-1,1,0,1
versare,6,3,3,1,-1,0,1
immergere,4,5,1,1,1,0,1
appoggiare,6,3,3,1,-1,0,1
stampare,2,4,2,1,1,0,1
dipingere,3,4,1,1,1,0,1
asciugare,2,3,1,1,1,0,1
registrare,15,7,8,1,-1,0,1
lavare,2,4,2,1,1,0,1
girare,1,4,3,1,1,1,1
coprire,2,3,1,1,1,0,1
cuocere,2,3,1,1,1,0,1
regalare,1,4,3,1,1,1,1
scegliere,2,6,4,1,1,0,1
mettere,2,2,0,0,-1,0,1
stare,2,4,2,1,1,0,1
fare,2,11,9,1,1,0,1
prendere,8,4,4,1,-1,0,1
ritirare,3,3,0,0,1,0,1
uccidere,3,4,1,1,1,0,1
usare,2,2,0,0,1,0,1
fare,4,2,-2,-1,1,0,1
prendere,2,6,4,1,1,0,1
esplodere,5,11,6,1,1,0,1
esplodere,5,10,5,1,1,0,1
lanciare,2,10,8,1,1,0,1
avere,2,2,0,0,-1,0,1
avere,7,2,5,1,-1,0,1
dare,4,6,2,1,1,0,1
riparare,1,3,2,1,1,1,1
dedicare,1,4,3,1,1,1,1
fare,6,5,-1,-1,1,0,1
tritare,2,3,1,1,1,0,1
tagliare,2,6,4,1,1,0,1
mettere,2,3,1,1,1,0,1
rimettere,4,6,2,1,1,0,1
mettere,4,3,-1,-1,1,0,1
giocare,4,5,1,1,1,0,1
firmare,3,2,-1,-1,1,0,1
firmare,2,2,0,0,1,0,1
passare,3,4,1,1,1,0,1
togliere,3,3,0,0,1,0,1
unire,1,4,3,1,1,1,1
ricevere,6,8,2,1,1,0,1
ricevere,6,7,1,1,1,0,1
portare,4,2,-2,-1,1,-1,1
mettere,2,3,1,1,1,0,1
controllare,2,5,3,1,1,0,1
pubblicare,4,3,-1,-1,1,0,1
diffondere,5,3,-2,-1,1,0,1
usare,2,3,1,1,1,0,1
portare,2,7,5,1,1,0,1
premiare,4,5,1,1,1,0,1
ricevere,2,3,1,1,1,0,1
dedicare,2,7,5,1,1,0,1
ricevere,5,4,-1,-1,1,0,1
dare,6,5,-1,-1,1,0,1
dare,6,5,-1,-1,1,0,1
fare,11,11,0,0,1,0,1
avere,6,7,1,1,1,0,1
seguire,5,3,-2,-1,1,0,1
sommare,10,12,2,1,1,0,1
avere,2,2,0,0,-1,0,1
formare,7,2,5,1,-1,0,1
vedere,2,9,7,1,1,0,1
vincere,3,8,5,1,1,0,1
seguire,6,2,-4,-1,1,0,1
percorrere,3,9,6,1,1,0,1
trovare,2,6,4,1,1,0,1
pagare,1,3,2,1,1,0,1
pagare,2,8,6,1,1,0,1
pagare,2,7,5,1,1,0,1
pagare,4,7,3,1,1,0,1
accompagnare,2,2,0,0,1,0,1
dedicare,9,6,-3,-1,1,0,1
dedicare,5,6,1,1,1,0,1
ricordare,2,6,4,1,1,0,1
percorrere,7,2,5,1,-1,0,1
percorrere,3,6,3,1,1,0,1
percorrere,3,6,3,1,1,0,1
guadagnare,1,6,5,1,1,0,1
affrontare,2,6,4,1,1,0,1
produrre,3,2,1,1,-1,0,1
dare,1,14,13,1,1,0,1
pagare,2,6,4,1,1,0,1
aiutare,4,6,2,1,1,0,1
dare,1,4,3,1,1,0,1
aiutare,2,13,11,1,1,0,1
succhiare,2,13,11,1,1,0,1
trasportare,2,3,1,1,1,0,1
trasformare,2,2,0,0,1,0,1
ricavare,2,7,5,1,1,0,1
vincere,6,6,0,0,1,0,1
comprare,2,7,5,1,1,0,1
fare,2,3,1,1,1,0,1
correre,3,2,-1,-1,1,0,1
correre,3,2,-1,-1,1,0,1
correre,9,2,-7,-1,1,0,1
mettere,3,6,-3,-1,-1,0,1
dare,3,5,2,1,1,0,1
iniziare,11,6,5,1,-1,0,1
raccogliere,7,9,2,1,1,0,1
svolgere,3,4,1,1,1,0,1
perso,2,3,1,1,1,0,1
dare,10,3,7,1,-1,0,1
usare,2,3,1,1,1,0,1
comprare,6,5,1,1,-1,0,1
mettere,3,2,1,1,-1,0,1
fare,1,4,3,1,1,0,1
suonare,2,7,5,1,1,0,1
suonare,2,6,4,1,1,0,1
scrivere,2,4,2,1,1,0,1
scrivere,1,2,1,1,1,1,1
fare,2,7,5,1,1,0,1
mettere,4,2,2,1,-1,0,1
fare,2,8,6,1,1,0,1
fare,2,7,5,1,1,0,1
fare,4,3,-1,-1,1,0,1
analizzare,11,4,7,1,-1,0,1
finire,3,3,0,0,1,0,1
coinvolgere,6,3,3,1,-1,0,1
affrontare,11,2,9,1,-1,0,1
aiutare,2,4,2,1,1,0,1
aiutare,2,2,0,0,1,0,1
cancellare,6,5,1,1,-1,1,1
cambiare,2,5,3,1,1,0,1
verificare,5,4,-1,-1,1,0,1
assegnare,2,6,4,1,1,0,1
comunicare,2,3,1,1,1,0,1
comunicare,1,3,2,1,1,0,1
inquinare,5,8,3,1,1,0,1
ricostruire,7,3,-4,-1,1,0,1
concedere,33,2,31,1,-1,1,1
restringere,9,10,1,1,1,0,1
concedere,2,2,0,0,1,0,1
usare,16,10,-6,-1,1,0,1
creare,4,5,1,1,1,0,1
usare,16,10,-6,-1,1,0,1
rilasciare,2,10,8,1,1,0,1
cessare,5,3,-2,-1,1,0,1
recitare,7,3,4,1,-1,0,1
recitare,3,3,0,0,-1,0,1
utilizzare,15,8,-7,-1,1,0,1
osservare,4,21,17,1,1,0,1
alzare,1,2,1,1,1,1,1
inviare,2,7,5,1,1,0,1
fare,4,14,10,1,1,1,1
sollevare,5,13,8,1,1,0,1
richiamare,2,15,13,1,1,0,1
fare,3,2,1,1,-1,1,1
sottoporre,2,6,4,1,1,0,1
ottenere,1,4,3,1,1,0,1
riguardare,7,4,-3,-1,1,0,1
esprimere,3,41,38,1,1,0,1
trarre,1,5,4,1,1,0,1
votare,6,2,-4,-1,1,0,1
spiegare,1,3,2,1,1,1,1
fare,2,4,2,1,1,0,1
porre,23,2,21,1,-1,0,1
respingere,2,9,7,1,1,0,1
ringraziare,3,11,8,1,1,0,1
chiudere,2,6,4,1,1,0,1
rilasciare,4,6,2,1,1,0,1
assicurare,3,6,3,1,1,0,1
colmare,3,5,2,1,1,0,1
chiudere,2,22,20,1,1,0,1
ringraziare,3,45,42,1,1,0,1
accogliere,1,11,10,1,1,0,1
ringraziare,2,13,11,1,1,0,1
contenere,2,2,0,0,-1,0,1
integrare,2,9,7,1,1,0,1
dare,2,17,15,1,1,0,1
presentare,6,7,1,1,1,0,1
porre,8,2,6,1,-1,0,1
fornire,3,9,6,1,1,0,1
garantire,5,3,-2,-1,1,0,1
favorire,3,3,0,0,1,0,1
ringraziare,3,4,1,1,1,0,1
migliorare,1,2,1,1,1,0,1
considerare,2,6,4,1,1,0,1
tenere,17,3,14,1,-1,0,1
dedicare,1,9,8,1,1,1,1
comportare,1,7,6,1,1,0,1
modificare,5,15,10,1,1,0,1
disciplinare,2,4,2,1,1,0,1
fare,4,8,4,1,1,0,1
ridurre,2,4,2,1,1,0,1
tenere,1,15,14,1,1,0,1
riconoscere,17,6,11,1,-1,0,1
concludere,18,4,14,1,-1,0,1
ottenere,8,10,2,1,1,0,1
mettere,13,2,11,1,-1,-1,1
garantire,3,4,1,1,1,0,1
esigere,11,4,7,1,-1,0,1
analizzare,1,5,4,1,1,1,1
inserire,62,3,59,1,-1,0,1
potenziare,5,9,4,1,1,0,1
vedere,9,14,5,1,1,0,1
attirare,3,32,29,1,1,0,1
porre,18,3,15,1,-1,0,1
abbandonare,3,32,29,1,1,0,1
trovare,2,8,6,1,1,0,1
costituire,2,14,12,1,1,0,1
ringraziare,4,8,4,1,1,0,1
trovare,3,25,22,1,1,0,1
stabilire,13,47,34,1,1,0,1
unire,3,6,3,1,1,-1,1
ricordare,17,6,11,1,-1,0,1
presentare,2,6,4,1,1,0,1
identificare,16,44,28,1,1,0,1
fornire,1,13,12,1,1,0,1
sfruttare,9,3,6,1,-1,0,1
ribadire,19,12,-7,-1,1,0,1
produrre,3,4,1,1,1,0,1
seguire,2,3,1,1,1,0,1
tenere,1,2,1,1,1,-1,1
creare,1,8,7,1,1,0,1
prendere,6,3,3,1,-1,0,1
prendere,1,6,5,1,1,0,1
proporre,2,18,16,1,1,0,1
attribuire,2,16,14,1,1,0,1
svolgere,3,10,7,1,1,0,1
assistere,3,4,1,1,1,0,1
abbandonare,2,3,1,1,1,0,1
porre,1,9,8,1,1,0,1
ridare,19,3,16,1,-1,0,1
avere,1,15,14,1,1,0,1
utilizzare,14,3,11,1,-1,0,1
dare,2,5,3,1,1,0,1
avere,1,32,31,1,1,0,1
rendere,5,2,-3,-1,1,0,1
acquistare,1,4,3,1,1,0,1
condividere,3,3,0,0,1,-1,1
vedere,8,4,-4,-1,1,0,1
ricevere,6,3,-3,-1,1,0,1
iscrivere,1,2,1,1,1,1,1
aggiungere,3,5,2,1,1,0,1
ricevere,2,2,0,0,1,0,1
ricevere,1,4,3,1,1,0,1
ottenere,1,3,2,1,1,1,1
effettuare,6,4,-2,-1,1,0,1
inserire,7,14,7,1,1,0,1
aggiungere,4,4,0,0,1,0,1
impostare,9,6,-3,-1,1,0,1
aggiungere,4,4,0,0,1,0,1
rivelare,4,2,2,1,-1,1,1
migliorare,7,8,1,1,1,0,1
connettere,1,7,6,1,1,1,1
scegliere,3,8,5,1,1,0,1
costruire,2,5,3,1,1,0,1
tenere,2,2,0,0,-1,0,1
modificare,3,3,0,0,1,0,1
raggiungere,3,4,1,1,1,0,1
rappresentare,7,3,4,1,-1,0,1
gestire,3,3,0,0,-1,0,1
avere,6,2,4,1,-1,0,1
ottenere,13,2,11,1,-1,0,1
ricevere,4,5,1,1,1,0,1
limitare,2,4,2,1,1,0,1
riservare,3,6,3,1,1,-1,1
avere,3,4,1,1,1,0,1
visualizzare,4,5,1,1,1,0,1
istituire,20,24,4,1,1,0,1
mantenere,2,12,10,1,1,0,1
introdurre,14,20,6,1,1,0,1
fare,1,35,34,1,1,1,1
informare,2,16,14,1,1,0,1
ridurre,6,9,3,1,1,0,1
dare,1,21,20,1,1,0,1
prendere,15,2,13,1,-1,0,1
mettere,13,2,11,1,-1,0,1
facilitare,5,3,-2,-1,1,0,1
dare,2,11,9,1,1,0,1
conseguire,2,11,9,1,1,0,1
promuovere,8,13,5,1,1,0,1
tenere,36,4,32,1,-1,0,1
ridurre,6,4,-2,-1,1,0,1
tenere,1,71,70,1,1,0,1
scambiare,12,10,-2,-1,1,0,1
tenere,1,8,7,1,1,0,1
prendere,3,2,1,1,-1,0,1
fissare,1,5,4,1,1,0,1
fissare,11,6,5,1,-1,0,1
definire,10,8,-2,-1,1,0,1
adottare,50,3,47,1,-1,0,1
organizzare,1,4,3,1,1,0,1
porre,2,4,2,1,1,0,1
eliminare,1,3,2,1,1,0,1
evitare,1,3,2,1,1,0,1
affrontare,7,3,4,1,-1,0,1
centralizzare,15,9,-6,-1,1,-1,1
sostituire,12,3,9,1,-1,0,1
determinare,7,10,3,1,1,0,1
applicare,2,4,2,1,1,0,1
fornire,2,6,4,1,1,0,1
estendere,2,19,17,1,1,0,1
fornire,1,4,3,1,1,0,1
conferire,2,12,10,1,1,0,1
introdurre,2,3,1,1,1,0,1
riaffermare,32,3,29,1,-1,0,1
promuovere,9,4,-5,-1,1,0,1
perseguire,15,6,9,1,-1,0,1
proclamare,8,90,82,1,1,0,1
promuovere,9,6,3,1,-1,0,1
avere,1,3,2,1,1,0,1
avere,1,26,25,1,1,0,1
avere,1,14,13,1,1,0,1
godere,4,3,1,1,-1,0,1
manifestare,7,16,9,1,1,0,1
diffondere,3,8,5,1,1,0,1
avere,1,49,48,1,1,0,1
avere,1,24,23,1,1,0,1
avere,1,6,5,1,1,0,1
comprendere,12,2,10,1,-1,1,1
garantire,11,23,12,1,1,0,1
favorire,6,6,0,0,1,0,1
soddisfare,15,4,-11,-1,1,0,1
rendere,4,5,1,1,1,0,1
rilasciare,5,7,2,1,1,0,1
imbottire,5,6,1,1,1,0,1
ingerire,2,3,1,1,1,0,1
cedere,2,3,1,1,1,0,1
apprezzare,6,3,-3,-1,1,0,1
proteggere,3,7,4,1,1,0,1
figurare,1,3,2,1,1,0,1
sostenere,6,4,-2,-1,1,0,1
investire,5,6,1,1,1,0,1
assillare,2,5,3,1,1,0,1
portare,20,2,18,1,-1,0,1
vedere,14,3,11,1,-1,0,1
fornire,3,7,-4,-1,-1,0,1
incoraggiare,2,3,-1,-1,-1,0,1
trasformare,6,13,7,1,1,0,1
spianare,2,4,2,1,1,0,1
fissare,3,5,2,1,1,0,1
avere,5,9,4,1,1,-1,1
sorprendere,2,10,8,1,1,0,1
sostenere,1,3,2,1,1,1,1
imporre,3,9,6,1,1,0,1
sviluppare,9,24,15,1,1,0,1
mostrare,1,6,5,1,1,0,1
fornire,1,4,3,1,1,0,1
lanciare,3,6,3,1,1,0,1
superare,4,3,1,1,-1,0,1
dimostrare,3,27,24,1,1,0,1
salvare,2,4,2,1,1,0,1
sostenere,8,4,-4,-1,1,0,1
integrare,3,6,3,1,1,0,1
richiedere,6,16,10,1,1,0,1
scoraggiare,4,4,0,0,1,0,1
sviluppare,4,13,9,1,1,0,1
offrire,2,6,4,1,1,0,1
combinare,1,8,7,1,1,1,1
aprire,4,17,13,1,1,0,1
aumentare,5,4,-1,-1,1,0,1
ricostruire,2,5,3,1,1,0,1
causare,2,19,17,1,1,0,1
mantenere,2,4,2,1,1,0,1
cedere,2,6,4,1,1,0,1
ricordare,17,3,14,1,-1,-1,1
offrire,3,5,2,1,1,0,1
affondare,2,19,17,1,1,0,1
erogare,1,4,3,1,1,0,1
ricevere,1,26,25,1,1,0,1
crescere,8,10,2,1,1,0,1
sentire,3,5,2,1,1,0,1
lasciare,4,2,2,1,-1,0,1
invidiare,3,21,18,1,1,0,1
porre,2,7,5,1,1,0,1
fare,1,3,2,1,1,1,1
ridurre,5,6,1,1,1,-1,1
consentire,6,5,-1,-1,1,0,1
attirare,6,4,-2,-1,1,0,1
lasciare,9,2,7,1,-1,0,1
rispecchiare,10,3,7,1,-1,0,1
valutare,40,3,37,1,-1,0,1
confrontare,2,27,25,1,1,-1,1
tenere,8,3,-5,-1,1,0,1
iniziare,2,6,4,1,1,0,1
sostenere,3,13,10,1,1,0,1
offrire,8,4,-4,-1,1,0,1
attingere,1,4,3,1,1,0,1
dovere,1,15,14,1,1,1,1
promuovere,8,21,13,1,1,0,1
fondare,3,6,3,1,1,0,1
creare,4,3,-1,-1,1,0,1
offrire,1,12,11,1,1,0,1
lasciare,18,5,13,1,-1,0,1
offrire,12,5,7,1,-1,0,1
coltivare,4,10,6,1,1,0,1
portare,16,2,14,1,-1,0,1
ridurre,2,5,3,1,1,0,1
offrire,16,4,12,1,-1,0,1
trasformare,5,6,1,1,1,0,1
dichiarare,2,12,10,1,1,0,1
paragonare,6,12,-6,-1,-1,0,0
dedicare,2,4,-2,-1,-1,0,0
avere,10,2,-8,-1,1,0,0
fare,3,12,-9,-1,-1,0,0
sfruttare,2,3,1,1,1,0,0
comportare,8,16,-8,-1,-1,0,0
dedicare,2,3,-1,-1,-1,0,0
riconoscere,10,4,-6,-1,1,0,0
considerare,5,2,3,1,-1,0,0
riportare,9,7,2,1,-1,0,0
sollevare,2,13,-11,-1,-1,0,0
rendere,6,8,-2,-1,-1,0,0
ricostruire,2,5,-3,-1,-1,0,0
promuovere,2,2,0,0,-1,0,0
legare,5,16,-11,-1,-1,0,0
tenere,26,2,-24,-1,1,0,0
fiaccare,2,6,-4,-1,-1,0,0
considerare,2,8,-6,-1,-1,0,0
spostare,2,4,-2,-1,-1,0,0
manipolare,2,7,-5,-1,-1,0,0
pagare,2,6,-4,-1,-1,0,0
impiegare,7,3,4,1,-1,0,0
trasformare,1,3,-2,-1,-1,-1,0
negoziare,7,24,-17,-1,-1,0,0
incrementare,5,8,-3,-1,-1,0,0
ammassare,3,3,0,0,-1,1,0
risolvere,2,5,-3,-1,-1,0,0
assoggettare,4,4,0,0,-1,0,0
incorporare,8,4,4,1,-1,0,0
porre,1,14,-13,-1,-1,0,0
avere,5,6,-1,-1,-1,0,0
condurre,5,9,-4,-1,-1,0,0
condurre,2,7,-5,-1,-1,0,0
lanciare,2,5,-3,-1,-1,0,0
controllare,1,23,-22,-1,-1,-1,0
mettere,9,2,-7,-1,1,0,0
dare,1,5,-4,-1,-1,0,0
passare,3,6,-3,-1,-1,0,0
portare,23,2,-21,-1,1,0,0
causare,2,7,-5,-1,-1,0,0
avere,1,6,-5,-1,-1,0,0
fare,1,4,-3,-1,-1,0,0
interrompere,2,5,-3,-1,-1,0,0
cambiare,3,7,-4,-1,-1,1,0
aggiungere,4,4,0,0,1,0,0
svolgere,3,3,0,0,-1,0,0
trascorrere,2,2,0,0,-1,0,0
mandare,2,3,-1,-1,-1,0,0
dare,2,3,-1,-1,-1,0,0
provare,3,10,-7,-1,-1,0,0
leggere,2,5,-3,-1,-1,0,0
attribuire,3,4,-1,-1,-1,0,0
riformare,5,7,-2,-1,-1,-1,0
seguire,3,2,1,1,-1,0,0
creare,3,4,-1,-1,-1,0,0
leggere,3,4,-1,-1,-1,0,0
scrivere,2,11,-9,-1,-1,0,0
fondare,3,5,-2,-1,-1,0,0
causare,3,3,0,0,-1,0,0
trarre,1,17,-16,-1,-1,0,0
procurare,2,9,-7,-1,-1,0,0
avere,2,3,-1,-1,-1,0,0
candidare,1,3,-2,-1,-1,-1,0
dare,2,3,-1,-1,-1,0,0
trasporre,5,6,1,1,1,0,0
rivedere,3,3,0,0,-1,0,0
ricoprire,4,6,-2,-1,-1,0,0
ripetere,2,6,-4,-1,-1,0,0
causare,2,8,-6,-1,-1,1,0
trascorrere,1,8,-7,-1,-1,0,0
trascorrere,3,31,-28,-1,-1,0,0
esprimere,1,19,-18,-1,-1,0,0
trovare,11,13,-2,-1,-1,0,0
avere,2,8,-6,-1,-1,0,0
includere,1,7,-6,-1,-1,1,0
costruire,3,5,-2,-1,-1,0,0
vedere,2,4,-2,-1,-1,0,0
dare,4,4,0,0,-1,0,0
pervadere,2,5,-3,-1,-1,0,0
utilizzare,13,8,5,1,-1,0,0
trarre,15,2,-13,-1,1,0,0
preferire,1,2,-1,-1,-1,0,0
rappresentare,5,3,-2,-1,1,0,0
produrre,8,6,2,1,-1,0,0
adorare,1,9,-8,-1,-1,0,0
dare,10,3,-7,-1,1,0,0
scrivere,3,3,0,0,-1,1,0
confermare,2,9,-7,-1,-1,0,0
creare,3,5,-2,-1,-1,0,0
avere,2,7,-5,-1,-1,0,0
identificare,1,5,-4,-1,-1,0,0
ottenere,3,6,-3,-1,-1,0,0
cambiare,3,4,-1,-1,-1,0,0
sapere,4,2,-2,-1,1,0,0
trascorrere,2,7,-5,-1,-1,0,0
sposare,4,3,1,1,-1,0,0
causare,4,4,0,0,-1,0,0
lasciare,3,6,-3,-1,-1,0,0
passare,3,11,-8,-1,-1,0,0
dare,2,3,1,1,1,0,0
porre,1,7,-6,-1,-1,0,0
vedere,2,5,-3,-1,-1,0,0
fare,2,12,-10,-1,-1,-1,0
avere,1,4,-3,-1,-1,0,0
mettere,6,2,-4,-1,1,0,0
alimentare,5,14,-9,-1,-1,0,0
dare,1,31,-30,-1,-1,0,0
offrire,5,9,4,1,1,0,0
aggiungere,3,4,1,1,1,0,0
portare,4,2,-2,-1,1,0,0
vedere,4,15,-11,-1,-1,0,0
avere,2,2,0,0,1,0,0
instaurare,3,4,-1,-1,-1,0,0
individuare,9,3,-6,-1,1,0,0
fare,1,4,-3,-1,-1,0,0
fare,5,8,-3,-1,-1,0,0
avere,3,2,-1,-1,1,0,0
valutare,2,16,-14,-1,-1,0,0
adattare,3,4,-1,-1,-1,0,0
calibrare,7,7,0,0,-1,0,0
donare,4,10,-6,-1,-1,0,0
descrivere,3,16,-13,-1,-1,0,0
contrapporre,2,3,-1,-1,-1,0,0
combinare,3,7,-4,-1,-1,0,0
mostrare,7,3,-4,-1,1,0,0
dare,10,4,-6,-1,1,0,0
conservare,6,5,1,1,-1,0,0
lasciare,3,7,-4,-1,-1,0,0
rivivere,6,4,2,1,-1,0,0
descrivere,9,7,2,1,-1,0,0
dovere,1,2,-1,-1,-1,-1,0
tradurre,1,2,-1,-1,-1,0,0
condannare,1,7,-6,-1,-1,0,0
avere,3,2,1,1,-1,0,0
tradurre,3,7,-4,-1,-1,0,0
attribuire,3,6,-3,-1,-1,0,0
considerare,1,7,-6,-1,-1,-1,0
interpretare,3,13,-10,-1,-1,0,0
dare,3,4,-1,-1,-1,0,0
fare,4,2,2,1,-1,0,0
acquistare,2,2,0,0,-1,0,0
dare,2,4,-2,-1,-1,0,0
confondere,1,3,-2,-1,-1,0,0
chiudere,2,2,0,0,-1,0,0
fare,2,4,-2,-1,-1,0,0
sfuggire,2,6,-4,-1,-1,0,0
costruire,1,9,-8,-1,-1,0,0
guastare,2,10,-8,-1,-1,0,0
prendere,2,2,0,0,1,0,0
barattare,5,4,1,1,-1,0,0
proporre,6,3,-3,-1,1,0,0
avere,3,4,-1,-1,-1,0,0
portare,1,2,-1,-1,-1,-1,0
pensare,1,3,2,1,1,0,0
tenere,2,3,-1,-1,-1,0,0
fare,2,2,0,0,-1,0,0
vedere,6,7,-1,-1,-1,0,0
mettere,9,2,-7,-1,1,0,0
paragonare,1,4,-3,-1,-1,0,0
immaginare,1,6,-5,-1,-1,0,0
aggiungere,1,3,2,1,1,0,0
conquistare,4,8,-4,-1,-1,0,0
dare,2,4,-2,-1,-1,0,0
chiedere,1,3,-2,-1,-1,0,0
convocare,3,3,0,0,-1,0,0
chiedere,2,3,-1,-1,-1,0,0
dare,3,3,0,0,1,0,0
votare,2,3,-1,-1,-1,0,0
accreditare,5,3,2,1,-1,0,0
vedere,3,7,-4,-1,-1,0,0
garantire,2,2,0,0,-1,0,0
inviare,2,4,-2,-1,-1,0,0
ricoprire,3,6,-3,-1,-1,0,0
soffocare,1,2,-1,-1,-1,-1,0
riunire,2,2,0,0,1,0,0
avere,2,5,-3,-1,-1,0,0
portare,3,2,1,1,-1,0,0
dare,2,3,-1,-1,-1,0,0
rubare,3,7,-4,-1,-1,0,0
dare,2,3,-1,-1,-1,0,0
andare,2,2,0,0,-1,-1,0
chiedere,1,2,-1,-1,-1,-1,0
fare,3,2,1,1,-1,1,0
dire,2,3,-1,-1,-1,0,0
criticare,1,5,-4,-1,-1,0,0
fare,1,3,-2,-1,-1,0,0
chiedere,4,4,0,0,1,0,0
prendere,4,4,0,0,-1,0,0
comprare,1,2,-1,-1,-1,0,0
rilanciare,2,3,-1,-1,-1,0,0
avviare,1,4,-3,-1,-1,0,0
incentivare,3,5,-2,-1,-1,0,0
rubare,1,3,-2,-1,-1,0,0
citare,9,4,5,1,-1,0,0
preferire,2,3,-1,-1,-1,0,0
dare,2,10,-8,-1,-1,0,0
permettere,2,3,1,1,1,0,0
avere,4,12,-8,-1,-1,0,0
dire,1,2,-1,-1,-1,0,0
passire,1,4,3,1,1,0,0
uscire,2,4,-2,-1,-1,0,0
cambiare,1,3,-2,-1,-1,0,0
collegare,1,4,-3,-1,-1,-1,0
andare,1,2,-1,-1,-1,-1,0
vedere,11,2,-9,-1,1,0,0
unire,2,4,-2,-1,-1,0,0
invocare,5,6,-1,-1,-1,0,0
dire,1,4,-3,-1,-1,0,0
dirigere,1,2,-1,-1,-1,1,0
fare,1,3,-2,-1,-1,0,0
ristrutturare,2,3,-1,-1,-1,0,0
dare,1,16,-15,-1,-1,1,0
basare,4,8,-4,-1,-1,0,0
lasciare,2,3,-1,-1,-1,0,0
approvare,6,5,1,1,-1,0,0
fare,2,3,-1,-1,-1,0,0
assegnare,2,3,-1,-1,-1,0,0
avere,1,2,-1,-1,-1,0,0
porre,1,4,-3,-1,-1,0,0
fermare,1,2,-1,-1,-1,0,0
fare,2,4,-2,-1,-1,0,0
chiedere,1,3,-2,-1,-1,0,0
fare,1,3,-2,-1,-1,0,0
trasformare,2,2,0,0,1,0,0
sostenere,3,3,0,0,1,0,0
mozzare,5,4,1,1,-1,0,0
servire,1,3,-2,-1,-1,0,0
rompere,2,15,-13,-1,-1,1,0
rompere,2,3,-1,-1,-1,0,0
governare,2,5,-3,-1,-1,0,0
presentire,1,8,-7,-1,-1,0,0
dare,1,4,-3,-1,-1,0,0
aspettare,2,8,6,1,1,0,0
traghettare,3,5,-2,-1,-1,0,0
dare,2,5,-3,-1,-1,0,0
mandare,4,2,-2,-1,1,0,0
scatenare,1,3,-2,-1,-1,0,0
dare,2,7,-5,-1,-1,0,0
unire,2,4,-2,-1,-1,0,0
immaginare,2,3,-1,-1,-1,0,0
salvare,3,3,0,0,-1,0,0
rovesciare,2,2,0,0,-1,0,0
digerire,2,4,2,1,1,0,0
fare,4,2,2,1,-1,0,0
mantenere,3,2,1,1,-1,0,0
fare,2,2,0,0,-1,1,0
avere,1,4,-3,-1,-1,0,0
mettere,2,11,-9,-1,-1,0,0
salvare,2,3,-1,-1,-1,0,0
amare,1,2,-1,-1,-1,0,0
trascorrere,2,4,-2,-1,-1,0,0
fare,8,3,-5,-1,1,1,0
ballare,3,7,-4,-1,-1,0,0
dire,5,4,1,1,-1,0,0
favorire,2,6,-4,-1,-1,0,0
dare,1,3,-2,-1,-1,0,0
guadagnare,2,3,-1,-1,-1,0,0
colpire,1,2,-1,-1,-1,-1,0
tentare,3,15,-12,-1,-1,0,0
fare,2,3,-1,-1,-1,0,0
fare,2,3,-1,-1,-1,0,0
volere,1,3,-2,-1,-1,0,0
dare,4,4,0,0,-1,0,0
costruire,3,4,-1,-1,-1,0,0
scrivere,1,3,-2,-1,-1,-1,0
dare,3,2,-1,-1,1,0,0
passare,3,2,1,1,-1,0,0
dare,3,5,-2,-1,-1,0,0
avere,1,4,-3,-1,-1,0,0
impacchettare,1,2,-1,-1,-1,0,0
spedire,1,2,-1,-1,-1,-1,0
spingere,2,4,-2,-1,-1,0,0
appoggiare,6,2,-4,-1,1,0,0
avere,3,5,-2,-1,-1,0,0
riscattare,1,3,-2,-1,-1,-1,0
mettere,5,3,2,1,-1,0,0
trascinare,1,4,-3,-1,-1,-1,0
avere,1,3,-2,-1,-1,0,0
fare,1,3,-2,-1,-1,0,0
sentire,2,2,0,0,-1,1,0
iscrivere,1,4,-3,-1,-1,-1,0
incolpare,1,5,-4,-1,-1,0,0
pagare,1,2,-1,-1,-1,1,0
lasciare,3,2,1,1,-1,0,0
cedere,3,3,0,0,-1,0,0
correre,1,3,-2,-1,-1,0,0
avere,6,3,-3,-1,1,0,0
fare,2,2,0,0,-1,0,0
mettere,1,2,1,1,1,1,0
condividere,22,3,-19,-1,1,0,0
aiutare,1,5,-4,-1,-1,-1,0
iniziare,2,3,-1,-1,-1,0,0
aumentare,5,2,3,1,-1,0,0
difendere,2,4,-2,-1,-1,0,0
portare,1,6,-5,-1,-1,0,0
rappresentare,2,2,0,0,-1,1,0
restituire,2,5,-3,-1,-1,0,0
avere,1,8,-7,-1,-1,0,0
ammonire,1,2,-1,-1,-1,0,0
fare,2,5,-3,-1,-1,0,0
scoprire,2,2,0,0,-1,0,0
volere,1,7,-6,-1,-1,0,0
perdere,2,9,-7,-1,-1,0,0
spiegare,2,6,-4,-1,-1,1,0
fare,3,4,-1,-1,-1,0,0
promettere,3,5,-2,-1,-1,0,0
regalare,3,3,0,0,-1,0,0
sottovalutare,6,9,-3,-1,-1,0,0
concentrare,3,4,-1,-1,-1,0,0
ottenere,1,9,-8,-1,-1,0,0
rendere,1,2,-1,-1,-1,0,0
votare,1,2,-1,-1,-1,0,0
ascoltare,6,5,1,1,-1,0,0
dare,2,10,-8,-1,-1,0,0
dare,2,5,-3,-1,-1,0,0
fare,1,13,-12,-1,-1,-1,0
chiedere,1,4,-3,-1,-1,0,0
sostenere,3,8,-5,-1,-1,0,0
tornare,2,2,0,0,1,0,0
condividere,2,9,-7,-1,-1,1,0
chiedere,2,3,-1,-1,-1,0,0
avere,2,3,-1,-1,-1,0,0
dare,1,2,-1,-1,-1,1,0
perdere,2,3,-1,-1,-1,0,0
prendere,1,2,-1,-1,-1,0,0
creare,2,2,0,0,-1,0,0
sentire,1,2,-1,-1,-1,0,0
sostenere,3,4,-1,-1,-1,0,0
spendere,3,8,-5,-1,-1,0,0
prendere,4,2,-2,-1,1,1,0
dare,2,3,-1,-1,-1,0,0
calare,2,3,-1,-1,-1,0,0
vedere,4,5,-1,-1,-1,0,0
vestire,2,2,0,0,1,0,0
sembrare,2,2,0,0,-1,0,0
trasformare,1,4,-3,-1,-1,-1,0
aspettare,1,3,-2,-1,-1,0,0
seguire,1,5,-4,-1,-1,0,0
fare,1,4,-3,-1,-1,0,0
fare,1,3,-2,-1,-1,0,0
fare,2,3,-1,-1,-1,0,0
dare,2,3,-1,-1,-1,0,0
dire,1,4,-3,-1,-1,0,0
mandare,2,3,-1,-1,-1,0,0
condannare,2,3,-1,-1,-1,0,0
dare,1,4,-3,-1,-1,0,0
fare,3,7,-4,-1,-1,0,0
affrontare,1,5,-4,-1,-1,0,0
fare,1,3,-2,-1,-1,0,0
guardare,1,2,-1,-1,-1,0,0
fare,2,3,-1,-1,-1,0,0
vedere,6,7,-1,-1,-1,0,0
sparare,1,3,2,1,1,0,0
mettere,5,3,-2,-1,1,0,0
pagare,2,3,-1,-1,-1,0,0
fare,2,2,0,0,-1,0,0
giocare,2,2,0,0,1,0,0
fare,2,2,0,0,-1,0,0
avere,4,4,0,0,-1,0,0
finire,2,3,-1,-1,-1,0,0
ridare,3,3,0,0,-1,0,0
dire,1,4,-3,-1,-1,0,0
convocare,3,3,0,0,1,0,0
dire,1,3,-2,-1,-1,0,0
avere,1,3,-2,-1,-1,-1,0
governare,2,4,-2,-1,-1,1,0
mandare,1,3,-2,-1,-1,-1,0
mandare,2,2,0,0,1,0,0
dire,1,4,-3,-1,-1,0,0
criticare,3,3,0,0,1,0,0
confondere,1,5,-4,-1,-1,0,0
avere,2,2,0,0,-1,0,0
fare,4,3,1,1,-1,0,0
avere,2,4,-2,-1,-1,0,0
amare,4,2,2,1,-1,1,0
fare,1,2,-1,-1,-1,1,0
dire,3,4,-1,-1,-1,0,0
ripensare,3,3,0,0,-1,0,0
chiarire,2,2,0,0,-1,0,0
declassare,2,2,0,0,-1,0,0
lanciare,2,3,-1,-1,-1,0,0
ottenere,2,4,-2,-1,-1,0,0
fare,1,7,-6,-1,-1,0,0
pagare,2,3,-1,-1,-1,0,0
dare,1,2,-1,-1,-1,0,0
invocare,5,6,-1,-1,-1,0,0
attaccare,2,5,-3,-1,-1,0,0
servire,1,3,-2,-1,-1,0,0
privare,2,3,-1,-1,-1,-1,0
aspettare,1,2,-1,-1,-1,0,0
volere,1,4,-3,-1,-1,0,0
capitare,1,2,-1,-1,-1,-1,0
volere,2,2,0,0,-1,1,0
conquistare,1,4,-3,-1,-1,-1,0
fare,2,5,-3,-1,-1,0,0
fare,2,3,-1,-1,-1,0,0
elencare,6,3,3,1,-1,0,0
aggiuntare,2,5,-3,-1,-1,0,0
diventare,2,2,0,0,-1,0,0
contrastare,6,3,3,1,-1,0,0
pagare,3,3,0,0,-1,0,0
scoprire,6,2,-4,-1,1,0,0
fare,2,4,-2,-1,-1,0,0
meritare,3,2,1,1,-1,0,0
concludere,4,8,-4,-1,-1,0,0
trascorrere,5,2,3,1,-1,0,0
abbandonare,1,7,-6,-1,-1,-1,0
aggiungere,2,2,0,0,-1,-1,0
mettere,1,2,-1,-1,-1,1,0
mettere,1,2,1,1,1,1,0
fare,2,4,-2,-1,-1,0,0
ascoltare,1,2,-1,-1,-1,0,0
dedicare,4,2,-2,-1,1,0,0
sfracassare,2,3,-1,-1,-1,0,0
fare,2,3,-1,-1,-1,0,0
pigliare,1,3,-2,-1,-1,-1,0
pilotare,2,4,-2,-1,-1,0,0
dire,3,3,0,0,-1,-1,0
prendere,1,3,-2,-1,-1,-1,0
comprare,2,5,-3,-1,-1,0,0
avere,9,2,-7,-1,1,1,0
dare,3,3,0,0,-1,0,0
inserire,10,7,-3,-1,1,0,0
meritare,2,5,-3,-1,-1,0,0
fare,2,2,0,0,-1,0,0
avere,2,4,-2,-1,-1,1,0
togliere,2,3,-1,-1,-1,0,0
avere,4,8,-4,-1,-1,1,0
avere,1,3,-2,-1,-1,0,0
guardare,1,2,-1,-1,-1,-1,0
fare,1,2,-1,-1,-1,0,0
seguire,1,3,-2,-1,-1,-1,0
parlare,2,3,-1,-1,-1,1,0
dedicare,2,11,-9,-1,-1,0,0
avere,2,9,-7,-1,-1,0,0
ritrovare,2,3,-1,-1,-1,0,0
scegliere,3,2,1,1,-1,0,0
considerare,1,2,-1,-1,-1,0,0
murare,2,2,0,0,-1,0,0
prendere,2,3,1,1,1,0,0
legare,2,14,-12,-1,-1,0,0
dire,3,4,-1,-1,-1,0,0
mandare,1,3,-2,-1,-1,-1,0
organizzare,8,10,-2,-1,-1,0,0
fare,3,6,-3,-1,-1,0,0
fare,1,3,-2,-1,-1,0,0
passare,4,3,-1,-1,1,0,0
rimpiangere,2,11,-9,-1,-1,0,0
dare,1,3,-2,-1,-1,-1,0
denunciare,2,3,-1,-1,-1,0,0
terminare,2,2,0,0,-1,1,0
fare,2,2,0,0,1,0,0
ficcare,1,2,-1,-1,-1,-1,0
acquistare,2,2,0,0,-1,0,0
dare,2,4,-2,-1,-1,0,0
fare,2,3,1,1,1,0,0
avere,2,2,0,0,-1,0,0
impugnare,6,5,1,1,-1,0,0
alludere,2,6,-4,-1,-1,0,0
tagliare,2,4,-2,-1,-1,0,0
svelare,3,7,-4,-1,-1,0,0
fare,2,2,0,0,-1,0,0
pagare,1,2,-1,-1,-1,-1,0
appoggiare,3,9,-6,-1,-1,0,0
plaudere,2,3,-1,-1,-1,0,0
girare,1,2,-1,-1,-1,0,0
trovare,2,2,0,0,-1,0,0
aggiuntare,2,5,-3,-1,-1,0,0
riportare,2,2,0,0,1,0,0
appoggiare,1,3,-2,-1,-1,-1,0
sperare,1,4,-3,-1,-1,-1,0
scorgere,2,7,-5,-1,-1,0,0
sentire,1,2,-1,-1,-1,0,0
cadere,1,4,-3,-1,-1,0,0
fare,2,2,0,0,-1,1,0
mettere,5,3,-2,-1,1,0,0
invocare,3,11,-8,-1,-1,0,0
portare,2,3,-1,-1,-1,0,0
ritrovare,2,7,-5,-1,-1,0,0
dare,13,2,-11,-1,1,0,0
dare,2,3,-1,-1,-1,0,0
sentire,2,2,0,0,-1,0,0
mettere,9,3,-6,-1,1,0,0
acquistare,5,2,3,1,-1,0,0
dare,2,4,-2,-1,-1,0,0
negare,2,2,0,0,-1,0,0
fare,2,3,-1,-1,-1,0,0
proporre,1,3,-2,-1,-1,0,0
staccare,2,4,-2,-1,-1,0,0
rompere,2,6,-4,-1,-1,0,0
dire,1,4,-3,-1,-1,0,0
portare,2,3,-1,-1,-1,0,0
eliminare,2,7,-5,-1,-1,0,0
insultare,2,4,-2,-1,-1,0,0
lanciare,5,3,-2,-1,1,-1,0
ricevere,3,2,-1,-1,1,0,0
dare,3,4,-1,-1,-1,0,0
evitare,3,4,-1,-1,-1,0,0
perdere,1,3,-2,-1,-1,0,0
ascoltare,1,3,-2,-1,-1,0,0
fare,1,4,-3,-1,-1,0,0
usare,1,2,1,1,1,0,0
difendere,2,4,-2,-1,-1,0,0
tornare,2,3,-1,-1,-1,0,0
risparmiare,7,3,-4,-1,1,0,0
fare,2,9,-7,-1,-1,0,0
avere,1,3,-2,-1,-1,0,0
mangiare,3,2,-1,-1,1,1,0
spacciare,3,2,1,1,-1,0,0
avere,2,2,0,0,-1,0,0
annunciare,1,8,-7,-1,-1,0,0
dare,2,3,-1,-1,-1,0,0
dire,1,2,-1,-1,-1,0,0
dire,3,4,-1,-1,-1,-1,0
preferire,4,6,-2,-1,-1,1,0
avere,1,3,-2,-1,-1,0,0
lustrare,2,2,0,0,-1,0,0
candidare,2,3,-1,-1,-1,0,0
avere,2,2,0,0,-1,1,0
battere,2,8,-6,-1,-1,0,0
cambiare,2,3,-1,-1,-1,0,0
portare,2,4,-2,-1,-1,0,0
trovare,2,2,0,0,-1,0,0
vincere,2,3,-1,-1,-1,0,0
mandare,2,2,0,0,1,0,0
allargare,4,4,0,0,-1,0,0
strappare,2,3,-1,-1,-1,0,0
versare,2,8,-6,-1,-1,0,0
mettere,3,2,-1,-1,1,0,0
fare,1,4,-3,-1,-1,0,0
dire,1,3,-2,-1,-1,-1,0
saltare,3,2,-1,-1,1,0,0
aspettare,5,3,-2,-1,1,0,0
passare,3,2,1,1,-1,0,0
fare,3,3,0,0,-1,0,0
bombardare,3,2,1,1,-1,0,0
dare,1,4,-3,-1,-1,0,0
dare,3,3,0,0,1,0,0
aggiungere,3,4,1,1,1,0,0
confidare,1,3,2,1,1,0,0
inviare,2,3,1,1,1,-1,0
dire,1,4,-3,-1,-1,0,0
servire,1,4,-3,-1,-1,0,0
esaltare,4,19,-15,-1,-1,0,0
opporre,1,4,-3,-1,-1,-1,0
fare,2,10,-8,-1,-1,0,0
fare,2,2,0,0,-1,0,0
scippare,2,2,0,0,-1,0,0
attaccare,7,3,4,1,-1,0,0
risparmiare,7,3,-4,-1,1,0,0
iniziare,3,6,-3,-1,-1,0,0
raccontare,8,7,-1,-1,1,0,0
visitare,1,2,-1,-1,-1,1,0
fare,2,6,-4,-1,-1,0,0
inserire,1,3,-2,-1,-1,0,0
fare,1,3,-2,-1,-1,-1,0
inserire,4,3,-1,-1,1,0,0
incantare,2,3,-1,-1,-1,0,0
polverizzare,1,3,-2,-1,-1,-1,0
dare,3,3,0,0,-1,0,0
seguire,1,2,-1,-1,-1,-1,0
tenere,3,2,-1,-1,1,0,0
cercare,3,4,1,1,1,0,0
avere,2,3,-1,-1,-1,0,0
difendere,2,4,-2,-1,-1,0,0
prendere,1,2,-1,-1,-1,0,0
andare,1,4,-3,-1,-1,0,0
trasformare,2,7,-5,-1,-1,0,0
tassare,2,5,-3,-1,-1,0,0
fare,2,3,-1,-1,-1,0,0
accettare,2,2,0,0,-1,0,0
fare,3,3,0,0,-1,0,0
fare,1,12,-11,-1,-1,-1,0
mettere,2,2,0,0,1,0,0
accorciare,1,3,-2,-1,-1,0,0
vedere,3,3,0,0,1,0,0
scrivere,1,2,-1,-1,-1,0,0
lanciare,2,3,-1,-1,-1,0,0
pagare,2,3,-1,-1,-1,1,0
colpire,2,6,-4,-1,-1,0,0
candidare,2,4,-2,-1,-1,0,0
fare,1,2,-1,-1,-1,0,0
dare,2,4,-2,-1,-1,0,0
definire,3,6,-3,-1,-1,0,0
ridurre,2,5,-3,-1,-1,0,0
attendere,2,5,-3,-1,-1,0,0
invasare,3,2,-1,-1,1,0,0
pareggiare,1,2,-1,-1,-1,-1,0
dire,1,4,-3,-1,-1,0,0
uscire,2,3,-1,-1,-1,0,0
esprimere,2,11,-9,-1,-1,0,0
apprezzare,1,3,-2,-1,-1,-1,0
sistemare,1,6,-5,-1,-1,-1,0
dare,1,20,-19,-1,-1,0,0
dare,1,6,-5,-1,-1,0,0
governare,2,3,-1,-1,-1,0,0
fare,2,2,0,0,-1,0,0
fare,2,5,-3,-1,-1,0,0
prendere,1,3,-2,-1,-1,-1,0
mettere,2,2,0,0,1,0,0
sciroppare,6,3,-3,-1,1,0,0
fare,2,4,-2,-1,-1,0,0
temere,6,3,3,1,-1,0,0
mandare,1,2,1,1,1,1,0
tenere,6,2,-4,-1,1,0,0
prestare,1,3,-2,-1,-1,0,0
chiamare,9,3,-6,-1,1,0,0
riportare,4,2,-2,-1,1,0,0
rompere,2,2,0,0,-1,0,0
cercare,2,3,-1,-1,-1,0,0
mettere,7,2,5,1,-1,0,0
fare,2,7,-5,-1,-1,0,0
fare,5,2,3,1,-1,0,0
pagare,2,3,-1,-1,-1,0,0
invocare,5,6,-1,-1,-1,0,0
fare,2,3,-1,-1,-1,0,0
fare,1,2,-1,-1,-1,1,0
avere,2,2,0,0,-1,0,0
fare,1,5,-4,-1,-1,0,0
iscrivere,1,15,-14,-1,-1,-1,0
amare,1,2,-1,-1,-1,0,0
parlare,3,2,1,1,-1,0,0
chiedere,2,4,-2,-1,-1,0,0
avere,1,4,-3,-1,-1,0,0
confrontare,1,4,-3,-1,-1,-1,0
avere,1,8,-7,-1,-1,0,0
perdere,5,3,2,1,-1,0,0
aspettare,7,2,-5,-1,1,0,0
fare,3,4,-1,-1,-1,0,0
certificare,2,4,-2,-1,-1,0,0
segnare,3,3,0,0,-1,0,0
mettere,6,4,-2,-1,1,0,0
mettere,2,3,-1,-1,-1,0,0
incrociare,2,4,-2,-1,-1,0,0
abbassare,2,5,-3,-1,-1,0,0
fare,1,8,-7,-1,-1,0,0
autorizzare,2,2,0,0,-1,0,0
condannare,1,2,1,1,1,0,0
illustrare,2,2,0,0,-1,0,0
appoggiare,5,4,1,1,-1,0,0
pensare,2,2,0,0,-1,1,0
presentare,2,3,-1,-1,-1,0,0
sostenere,5,3,2,1,-1,0,0
sostenere,2,2,0,0,-1,0,0
disciplinare,6,2,4,1,-1,0,0
pagare,3,4,-1,-1,-1,0,0
amare,2,3,-1,-1,-1,0,0
fare,2,3,-1,-1,-1,0,0
salutare,1,2,-1,-1,-1,-1,0
assicurare,2,4,-2,-1,-1,0,0
fare,1,5,-4,-1,-1,0,0
aprire,1,4,-3,-1,-1,0,0
indorare,2,3,-1,-1,-1,0,0
mettere,1,2,-1,-1,-1,-1,0
spiegare,2,9,-7,-1,-1,0,0
affidare,1,2,-1,-1,-1,0,0
superare,2,3,-1,-1,-1,0,0
giudicare,2,3,-1,-1,-1,0,0
infangare,3,4,-1,-1,-1,0,0
volere,1,3,-2,-1,-1,0,0
avere,3,2,1,1,-1,0,0
smettere,1,3,-2,-1,-1,-1,0
attendere,2,4,-2,-1,-1,0,0
dare,1,5,-4,-1,-1,1,0
dare,3,4,1,1,1,0,0
invitare,1,2,1,1,1,0,0
seguire,4,3,-1,-1,1,0,0
chiedere,2,3,-1,-1,-1,0,0
mettere,4,3,-1,-1,1,0,0
regalare,1,2,-1,-1,-1,-1,0
saltare,2,4,-2,-1,-1,0,0
dare,1,8,-7,-1,-1,0,0
riempire,2,8,-6,-1,-1,0,0
mettere,10,2,-8,-1,1,0,0
confondere,1,5,-4,-1,-1,0,0
amare,1,9,-8,-1,-1,0,0
rimettere,3,2,-1,-1,1,0,0
mandare,1,2,-1,-1,-1,-1,0
arrivare,1,2,1,1,1,0,0
toccare,1,3,2,1,1,0,0
avere,3,4,-1,-1,-1,0,0
invocare,2,10,-8,-1,-1,0,0
trovare,1,3,-2,-1,-1,1,0
convenire,3,3,0,0,-1,0,0
fare,2,4,-2,-1,-1,0,0
paragonare,1,2,-1,-1,-1,-1,0
lasciare,2,3,1,1,1,0,0
ripristinare,2,4,-2,-1,-1,0,0
dare,3,6,-3,-1,-1,0,0
fare,2,3,-1,-1,-1,0,0
tenere,8,2,-6,-1,1,0,0
alzare,2,6,-4,-1,-1,0,0
accusare,3,4,1,1,1,0,0
avere,1,3,-2,-1,-1,-1,0
cercare,2,2,0,0,-1,0,0
smettere,1,10,-9,-1,-1,-1,0
pagare,6,4,2,1,-1,0,0
paragonare,2,2,0,0,-1,0,0
mettere,1,6,-5,-1,-1,-1,0
tenere,3,3,0,0,-1,0,0
volere,3,4,-1,-1,-1,0,0
appoggiare,3,2,-1,-1,1,0,0
ricaricare,2,4,-2,-1,-1,-1,0
offendere,3,2,1,1,-1,0,0
fare,6,2,-4,-1,1,0,0
praticare,3,4,-1,-1,-1,0,0
avere,1,5,-4,-1,-1,0,0
mettere,3,5,-2,-1,-1,0,0
fare,2,3,-1,-1,-1,0,0
chiamare,1,2,1,1,1,0,0
lasciare,1,6,-5,-1,-1,0,0
temere,2,3,-1,-1,-1,0,0
pagare,2,5,-3,-1,-1,0,0
dire,1,4,-3,-1,-1,0,0
strizzare,2,3,-1,-1,-1,0,0
fare,3,2,-1,-1,1,-1,0
dare,2,2,0,0,-1,1,0
prendere,1,3,-2,-1,-1,0,0
trovare,3,4,-1,-1,-1,0,0
fare,1,3,-2,-1,-1,-1,0
fare,2,2,0,0,-1,0,0
togliere,2,2,0,0,1,0,0
dire,1,10,-9,-1,-1,0,0
insegnare,1,2,-1,-1,-1,0,0
fare,1,4,-3,-1,-1,-1,0
mettere,11,2,-9,-1,1,0,0
dare,2,3,-1,-1,-1,0,0
fare,1,3,-2,-1,-1,0,0
portare,3,3,0,0,-1,0,0
dire,2,11,-9,-1,-1,-1,0
avere,1,3,-2,-1,-1,1,0
preparare,3,4,-1,-1,-1,0,0
dire,1,4,-3,-1,-1,0,0
fare,3,4,-1,-1,-1,1,0
succedere,1,2,-1,-1,-1,-1,0
portare,1,3,-2,-1,-1,-1,0
leggere,1,2,-1,-1,-1,-1,0
sfogliare,1,2,-1,-1,-1,-1,0
spacciare,1,2,-1,-1,-1,-1,0
togliere,2,3,-1,-1,-1,0,0
mettere,2,2,0,0,1,0,0
avere,2,2,0,0,-1,0,0
trasformare,2,2,0,0,1,0,0
avere,3,4,-1,-1,-1,0,0
fare,2,3,-1,-1,-1,0,0
avere,2,2,0,0,-1,0,0
costruire,1,9,-8,-1,-1,0,0
fare,4,2,2,1,-1,0,0
fare,1,3,-2,-1,-1,0,0
immaginare,1,6,-5,-1,-1,0,0
trovare,3,4,-1,-1,-1,0,0
dare,8,3,-5,-1,1,0,0
andare,2,3,-1,-1,-1,0,0
dare,2,3,-1,-1,-1,1,0
portare,2,3,-1,-1,-1,0,0
lanciare,1,3,-2,-1,-1,-1,0
assaltare,1,6,-5,-1,-1,0,0
dare,2,5,-3,-1,-1,0,0
perdere,1,3,-2,-1,-1,0,0
colpire,2,6,-4,-1,-1,0,0
dire,3,4,-1,-1,-1,0,0
vergere,5,2,3,1,-1,0,0
dare,2,3,-1,-1,-1,0,0
comunicare,5,7,2,1,1,0,0
dare,2,3,1,1,1,0,0
chiedere,1,12,-11,-1,-1,-1,0
dire,3,3,0,0,-1,-1,0
prendere,2,2,0,0,1,0,0
passare,3,2,1,1,-1,0,0
sostenere,3,3,0,0,1,0,0
impacchettare,1,2,-1,-1,-1,0,0
spedire,1,2,-1,-1,-1,-1,0
avere,2,5,-3,-1,-1,0,0
dire,1,4,-3,-1,-1,0,0
strappare,2,3,-1,-1,-1,0,0
spalmare,1,6,-5,-1,-1,0,0
portare,1,4,-3,-1,-1,-1,0
aspettare,3,2,-1,-1,1,1,0
dare,2,3,-1,-1,-1,0,0
ritrovare,2,7,-5,-1,-1,0,0
ascoltare,6,5,1,1,-1,0,0
infangare,3,4,-1,-1,-1,0,0
pulire,2,2,0,0,-1,1,0
mandare,2,2,0,0,-1,0,0
Ringrazare,5,3,2,1,-1,0,0
distruggere,3,5,-2,-1,-1,0,0
lasciare,2,2,0,0,-1,0,0
attendere,1,4,-3,-1,-1,0,0
fissare,5,5,0,0,-1,0,0
proporre,2,4,-2,-1,-1,0,0
diare,1,3,-2,-1,-1,0,0
mettere,2,3,1,1,1,0,0
confondare,3,3,0,0,-1,0,0
confondere,3,3,0,0,-1,0,0
concedere,2,3,-1,-1,-1,0,0
eliminare,2,3,-1,-1,-1,0,0
spendere,3,8,-5,-1,-1,0,0
smettere,1,10,-9,-1,-1,-1,0
ritrovare,2,3,-1,-1,-1,0,0
colpire,1,2,-1,-1,-1,-1,0
ricevere,2,2,0,0,-1,0,0
assumere,3,4,-1,-1,-1,0,0
parlare,1,2,-1,-1,-1,0,0
augurare,5,3,2,1,-1,0,0
mettere,2,2,0,0,-1,0,0
dare,1,3,-2,-1,-1,0,0
mettere,1,2,-1,-1,-1,-1,0
lasciare,3,2,1,1,-1,0,0
fare,1,7,-6,-1,-1,0,0
pagare,2,3,-1,-1,-1,0,0
dare,2,3,-1,-1,-1,0,0
temere,6,3,3,1,-1,0,0
ricoprire,3,6,-3,-1,-1,0,0
regalare,3,3,0,0,-1,0,0
sciroppare,6,3,-3,-1,1,0,0
fare,2,4,-2,-1,-1,0,0
mettere,6,2,-4,-1,1,0,0
insegnare,1,2,-1,-1,-1,0,0
portare,2,2,0,0,1,0,0
dare,2,3,1,1,1,0,0
comprare,2,3,-1,-1,-1,0,0
fare,3,2,1,1,-1,0,0
fare,2,6,-4,-1,-1,0,0
scoprire,2,2,0,0,-1,0,0
sistemare,1,3,-2,-1,-1,-1,0
rivendicare,3,2,-1,-1,1,0,0
fare,1,3,-2,-1,-1,0,0
proporre,3,4,-1,-1,-1,0,0
rinviare,1,3,-2,-1,-1,-1,0
manifestare,5,2,-3,-1,1,0,0
bloccare,2,3,-1,-1,-1,0,0
fare,1,4,-3,-1,-1,0,0
mettere,4,8,4,1,1,0,0
dare,5,3,2,1,-1,0,0
fare,2,7,-5,-1,-1,0,0
copiare,7,3,-4,-1,1,0,0
suggerire,1,2,-1,-1,-1,-1,0
tenere,3,2,1,1,-1,0,0
usare,1,2,1,1,1,0,0
scrivere,1,3,-2,-1,-1,-1,0
mandare,2,2,0,0,1,0,0
avere,4,4,0,0,-1,0,0
fare,1,3,-2,-1,-1,0,0
stanziare,2,3,-1,-1,-1,0,0
confondere,2,11,-9,-1,-1,0,0
rifilare,2,3,-1,-1,-1,0,0
trovare,2,2,0,0,-1,0,0
mettere,1,4,-3,-1,-1,-1,0
lasciare,7,2,-5,-1,1,1,0
aggredire,2,2,0,0,-1,0,0
Invitere,5,4,1,1,-1,0,0
avere,2,2,0,0,-1,1,0
diffamare,3,4,-1,-1,-1,0,0
fare,1,2,-1,-1,-1,-1,0
ri-votare,1,3,-2,-1,-1,-1,0
opporre,1,6,-5,-1,-1,0,0
iscrivere,1,3,-2,-1,-1,-1,0
portare,6,2,-4,-1,1,0,0
scegliere,2,2,0,0,-1,0,0
mettere,1,3,-2,-1,-1,-1,0
introdurre,2,3,-1,-1,-1,0,0
paracadutare,1,2,-1,-1,-1,0,0
tagliare,5,5,0,0,-1,0,0
chiedere,2,3,1,1,1,0,0
uccidere,2,6,-4,-1,-1,0,0
respingere,2,7,-5,-1,-1,0,0
insegnare,3,4,-1,-1,-1,0,0
creare,1,7,6,1,1,0,0
prendere,5,3,-2,-1,1,1,0
accoltellare,2,2,0,0,-1,0,0
fare,1,3,-2,-1,-1,0,0
impedire,2,10,-8,-1,-1,0,0
versare,2,3,-1,-1,-1,0,0
fare,2,3,-1,-1,-1,0,0
guardare,1,2,-1,-1,-1,0,0
fare,1,4,-3,-1,-1,0,0
mettere,2,11,-9,-1,-1,0,0
fare,6,2,-4,-1,1,0,0
trasformare,1,4,-3,-1,-1,-1,0
cancellare,12,3,-9,-1,1,0,0
studiare,1,3,-2,-1,-1,0,0
fare,1,3,-2,-1,-1,1,0
fare,1,7,-6,-1,-1,0,0
combattere,1,3,-2,-1,-1,-1,0
impegnare,2,7,-5,-1,-1,0,0
mettere,6,2,-4,-1,1,0,0
mettere,2,2,0,0,1,0,0
mettere,1,3,-2,-1,-1,0,0
fermare,2,3,-1,-1,-1,0,0
presentare,5,17,-12,-1,-1,1,0
avere,3,18,-15,-1,-1,0,0
occupare,2,4,-2,-1,-1,0,0
creare,26,6,-20,-1,1,0,0
giocare,5,13,-8,-1,-1,0,0
introdurre,62,3,-59,-1,1,0,0
realizzare,7,3,-4,-1,1,0,0
discutere,24,14,-10,-1,1,0,0
attuare,10,4,-6,-1,1,0,0
registrare,8,7,-1,-1,1,0,0
dare,2,18,-16,-1,-1,0,0
dare,1,13,-12,-1,-1,0,0
riportare,19,4,-15,-1,1,0,0
dare,7,7,0,0,1,0,0
scegliere,2,6,-4,-1,-1,0,0
rimarcare,20,3,-17,-1,1,0,0
raccogliere,7,3,-4,-1,1,0,0
aderire,19,2,-17,-1,1,0,0
chiedere,2,6,-4,-1,-1,0,0
essere,1,3,-2,-1,-1,0,0
ricondurre,10,3,-7,-1,1,0,0
proporre,23,6,17,1,-1,0,0
avere,3,16,-13,-1,-1,0,0
lasciare,3,5,-2,-1,-1,0,0
accrescere,9,29,-20,-1,-1,0,0
ricondurre,18,13,-5,-1,1,0,0
dare,16,3,-13,-1,1,0,0
conoscere,7,3,-4,-1,1,0,0
aggiungere,13,9,4,1,-1,0,0
chiudere,2,20,-18,-1,-1,0,0
affidare,3,3,0,0,1,0,0
coinvolgere,3,6,-3,-1,-1,0,0
fare,1,2,-1,-1,-1,0,0
garantire,3,5,2,1,1,0,0
prendere,2,10,-8,-1,-1,0,0
presentare,5,9,-4,-1,-1,0,0
chiedere,14,3,-11,-1,1,0,0
richiedere,3,5,2,1,1,0,0
svolgere,5,4,-1,-1,1,0,0
impegnare,3,6,-3,-1,-1,0,0
stringere,5,13,-8,-1,-1,0,0
appaltare,2,3,-1,-1,-1,0,0
promettere,2,3,1,1,1,0,0
mandare,7,5,-2,-1,1,0,0
formulare,3,5,-2,-1,-1,0,0
appaltare,2,3,-1,-1,-1,0,0
sottoporre,5,2,3,1,-1,0,0
spendere,5,3,2,1,-1,0,0
esaminare,5,6,-1,-1,-1,0,0
prospettare,10,29,-19,-1,-1,0,0
servire,17,3,-14,-1,1,0,0
aprire,1,7,-6,-1,-1,0,0
confermare,7,3,-4,-1,1,0,0
avere,1,2,-1,-1,-1,0,0
segnare,8,2,-6,-1,1,0,0
prestare,2,18,-16,-1,-1,0,0
rivelare,13,3,-10,-1,1,1,0
avere,3,3,0,0,1,0,0
irrobustire,3,12,-9,-1,-1,0,0
dare,1,6,-5,-1,-1,0,0
meritare,4,20,-16,-1,-1,0,0
rinviare,9,2,-7,-1,1,0,0
consegnare,8,5,-3,-1,1,0,0
chiamare,5,2,-3,-1,1,0,0
formulare,2,4,-2,-1,-1,0,0
fare,1,16,-15,-1,-1,0,0
riferire,6,12,6,1,1,0,0
testimoniare,12,9,3,1,-1,0,0
comportare,9,3,-6,-1,1,0,0
svolgere,9,3,-6,-1,1,0,0
risolvere,11,4,-7,-1,1,0,0
attraversare,5,3,2,1,-1,0,0
raggiungere,5,27,-22,-1,-1,0,0
liberare,5,7,-2,-1,-1,0,0
fare,5,6,-1,-1,-1,0,0
esplodere,5,11,-6,-1,-1,0,0
trasportare,2,3,-1,-1,-1,0,0
rivendicare,2,12,-10,-1,-1,0,0
avviare,3,4,-1,-1,-1,0,0
cercare,1,2,-1,-1,-1,0,0
raggiungere,2,2,0,0,-1,0,0
sferrare,3,2,1,1,-1,0,0
arrivare,3,16,-13,-1,-1,0,0
raccontare,4,8,-4,-1,-1,0,0
porre,1,4,-3,-1,-1,0,0
trarre,3,2,-1,-1,1,0,0
galoppare,2,2,0,0,-1,0,0
mettere,5,28,-23,-1,-1,0,0
trovare,1,17,-16,-1,-1,0,0
offrire,27,3,-24,-1,1,0,0
nominare,17,3,-14,-1,1,0,0
stabilire,3,4,-1,-1,-1,0,0
indirizzare,2,19,17,1,1,0,0
rassicurare,8,13,-5,-1,-1,0,0
raggiungere,7,17,-10,-1,-1,0,0
fare,1,4,-3,-1,-1,0,0
fare,12,4,-8,-1,1,0,0
risultare,12,2,-10,-1,1,0,0
fare,1,3,-2,-1,-1,-1,0
aprire,3,3,0,0,-1,0,0
recuperare,3,7,-4,-1,-1,0,0
raggiungere,3,6,-3,-1,-1,0,0
fissare,19,2,-17,-1,1,0,0
porre,5,7,-2,-1,-1,0,0
ridare,1,3,-2,-1,-1,0,0
lanciare,28,2,-26,-1,1,0,0
affiancare,10,3,-7,-1,1,0,0
lasciare,2,5,-3,-1,-1,0,0
garantire,7,8,-1,-1,-1,0,0
riqualificare,4,9,5,1,1,0,0
mettere,24,2,-22,-1,1,0,0
liberare,2,3,-1,-1,-1,0,0
garantire,4,9,-5,-1,-1,1,0
avere,8,10,-2,-1,-1,0,0
avere,3,3,0,0,1,0,0
ottenere,2,32,-30,-1,-1,0,0
attrarre,2,3,-1,-1,-1,0,0
introdurre,3,4,-1,-1,-1,0,0
raggiungere,4,8,-4,-1,-1,1,0
lasciare,2,4,-2,-1,-1,0,0
accettare,2,8,-6,-1,-1,0,0
mettere,8,2,-6,-1,1,0,0
mantenere,8,8,0,0,-1,0,0
forzare,2,2,0,0,1,0,0
riaprire,2,6,-4,-1,-1,0,0
concordare,4,15,-11,-1,-1,0,0
scoprire,2,23,-21,-1,-1,0,0
suggerire,5,3,-2,-1,1,0,0
prendere,2,3,-1,-1,-1,0,0
dare,2,3,-1,-1,-1,0,0
prospettare,10,9,-1,-1,1,0,0
prevedere,3,2,-1,-1,1,0,0
bloccare,7,4,-3,-1,1,0,0
preferire,5,6,-1,-1,-1,0,0
considerare,1,50,-49,-1,-1,-1,0
lasciare,3,3,0,0,-1,0,0
pesare,2,5,-3,-1,-1,0,0
avere,6,3,-3,-1,1,0,0
trasformare,2,3,-1,-1,-1,0,0
riaffermare,8,6,2,1,-1,0,0
imporre,16,3,-13,-1,1,0,0
confermare,34,2,-32,-1,1,0,0
indicare,20,4,-16,-1,1,0,0
venire,4,5,1,1,1,0,0
seguire,2,5,-3,-1,-1,0,0
sfiorare,2,6,-4,-1,-1,0,0
guidare,2,10,-8,-1,-1,0,0
esaminare,25,3,-22,-1,1,0,0
trasformare,11,9,2,1,-1,0,0
scomporre,3,8,-5,-1,-1,0,0
superare,3,16,-13,-1,-1,0,0
superare,3,11,-8,-1,-1,0,0
ottenere,1,8,-7,-1,-1,0,0
affrontare,6,5,-1,-1,1,0,0
attenuare,8,4,4,1,-1,0,0
affidare,5,6,1,1,1,0,0
applicare,1,3,-2,-1,-1,-1,0
accoppiare,2,29,-27,-1,-1,0,0
mettere,3,5,-2,-1,-1,0,0
sostenere,8,5,-3,-1,1,0,0
apprezzare,2,7,5,1,1,0,0
esplicitare,3,3,0,0,-1,0,0
leggere,22,9,-13,-1,1,0,0
produrre,3,4,1,1,1,0,0
avente,6,2,-4,-1,1,0,0
cambiare,6,2,4,1,-1,0,0
interessare,2,9,-7,-1,-1,0,0
incassare,4,3,1,1,-1,0,0
rappresentare,6,2,-4,-1,1,0,0
fotografare,2,3,-1,-1,-1,0,0
avere,2,2,0,0,1,0,0
offrire,7,3,-4,-1,1,0,0
avere,5,2,-3,-1,1,0,0
rilevare,8,6,2,1,-1,0,0
offrire,2,3,-1,-1,-1,0,0
costringere,2,5,-3,-1,-1,0,0
raffrontare,4,7,-3,-1,-1,1,0
fare,1,5,-4,-1,-1,0,0
indicare,15,3,-12,-1,1,0,0
spiegare,6,20,-14,-1,-1,0,0
diventare,1,3,-2,-1,-1,0,0
avere,8,2,-6,-1,1,0,0
girare,1,3,-2,-1,-1,0,0
utilizzare,5,2,-3,-1,1,0,0
vedere,7,2,5,1,-1,0,0
offrire,3,3,0,0,1,0,0
frantumare,8,18,-10,-1,-1,0,0
affollare,5,7,-2,-1,-1,0,0
affrontare,2,9,-7,-1,-1,0,0
capire,5,6,-1,-1,-1,0,0
mettere,21,9,-12,-1,1,0,0
mandare,4,2,-2,-1,1,0,0
avere,1,4,-3,-1,-1,0,0
prevedere,10,3,-7,-1,1,-1,0
istituire,4,2,-2,-1,1,0,0
fare,2,33,-31,-1,-1,0,0
seguire,30,16,-14,-1,1,0,0
trasformare,2,2,0,0,-1,0,0
dare,2,14,-12,-1,-1,0,0
presentare,19,3,-16,-1,1,0,0
avviare,4,21,-17,-1,-1,0,0
attuare,9,3,-6,-1,1,0,0
richiedere,4,6,-2,-1,-1,0,0
avere,1,3,-2,-1,-1,0,0
realizzare,6,3,3,1,-1,0,0
acquisire,2,43,-41,-1,-1,0,0
contare,1,5,-4,-1,-1,0,0
provocare,4,20,-16,-1,-1,0,0
portare,3,4,1,1,1,0,0
registrare,4,8,-4,-1,-1,0,0
vedere,5,4,-1,-1,1,0,0
registrare,4,5,-1,-1,-1,0,0
seguire,2,4,-2,-1,-1,0,0
portare,11,2,-9,-1,1,0,0
coinvolgere,17,3,-14,-1,1,0,0
affluire,1,32,-31,-1,-1,-1,0
confrontare,3,8,-5,-1,-1,1,0
lasciare,6,3,-3,-1,1,0,0
confrontare,6,5,1,1,-1,1,0
mettere,4,2,-2,-1,1,0,0
garantire,7,2,-5,-1,1,0,0
vivere,3,4,-1,-1,-1,0,0
preparare,1,6,-5,-1,-1,-1,0
raggiungere,7,24,-17,-1,-1,0,0
mettere,8,2,-6,-1,1,0,0
depurare,3,8,-5,-1,-1,0,0
essere,1,6,-5,-1,-1,0,0
porre,27,4,-23,-1,1,0,0
imporre,29,3,-26,-1,1,0,0
suscitare,1,36,-35,-1,-1,0,0
legare,2,3,-1,-1,-1,0,0
consentire,2,3,1,1,1,0,0
considerare,9,36,-27,-1,-1,0,0
arrivare,4,6,2,1,1,0,0
prevedere,1,3,-2,-1,-1,0,0
perseguire,3,9,-6,-1,-1,0,0
investire,4,10,-6,-1,-1,0,0
riformare,2,15,-13,-1,-1,0,0
fare,55,3,-52,-1,1,1,0
seguire,13,9,4,1,-1,0,0
interessare,3,6,-3,-1,-1,0,0
estendere,2,7,-5,-1,-1,0,0
avere,1,6,-5,-1,-1,0,0
concludere,2,4,-2,-1,-1,0,0
aprire,2,2,0,0,-1,0,0
interrompere,4,3,-1,-1,1,0,0
vendere,6,2,-4,-1,1,0,0
fruttare,6,3,-3,-1,1,0,0
replicare,4,2,2,1,-1,0,0
esporre,3,7,-4,-1,-1,0,0
tenere,9,4,5,1,-1,0,0
vedere,2,11,-9,-1,-1,0,0
investire,4,3,1,1,-1,0,0
irrigare,5,5,0,0,1,0,0
vendere,2,5,-3,-1,-1,0,0
completare,1,3,-2,-1,-1,-1,0
fare,1,2,-1,-1,-1,0,0
condurre,3,5,-2,-1,-1,0,0
mostrare,3,4,-1,-1,-1,0,0
valorizzare,1,10,-9,-1,-1,-1,0
evitare,1,4,-3,-1,-1,0,0
costituire,6,13,-7,-1,-1,0,0
avviare,5,3,-2,-1,1,0,0
inserire,38,4,-34,-1,1,0,0
dire,2,6,-4,-1,-1,0,0
sommare,13,9,-4,-1,1,0,0
mantenere,3,2,-1,-1,1,0,0
buttare,2,2,0,0,1,0,0
sbloccare,2,4,-2,-1,-1,0,0
indicare,8,4,-4,-1,1,0,0
evitare,3,7,-4,-1,-1,0,0
lasciare,2,4,2,1,1,0,0
trasferire,5,4,-1,-1,1,0,0
minacciare,4,11,-7,-1,-1,0,0
raggiungere,9,5,4,1,-1,0,0
avere,3,10,-7,-1,-1,0,0
assorbire,6,3,-3,-1,1,0,0
registrare,13,4,-9,-1,1,0,0
conoscere,6,4,-2,-1,1,0,0
trovare,1,2,-1,-1,-1,0,0
trarre,2,6,-4,-1,-1,0,0
estendere,7,14,7,1,1,0,0
lasciare,4,8,4,1,1,0,0
avere,6,3,-3,-1,1,0,0
dare,5,10,-5,-1,-1,0,0
avere,2,3,-1,-1,-1,0,0
recuperare,2,3,-1,-1,-1,0,0
limitare,8,13,-5,-1,-1,0,0
ricevere,27,3,-24,-1,1,0,0
effettuare,2,5,-3,-1,-1,0,0
versare,7,4,-3,-1,1,0,0
richiedere,2,5,-3,-1,-1,0,0
ricevere,3,4,-1,-1,-1,1,0
confondere,3,25,-22,-1,-1,0,0
trovare,1,40,-39,-1,-1,0,0
trattare,2,24,-22,-1,-1,0,0
affidare,8,4,-4,-1,1,0,0
fare,9,3,-6,-1,1,0,0
intrattenere,1,3,-2,-1,-1,0,0
estendere,6,25,-19,-1,-1,0,0
supportare,3,2,-1,-1,1,0,0
avere,35,2,-33,-1,1,1,0
avere,3,30,-27,-1,-1,1,0
protestare,2,6,-4,-1,-1,0,0
fare,2,9,-7,-1,-1,0,0
prolungare,5,3,2,1,-1,0,0
presentare,2,11,-9,-1,-1,0,0
elevare,3,4,-1,-1,-1,0,0
fare,3,9,-6,-1,-1,-1,0
avere,3,2,-1,-1,1,0,0
premiare,2,7,-5,-1,-1,0,0
determinare,2,3,-1,-1,-1,0,0
dedurre,13,3,-10,-1,1,0,0
intendere,13,2,-11,-1,1,0,0
fare,2,10,-8,-1,-1,0,0
riguardare,7,9,-2,-1,-1,0,0
provocare,4,8,-4,-1,-1,0,0
interrogare,2,4,-2,-1,-1,0,0
decapitare,4,43,-39,-1,-1,0,0
portare,9,2,-7,-1,1,0,0
ricevere,5,39,-34,-1,-1,0,0
definire,3,17,-14,-1,-1,0,0
registrare,9,20,-11,-1,-1,0,0
ricoprire,3,8,-5,-1,-1,0,0
scorrere,5,4,-1,-1,1,0,0
compilare,5,20,-15,-1,-1,0,0
compilare,46,3,-43,-1,1,0,0
produrre,6,5,-1,-1,1,0,0
chiedere,3,5,-2,-1,-1,0,0
estendere,6,7,-1,-1,-1,0,0
fare,1,5,-4,-1,-1,0,0
versare,21,30,-9,-1,-1,0,0
sommare,2,13,-11,-1,-1,1,0
confermare,11,43,-32,-1,-1,0,0
ottenere,26,3,-23,-1,1,0,0
inserire,16,4,-12,-1,1,0,0
acquisire,12,3,-9,-1,1,0,0
fare,3,13,-10,-1,-1,0,0
avere,21,2,-19,-1,1,1,0
dare,4,14,-10,-1,-1,0,0
lasciare,1,3,-2,-1,-1,0,0
moltiplicare,2,4,2,1,1,0,0
costituire,5,25,-20,-1,-1,0,0
definire,10,2,-8,-1,1,0,0
fissare,27,5,-22,-1,1,0,0
coprire,2,8,-6,-1,-1,0,0
fare,4,3,1,1,-1,0,0
completare,2,15,-13,-1,-1,0,0
avere,2,4,-2,-1,-1,0,0
chiedere,8,19,-11,-1,-1,0,0
imporre,2,4,-2,-1,-1,0,0
sospettare,40,2,-38,-1,1,0,0
violare,69,3,-66,-1,1,0,0
presentare,2,7,-5,-1,-1,0,0
resuscitare,33,5,-28,-1,1,0,0
annullare,2,9,-7,-1,-1,0,0
calcolare,2,9,-7,-1,-1,0,0
interpretare,31,7,-24,-1,1,0,0
dare,1,7,-6,-1,-1,0,0
aprire,2,19,-17,-1,-1,0,0
dichiarare,5,27,-22,-1,-1,0,0
proporre,3,10,-7,-1,-1,0,0
inseguire,2,3,-1,-1,-1,0,0
dotare,4,19,-15,-1,-1,0,0
ricordare,2,8,-6,-1,-1,0,0
sottoporre,23,4,-19,-1,1,0,0
avvicinare,2,17,-15,-1,-1,0,0
ribadire,5,10,-5,-1,-1,0,0
condannare,3,9,-6,-1,-1,0,0
favorire,3,10,-7,-1,-1,0,0
introdurre,24,6,-18,-1,1,0,0
fare,3,3,0,0,-1,0,0
correggere,12,3,-9,-1,1,0,0
nominare,3,10,-7,-1,-1,0,0
ottenere,2,2,0,0,-1,0,0
prevedere,3,4,-1,-1,-1,0,0
detenere,11,3,-8,-1,1,0,0
raccogliere,5,3,-2,-1,1,0,0
portare,6,5,1,1,-1,0,0
indicare,11,12,-1,-1,-1,0,0
aprire,2,6,-4,-1,-1,0,0
adempiere,14,6,-8,-1,1,0,0
abbattere,3,5,-2,-1,-1,0,0
confermare,27,3,-24,-1,1,0,0
sondare,1,7,-6,-1,-1,0,0
detenere,5,2,-3,-1,1,0,0
trovare,4,4,0,0,1,0,0
rifinanziare,2,17,-15,-1,-1,0,0
trovare,4,2,-2,-1,1,0,0
rifinanziare,2,17,-15,-1,-1,0,0
lasciare,2,3,1,1,1,0,0
lanciare,2,2,0,0,-1,0,0
intensificare,5,4,-1,-1,1,0,0
finanziare,3,14,-11,-1,-1,0,0
collocare,17,4,-13,-1,1,0,0
lanciare,10,5,5,1,-1,0,0
garantire,4,15,-11,-1,-1,0,0
ancorare,2,8,-6,-1,-1,0,0
rivelare,5,4,-1,-1,1,0,0
cedere,3,3,0,0,-1,0,0
lasciare,2,3,1,1,1,0,0
mettere,12,2,-10,-1,1,0,0
controllare,7,30,-23,-1,-1,0,0
avere,3,3,0,0,-1,0,0
cambiare,1,7,-6,-1,-1,0,0
abbinare,8,17,-9,-1,-1,0,0
tenere,9,2,-7,-1,1,0,0
fare,3,7,-4,-1,-1,0,0
cedere,4,9,5,1,1,0,0
chiudere,2,4,-2,-1,-1,0,0
fare,1,7,-6,-1,-1,0,0
trascinare,4,2,-2,-1,1,0,0
rifondere,34,3,-31,-1,1,0,0
curare,20,8,12,1,-1,0,0
condannare,2,7,-5,-1,-1,0,0
scaricare,5,12,7,1,1,0,0
aprire,2,3,-1,-1,-1,0,0
registrare,6,12,-6,-1,-1,0,0
comprimere,3,5,-2,-1,-1,0,0
avere,2,12,-10,-1,-1,0,0
cedere,18,10,8,1,-1,0,0
portare,11,6,-5,-1,1,0,0
vendere,17,3,-14,-1,1,0,0
ridurre,4,3,1,1,-1,0,0
cercare,2,3,-1,-1,-1,0,0
decollare,7,3,-4,-1,1,0,0
aprire,2,2,0,0,-1,0,0
prendere,1,2,-1,-1,-1,0,0
coprire,2,5,-3,-1,-1,0,0
avere,10,11,-1,-1,-1,0,0
portare,1,3,-2,-1,-1,0,0
riportare,2,2,0,0,-1,0,0
spostare,3,10,-7,-1,-1,0,0
tenere,3,8,-5,-1,-1,0,0
realizzare,15,3,-12,-1,1,0,0
mandare,1,2,-1,-1,-1,0,0
riportare,6,4,-2,-1,1,0,0
avere,10,36,-26,-1,-1,0,0
evidenziare,5,13,-8,-1,-1,0,0
lanciare,2,3,-1,-1,-1,0,0
chiudere,4,15,-11,-1,-1,0,0
vendere,1,3,-2,-1,-1,0,0
dare,2,3,-1,-1,-1,0,0
acquistare,5,7,-2,-1,-1,0,0
incassare,1,3,-2,-1,-1,0,0
varare,4,6,-2,-1,-1,0,0
assorbire,5,3,2,1,-1,0,0
aprire,3,7,-4,-1,-1,0,0
attivare,16,3,-13,-1,1,0,0
registrare,3,4,-1,-1,-1,0,0
elevare,5,10,-5,-1,-1,0,0
aderire,4,11,-7,-1,-1,1,0
avere,10,8,2,1,-1,0,0
concludere,3,45,-42,-1,-1,0,0
avere,1,51,-50,-1,-1,0,0
acquistare,32,7,-25,-1,1,0,0
acquisire,2,2,0,0,1,0,0
cedere,6,2,4,1,-1,0,0
rimborsare,3,8,-5,-1,-1,0,0
concludere,2,10,-8,-1,-1,0,0
acquistare,6,3,3,1,-1,0,0
associare,2,3,1,1,1,0,0
indicare,14,9,5,1,-1,0,0
mantenere,10,3,-7,-1,1,0,0
consegnare,2,3,-1,-1,-1,0,0
riallocare,12,5,-7,-1,1,0,0
consolidare,3,12,-9,-1,-1,0,0
fare,2,3,-1,-1,-1,0,0
cedere,5,14,-9,-1,-1,0,0
avere,4,2,-2,-1,1,0,0
facilitare,3,6,-3,-1,-1,0,0
piazzare,9,2,-7,-1,1,0,0
concentrare,1,7,-6,-1,-1,0,0
raccogliere,6,3,-3,-1,1,0,0
portare,10,5,5,1,-1,0,0
conseguire,5,6,-1,-1,-1,0,0
portare,14,23,-9,-1,-1,0,0
concludere,6,7,-1,-1,-1,0,0
portare,5,2,-3,-1,1,0,0
spingere,2,3,-1,-1,-1,0,0
realizzare,18,4,-14,-1,1,0,0
fornire,2,5,-3,-1,-1,0,0
raddoppiare,4,5,-1,-1,-1,0,0
acquistare,9,7,-2,-1,1,0,0
rilevare,11,4,-7,-1,1,0,0
perseguire,6,2,-4,-1,1,0,0
spingere,2,3,-1,-1,-1,0,0
siglare,7,11,-4,-1,-1,0,0
ridurre,9,3,-6,-1,1,0,0
limitare,8,3,-5,-1,1,0,0
acquisire,19,4,-15,-1,1,0,0
rilevare,10,4,-6,-1,1,0,0
raggruppare,3,20,-17,-1,-1,0,0
consolidare,8,10,-2,-1,-1,0,0
raddoppiare,6,3,-3,-1,1,0,0
coprire,2,32,-30,-1,-1,0,0
rilasciare,9,4,5,1,-1,0,0
raggiungere,10,2,-8,-1,1,0,0
puntare,2,4,-2,-1,-1,0,0
esasperare,10,3,-7,-1,1,0,0
trarre,2,5,-3,-1,-1,0,0
riportare,2,4,-2,-1,-1,0,0
riacquisire,6,3,3,1,-1,0,0
reclamare,3,3,0,0,-1,0,0
finanziare,7,10,-3,-1,-1,0,0
avere,2,8,-6,-1,-1,0,0
alzare,5,39,-34,-1,-1,0,0
raggiungere,7,23,-16,-1,-1,0,0
riguardare,4,2,-2,-1,1,0,0
prescrivere,21,8,-13,-1,1,0,0
costituente,5,20,-15,-1,-1,0,0
assicurare,14,10,-4,-1,1,0,0
depurare,6,7,-1,-1,-1,0,0
permettere,3,56,-53,-1,-1,0,0
fornire,3,7,-4,-1,-1,0,0
considerare,3,4,1,1,1,0,0
rapportare,9,6,3,1,-1,0,0
assolvere,11,5,6,1,-1,0,0
subire,6,2,4,1,-1,0,0
ricordare,1,39,-38,-1,-1,0,0
avere,1,12,-11,-1,-1,0,0
avere,1,12,-11,-1,-1,0,0
stravolgere,20,5,-15,-1,1,0,0
fornire,5,4,1,1,-1,0,0
trovare,2,6,-4,-1,-1,0,0
trovare,3,6,-3,-1,-1,0,0
suddividere,1,8,-7,-1,-1,-1,0
costituire,2,11,-9,-1,-1,0,0
trovare,1,4,-3,-1,-1,0,0
specificare,49,3,-46,-1,1,0,0
indicare,34,2,-32,-1,1,-1,0
includere,18,4,-14,-1,1,0,0
porre,4,9,-5,-1,-1,0,0
trovare,1,6,-5,-1,-1,0,0
indicare,17,3,-14,-1,1,0,0
includere,6,2,4,1,-1,0,0
fornire,1,4,-3,-1,-1,0,0
richiedere,24,12,-12,-1,1,0,0
richiedere,24,18,-6,-1,1,0,0
richiedere,7,29,22,1,1,0,0
richiedere,16,17,1,1,1,0,0
richiedere,1,6,-5,-1,-1,0,0
inserire,2,4,-2,-1,-1,0,0
effettuare,16,4,-12,-1,1,0,0
esporre,16,12,4,1,-1,0,0
indicare,1,7,-6,-1,-1,-1,0
esporre,16,4,-12,-1,1,0,0
generare,5,3,2,1,-1,0,0
accogliere,15,4,-11,-1,1,0,0
costituire,12,14,-2,-1,-1,0,0
sostituire,22,7,-15,-1,1,0,0
trovare,3,13,-10,-1,-1,0,0
porre,16,2,-14,-1,1,0,0
esporre,8,5,3,1,-1,0,0
esporre,16,9,7,1,-1,0,0
porre,2,16,-14,-1,-1,0,0
utilizzare,8,4,4,1,-1,0,0
porre,2,9,-7,-1,-1,0,0
aggiungere,28,4,-24,-1,1,0,0
sottrarre,2,4,-2,-1,-1,0,0
modificare,7,4,3,1,-1,0,0
sottrarre,4,4,0,0,1,0,0
avere,3,3,0,0,-1,0,0
aggiungere,4,4,0,0,1,0,0
aggiungere,2,4,2,1,1,0,0
classificare,2,16,-14,-1,-1,0,0
comprendere,8,9,-1,-1,-1,0,0
determinare,1,15,-14,-1,-1,0,0
esporre,8,4,4,1,-1,0,0
perdere,1,8,-7,-1,-1,0,0
rincarare,4,2,2,1,-1,0,0
ridare,4,26,-22,-1,-1,0,0
avere,2,44,-42,-1,-1,0,0
denotare,3,20,-17,-1,-1,0,0
scrollare,14,2,-12,-1,1,0,0
contribuire,51,7,-44,-1,1,0,0
portare,1,16,-15,-1,-1,-1,0
chiudere,2,11,-9,-1,-1,0,0
anticipare,6,3,-3,-1,1,0,0
scontare,2,5,-3,-1,-1,0,0
arretrare,1,5,-4,-1,-1,-1,0
portare,9,8,-1,-1,1,0,0
compiere,6,7,-1,-1,-1,0,0
avere,2,4,-2,-1,-1,0,0
avviare,2,6,-4,-1,-1,0,0
riaprire,5,7,-2,-1,-1,0,0
perdere,3,2,1,1,-1,0,0
gestire,3,9,-6,-1,-1,0,0
fare,2,3,-1,-1,-1,0,0
creare,4,3,1,1,-1,0,0
mettere,8,2,-6,-1,1,0,0
inaugurare,8,2,-6,-1,1,0,0
chiedere,5,9,-4,-1,-1,0,0
chiedere,4,6,-2,-1,-1,0,0
avere,1,7,-6,-1,-1,0,0
chiudere,2,6,-4,-1,-1,0,0
confermare,1,2,-1,-1,-1,0,0
dare,2,5,-3,-1,-1,0,0
avere,1,15,-14,-1,-1,0,0
chiudere,2,12,-10,-1,-1,0,0
annunciare,3,8,-5,-1,-1,0,0
conseguire,5,8,3,1,1,0,0
vendere,5,8,-3,-1,-1,0,0
bloccare,6,6,0,0,-1,0,0
motivare,2,26,-24,-1,-1,0,0
chiudere,3,23,-20,-1,-1,0,0
deridere,3,10,-7,-1,-1,0,0
disporre,5,4,1,1,-1,0,0
percorrere,6,4,-2,-1,1,0,0
apparire,4,2,-2,-1,1,0,0
recare,9,3,-6,-1,1,0,0
portare,4,7,-3,-1,-1,0,0
sapere,4,2,-2,-1,1,1,0
recare,4,4,0,0,1,0,0
portare,2,2,0,0,-1,1,0
vedere,1,3,-2,-1,-1,0,0
sollevare,2,3,-1,-1,-1,0,0
volgere,1,2,-1,-1,-1,-1,0
continuare,2,2,0,0,1,0,0
trovare,5,6,-1,-1,-1,0,0
comunicare,8,3,-5,-1,1,0,0
accogliere,3,2,-1,-1,1,0,0
abbandonare,2,3,-1,-1,-1,0,0
sembrare,7,3,-4,-1,1,0,0
scorgere,2,2,0,0,-1,1,0
vedere,1,3,-2,-1,-1,0,0
vedere,2,2,0,0,1,0,0
acquistare,5,3,-2,-1,1,0,0
acquistare,2,3,-1,-1,-1,0,0
togliere,3,3,0,0,1,0,0
inseguire,1,4,-3,-1,-1,-1,0
calare,2,2,0,0,1,0,0
porgere,4,4,0,0,1,0,0
fare,2,4,-2,-1,-1,0,0
avere,2,2,0,0,1,-1,0
lasciare,2,2,0,0,-1,0,0
scrivere,2,3,-1,-1,-1,0,0
estrarre,2,3,-1,-1,-1,0,0
trovare,1,3,-2,-1,-1,-1,0
lasciare,1,6,-5,-1,-1,-1,0
portare,5,4,-1,-1,1,0,0
ottenere,3,2,-1,-1,1,0,0
distruggere,2,6,-4,-1,-1,0,0
lasciare,3,4,-1,-1,-1,0,0
riscuotere,1,3,-2,-1,-1,0,0
stringere,2,3,-1,-1,-1,0,0
cedere,1,2,-1,-1,-1,0,0
lasciare,2,4,-2,-1,-1,0,0
fumare,4,3,1,1,-1,0,0
portare,12,2,-10,-1,1,0,0
invitare,5,6,-1,-1,-1,0,0
accendere,4,3,1,1,-1,0,0
aprire,2,6,-4,-1,-1,0,0
organizzare,2,4,-2,-1,-1,0,0
comperare,3,3,0,0,-1,0,0
decorare,1,3,-2,-1,-1,-1,0
decorare,1,3,-2,-1,-1,-1,0
riprodurre,2,2,0,0,-1,0,0
convincere,2,7,-5,-1,-1,0,0
offrire,3,6,-3,-1,-1,0,0
produrre,15,14,1,1,-1,0,0
registrare,3,9,6,1,1,0,0
progettare,1,11,-10,-1,-1,-1,0
girare,2,6,-4,-1,-1,0,0
anticipare,7,3,-4,-1,1,0,0
fondare,4,2,-2,-1,1,0,0
caricare,2,7,-5,-1,-1,0,0
credere,2,6,-4,-1,-1,0,0
avvenire,2,3,-1,-1,-1,0,0
capire,1,2,-1,-1,-1,-1,0
fare,2,4,-2,-1,-1,0,0
preparare,6,4,2,1,-1,0,0
progettare,2,2,0,0,-1,0,0
interessare,2,9,-7,-1,-1,0,0
valutare,27,3,-24,-1,1,0,0
suscitare,2,4,-2,-1,-1,0,0
concentrare,2,4,-2,-1,-1,0,0
accusare,2,3,1,1,1,0,0
sostenere,15,2,-13,-1,1,0,0
ottenere,3,12,-9,-1,-1,0,0
garantire,4,2,-2,-1,1,-1,0
dare,1,7,-6,-1,-1,0,0
mettere,6,2,-4,-1,1,0,0
avere,3,6,-3,-1,-1,0,0
giudicare,17,5,12,1,-1,0,0
assegnare,2,5,-3,-1,-1,0,0
misurare,2,11,-9,-1,-1,0,0
vedere,10,5,-5,-1,1,0,0
assegnare,9,7,2,1,-1,0,0
nascondere,3,7,-4,-1,-1,0,0
analizzare,4,2,-2,-1,1,0,0
vendere,3,2,-1,-1,1,0,0
vendere,3,3,0,0,-1,0,0
slittare,10,3,-7,-1,1,0,0
vedere,1,3,-2,-1,-1,0,0
rivelare,4,7,-3,-1,-1,0,0
raccogliere,2,4,-2,-1,-1,0,0
prendere,2,8,-6,-1,-1,0,0
avere,3,4,-1,-1,-1,0,0
sbagliare,3,2,-1,-1,1,0,0
dettare,2,6,-4,-1,-1,0,0
coprire,2,6,-4,-1,-1,0,0
liberare,1,17,-16,-1,-1,-1,0
evitare,2,4,-2,-1,-1,0,0
mettere,3,2,-1,-1,1,0,0
imporre,14,3,-11,-1,1,0,0
trasformare,6,4,2,1,-1,0,0
rivolgere,11,3,-8,-1,1,0,0
fornire,3,3,0,0,-1,0,0
notare,9,3,-6,-1,1,0,0
mettere,19,2,-17,-1,1,0,0
mettere,3,2,-1,-1,1,0,0
chiedere,8,3,-5,-1,1,0,0
mettere,2,3,-1,-1,-1,0,0
contestare,20,3,-17,-1,1,0,0
sperimentare,12,8,-4,-1,1,0,0
portare,4,9,-5,-1,-1,0,0
forzare,5,10,-5,-1,-1,0,0
costare,1,9,-8,-1,-1,-1,0
imporre,1,2,-1,-1,-1,0,0
riconciliare,1,3,-2,-1,-1,-1,0
valutare,2,15,-13,-1,-1,0,0
lasciare,2,9,-7,-1,-1,0,0
dare,2,8,-6,-1,-1,0,0
scavalcare,5,3,-2,-1,1,0,0
mettere,1,3,-2,-1,-1,-1,0
mettere,2,2,0,0,1,0,0
segnare,4,7,-3,-1,-1,0,0
mettere,2,7,-5,-1,-1,0,0
fare,5,3,2,1,-1,0,0
ripensare,2,4,2,1,1,0,0
mettere,2,4,-2,-1,-1,0,0
buttare,2,3,-1,-1,-1,0,0
trattenere,4,4,0,0,1,0,0
notificare,2,5,-3,-1,-1,0,0
trasmettere,32,8,-24,-1,1,0,0
eseguire,1,3,-2,-1,-1,0,0
rivolgere,23,3,-20,-1,1,0,0
pagare,16,3,-13,-1,1,0,0
dare,1,8,-7,-1,-1,0,0
esperire,9,12,-3,-1,-1,0,0
prorogare,7,3,-4,-1,1,0,0
inviare,2,16,-14,-1,-1,0,0
compiere,2,32,-30,-1,-1,0,0
mancare,4,4,0,0,-1,-1,0
inviare,2,14,-12,-1,-1,0,0
esimere,2,16,-14,-1,-1,0,0
esibire,7,3,-4,-1,1,0,0
apporre,3,9,6,1,1,0,0
trasmettere,22,3,-19,-1,1,0,0
omettere,12,6,-6,-1,1,0,0
tenere,6,5,-1,-1,1,0,0
versare,8,16,-8,-1,-1,0,0
dichiarare,22,5,-17,-1,1,0,0
esprimere,2,5,-3,-1,-1,0,0
avere,2,10,-8,-1,-1,0,0
chiedere,12,3,-9,-1,1,0,0
portare,1,7,-6,-1,-1,-1,0
tacciare,2,2,0,0,1,0,0
raccogliere,2,5,-3,-1,-1,0,0
valorizzare,8,15,-7,-1,-1,0,0
mantenere,16,5,-11,-1,1,0,0
mettere,2,3,-1,-1,-1,0,0
promuovere,11,10,1,1,-1,0,0
assumere,6,8,2,1,1,0,0
porre,10,3,-7,-1,1,0,0
porre,32,7,-25,-1,1,0,0
invertire,2,3,-1,-1,-1,0,0
avere,4,5,-1,-1,-1,0,0
sollevare,4,19,-15,-1,-1,0,0
affermare,15,7,8,1,-1,0,0
assicurare,15,4,-11,-1,1,0,0
mettere,5,2,-3,-1,1,0,0
esigere,8,5,-3,-1,1,0,0
affermare,47,15,-32,-1,1,0,0
promuovere,24,15,-9,-1,1,0,0
arricchire,11,4,-7,-1,1,0,0
avere,15,2,-13,-1,1,0,0
offrire,20,3,-17,-1,1,0,0
unire,7,20,-13,-1,-1,0,0
porre,5,3,-2,-1,1,0,0
riproporre,15,7,8,1,-1,0,0
riproporre,12,2,-10,-1,1,0,0
impedire,13,7,-6,-1,1,0,0
determinare,34,5,-29,-1,1,0,0
porre,12,9,-3,-1,1,0,0
costituire,5,9,-4,-1,-1,0,0
mettere,7,2,-5,-1,1,0,0
accrescere,3,7,-4,-1,-1,0,0
avere,3,3,0,0,-1,0,0
attrarre,9,3,-6,-1,1,0,0
orientare,10,4,-6,-1,1,0,0
rilanciare,8,7,-1,-1,1,0,0
stimolare,35,6,-29,-1,1,0,0
porre,3,2,-1,-1,1,0,0
conseguire,3,5,-2,-1,-1,0,0
vedere,4,2,-2,-1,1,0,0
affrontare,6,4,-2,-1,1,0,0
vivere,11,9,-2,-1,1,0,0
avere,36,4,-32,-1,1,0,0
ricercare,7,22,-15,-1,-1,0,0
superare,7,7,0,0,1,0,0
avere,1,7,-6,-1,-1,0,0
caratterizzare,11,2,-9,-1,1,0,0
considerare,17,4,-13,-1,1,0,0
ispirare,3,6,-3,-1,-1,0,0
esprimere,1,24,-23,-1,-1,0,0
sviluppare,2,17,-15,-1,-1,0,0
pesare,2,13,-11,-1,-1,0,0
sviluppare,4,3,-1,-1,1,0,0
mettere,5,2,-3,-1,1,0,0
determinare,2,7,-5,-1,-1,0,0
risolvere,1,4,-3,-1,-1,-1,0
accentuare,55,3,-52,-1,1,-1,0
comportare,4,6,-2,-1,-1,0,0
condizionare,3,6,-3,-1,-1,0,0
mettere,5,2,-3,-1,1,0,0
affidare,7,10,-3,-1,-1,0,0
fare,2,19,-17,-1,-1,0,0
spostare,1,4,-3,-1,-1,0,0
sostenere,7,3,-4,-1,1,0,0
difendere,6,3,-3,-1,1,0,0
portare,6,2,-4,-1,1,-1,0
tagliare,9,3,-6,-1,1,0,0
adeguare,15,8,7,1,-1,0,0
rilanciare,4,3,-1,-1,1,0,0
dare,1,4,-3,-1,-1,0,0
collocare,1,30,-29,-1,-1,-1,0
dare,26,6,-20,-1,1,0,0
dare,39,14,-25,-1,1,0,0
porre,7,3,-4,-1,1,0,0
porre,1,14,-13,-1,-1,0,0
contrastare,4,35,-31,-1,-1,0,0
costituire,3,3,0,0,-1,0,0
rendere,2,8,-6,-1,-1,0,0
rappresentare,9,19,-10,-1,-1,0,0
porre,2,7,-5,-1,-1,0,0
attendere,2,6,-4,-1,-1,0,0
impedire,8,3,-5,-1,1,0,0
creare,3,6,3,1,1,0,0
mettere,8,2,-6,-1,1,0,0
ricercare,2,13,-11,-1,-1,0,0
contrastare,28,2,-26,-1,1,0,0
formare,21,8,-13,-1,1,0,0
collegare,7,8,-1,-1,-1,0,0
orientare,5,28,-23,-1,-1,0,0
estendere,9,18,-9,-1,-1,0,0
superare,8,5,-3,-1,1,0,0
rivendicare,11,3,-8,-1,1,0,0
affermare,6,11,5,1,1,0,0
garantire,44,8,-36,-1,1,0,0
dare,3,3,0,0,1,0,0
trovare,1,6,-5,-1,-1,0,0
costituire,2,14,-12,-1,-1,0,0
percepire,15,3,-12,-1,1,0,0
contrastare,21,6,-15,-1,1,0,0
ribadire,8,4,-4,-1,1,0,0
costituire,6,3,-3,-1,1,0,0
dare,2,12,-10,-1,-1,0,0
avere,5,2,-3,-1,1,-1,0
mettere,2,3,-1,-1,-1,0,0
trovare,4,46,-42,-1,-1,0,0
costruire,8,30,-22,-1,-1,0,0
spingere,2,3,-1,-1,-1,0,0
perseguire,3,5,2,1,1,0,0
sostituire,48,25,-23,-1,1,0,0
esprimere,6,5,-1,-1,1,0,0
porre,8,3,-5,-1,1,0,0
sollecitare,11,12,1,1,1,0,0
chiamare,17,2,-15,-1,1,0,0
rimettere,6,2,-4,-1,1,0,0
assumere,1,2,-1,-1,-1,0,0
modificare,4,10,-6,-1,-1,0,0
spostare,10,4,-6,-1,1,0,0
sbloccare,3,10,-7,-1,-1,0,0
avviare,2,2,0,0,1,0,0
mettere,24,2,-22,-1,1,0,0
conquistare,4,13,-9,-1,-1,0,0
conciliare,3,6,-3,-1,-1,0,0
dare,1,3,-2,-1,-1,0,0
considerare,1,4,-3,-1,-1,-1,0
comportare,4,8,-4,-1,-1,0,0
caratterizzare,10,6,4,1,-1,0,0
dare,15,7,-8,-1,1,0,0
coprire,4,5,1,1,1,0,0
determinare,9,27,18,1,1,0,0
condurre,2,14,-12,-1,-1,0,0
rafforzare,6,19,-13,-1,-1,0,0
emergere,43,3,-40,-1,1,0,0
condizionare,2,8,-6,-1,-1,0,0
trovare,1,18,-17,-1,-1,0,0
colpire,18,3,-15,-1,1,0,0
determinare,2,28,-26,-1,-1,0,0
sollecitare,18,9,-9,-1,1,0,0
avanzare,18,4,-14,-1,1,0,0
avere,4,21,-17,-1,-1,0,0
porre,33,8,-25,-1,1,0,0
dare,1,20,-19,-1,-1,0,0
dare,5,7,-2,-1,-1,0,0
delegare,3,3,0,0,1,0,0
manifestare,3,3,0,0,-1,0,0
fare,1,5,-4,-1,-1,0,0
combattere,17,7,-10,-1,1,0,0
riavviare,2,2,0,0,-1,0,0
fare,1,7,-6,-1,-1,0,0
proibire,24,3,-21,-1,1,0,0
aprire,21,20,-1,-1,1,0,0
realizzare,3,3,0,0,1,0,0
ricercare,2,28,-26,-1,-1,0,0
sollecitare,11,30,-19,-1,-1,0,0
portare,4,10,-6,-1,-1,0,0
concentrare,3,10,-7,-1,-1,0,0
concepire,2,4,-2,-1,-1,0,0
aggregare,6,2,-4,-1,1,0,0
esercitare,3,18,-15,-1,-1,0,0
definire,3,6,-3,-1,-1,0,0
inventare,2,3,-1,-1,-1,0,0
avere,3,5,-2,-1,-1,0,0
affidare,3,16,-13,-1,-1,0,0
esporre,5,6,-1,-1,-1,0,0
informare,1,14,-13,-1,-1,-1,0
edificare,19,4,-15,-1,1,0,0
trovare,15,10,-5,-1,1,0,0
girare,1,3,-2,-1,-1,0,0
suonare,2,3,-1,-1,-1,0,0
rievocare,20,9,-11,-1,1,0,0
idolatrare,1,4,-3,-1,-1,0,0
conservare,2,2,0,0,-1,0,0
elargire,2,31,-29,-1,-1,0,0
dare,2,6,-4,-1,-1,0,0
profilare,3,3,0,0,1,0,0
avere,5,4,-1,-1,1,0,0
accentuare,4,18,-14,-1,-1,0,0
minare,11,10,-1,-1,1,0,0
strumentalizzare,5,31,-26,-1,-1,0,0
offrire,2,3,-1,-1,-1,0,0
combattere,2,7,-5,-1,-1,0,0
sentire,9,2,7,1,-1,0,0
ammirare,6,2,4,1,-1,0,0
perdere,2,4,-2,-1,-1,0,0
liberare,1,17,-16,-1,-1,-1,0
iscrivere,2,19,-17,-1,-1,0,0
custodire,2,4,-2,-1,-1,0,0
indirizzare,3,4,-1,-1,-1,0,0
scegliere,1,19,-18,-1,-1,0,0
riproporre,1,3,2,1,1,0,0
dialogare,2,6,-4,-1,-1,0,0
finanziare,15,5,-10,-1,1,0,0
lasciare,6,3,-3,-1,1,0,0
dare,1,2,-1,-1,-1,1,0
avere,4,3,1,1,-1,-1,0
cambiare,5,6,-1,-1,-1,0,0
imparare,2,3,-1,-1,-1,0,0
inviare,6,4,-2,-1,1,0,0
trasmettere,13,6,-7,-1,1,0,0
avere,2,3,1,1,1,0,0
produrre,1,4,-3,-1,-1,0,0
stabilire,12,3,-9,-1,1,0,0
proporre,11,8,-3,-1,1,0,0
rendere,1,5,-4,-1,-1,0,0
spandere,13,2,-11,-1,1,0,0
rendere,1,19,-18,-1,-1,0,0
ricordare,10,2,8,1,-1,0,0
centrare,11,3,-8,-1,1,0,0
ricondurre,2,20,-18,-1,-1,0,0
mandare,7,2,-5,-1,1,0,0
dare,4,36,-32,-1,-1,0,0
mostrare,7,18,11,1,1,0,0
avere,8,3,-5,-1,1,0,0
avere,16,4,-12,-1,1,0,0
maneggiare,2,4,2,1,1,0,0
scrivere,2,4,-2,-1,-1,0,0
disdire,8,6,-2,-1,1,0,0
mettere,1,6,-5,-1,-1,0,0
insegnare,3,3,0,0,1,0,0
preparare,7,3,-4,-1,1,0,0
avere,1,2,-1,-1,-1,0,0
avere,3,5,-2,-1,-1,0,0
accompagnare,2,2,0,0,-1,0,0
portare,1,14,-13,-1,-1,-1,0
tuffare,1,21,-20,-1,-1,-1,0
aprire,17,3,-14,-1,1,0,0
dare,2,11,-9,-1,-1,0,0
ricevere,6,3,-3,-1,1,0,0
mettere,2,2,0,0,1,0,0
stare,7,2,-5,-1,1,0,0
accomodare,2,4,-2,-1,-1,0,0
aprire,2,4,-2,-1,-1,0,0
raccogliere,1,3,-2,-1,-1,0,0
portare,19,3,-16,-1,1,0,0
colpire,3,6,3,1,1,0,0
arrestare,2,7,-5,-1,-1,0,0
mandare,2,3,-1,-1,-1,0,0
fare,6,26,-20,-1,-1,0,0
inviare,2,7,-5,-1,-1,0,0
avvertire,2,3,-1,-1,-1,0,0
riunire,19,4,-15,-1,1,0,0
inviare,18,2,-16,-1,1,0,0
assicurare,13,2,-11,-1,1,0,0
portare,2,2,0,0,1,0,0
conservare,2,11,-9,-1,-1,0,0
prevedere,10,6,-4,-1,1,0,0
dare,1,4,-3,-1,-1,0,0
fare,2,2,0,0,-1,0,0
puntare,2,37,-35,-1,-1,0,0
ottenere,19,3,-16,-1,1,0,0
aprire,3,18,-15,-1,-1,0,0
lasciare,4,2,-2,-1,1,0,0
indossare,11,2,-9,-1,1,0,0
abbandonare,4,6,2,1,1,0,0
festeggiare,6,5,1,1,-1,0,0
proporre,7,3,-4,-1,1,0,0
visitare,15,7,-8,-1,1,0,0
trasformare,1,14,-13,-1,-1,-1,0
cambiare,1,6,-5,-1,-1,0,0
accompagnare,3,3,0,0,1,0,0
accogliere,1,4,-3,-1,-1,-1,0
accogliere,2,2,0,0,-1,0,0
muovere,2,8,-6,-1,-1,0,0
stuprare,2,3,-1,-1,-1,0,0
inchiodare,8,11,-3,-1,-1,0,0
pretendere,3,5,-2,-1,-1,0,0
risvegliare,6,3,-3,-1,1,0,0
strappare,2,3,-1,-1,-1,0,0
dare,2,11,-9,-1,-1,0,0
chiedere,1,2,-1,-1,-1,0,0
fare,1,4,-3,-1,-1,0,0
scendere,23,2,-21,-1,1,0,0
saltare,2,3,-1,-1,-1,0,0
puntare,2,3,-1,-1,-1,0,0
firmare,2,6,-4,-1,-1,0,0
portare,2,6,-4,-1,-1,0,0
incontrare,3,13,-10,-1,-1,0,0
raccogliere,3,10,-7,-1,-1,0,0
impiegare,3,20,-17,-1,-1,0,0
fare,2,4,-2,-1,-1,0,0
eliminare,2,7,-5,-1,-1,0,0
avere,2,2,0,0,-1,0,0
affidare,1,4,-3,-1,-1,0,0
portare,1,4,-3,-1,-1,-1,0
tenere,3,3,0,0,1,0,0
superare,4,2,-2,-1,1,0,0
tranciare,2,2,0,0,-1,0,0
mettere,9,2,-7,-1,1,0,0
segnalare,2,6,-4,-1,-1,0,0
lasciare,18,5,-13,-1,1,0,0
organizzare,3,3,0,0,-1,0,0
suonare,2,27,-25,-1,-1,0,0
dividere,2,7,-5,-1,-1,0,0
tirare,4,3,1,1,-1,0,0
avere,5,8,-3,-1,-1,0,0
pagare,2,3,-1,-1,-1,0,0
avere,5,3,2,1,-1,0,0
mantenere,6,2,-4,-1,1,0,0
dare,2,3,-1,-1,-1,0,0
guardare,1,2,-1,-1,-1,-1,0
trovare,2,3,-1,-1,-1,0,0
avere,5,3,2,1,-1,0,0
togliere,1,4,-3,-1,-1,0,0
vedere,2,3,1,1,1,0,0
vendere,3,14,-11,-1,-1,0,0
prevedere,12,19,-7,-1,-1,0,0
creare,3,3,0,0,-1,0,0
presentare,14,2,-12,-1,1,0,0
garantire,5,8,-3,-1,-1,0,0
portare,2,12,-10,-1,-1,0,0
scoprire,2,2,0,0,1,-1,0
mettere,2,2,0,0,1,0,0
rivelare,1,3,-2,-1,-1,-1,0
applicare,1,6,-5,-1,-1,-1,0
regalare,10,4,-6,-1,1,0,0
togliere,2,4,-2,-1,-1,0,0
sospettare,2,4,-2,-1,-1,0,0
sottoporre,3,2,1,1,-1,0,0
mettere,2,3,1,1,1,0,0
ottenere,1,5,-4,-1,-1,0,0
dire,1,2,-1,-1,-1,-1,0
seguire,2,5,-3,-1,-1,0,0
temere,4,2,-2,-1,1,0,0
avere,1,3,-2,-1,-1,0,0
avere,1,3,-2,-1,-1,0,0
lasciare,13,3,-10,-1,1,0,0
provocare,5,4,-1,-1,1,0,0
costringere,2,3,-1,-1,-1,0,0
tenere,2,4,2,1,1,0,0
avere,5,29,-24,-1,-1,0,0
limitare,6,8,2,1,1,0,0
guardare,4,4,0,0,1,0,0
ridare,1,3,-2,-1,-1,-1,0
dare,3,3,0,0,-1,0,0
sollevare,1,9,-8,-1,-1,0,0
ricevere,1,15,-14,-1,-1,0,0
detenere,3,7,-4,-1,-1,0,0
imprimere,3,6,-3,-1,-1,0,0
concentrare,3,11,-8,-1,-1,0,0
sconvolgere,3,3,0,0,-1,0,0
lasciare,2,3,-1,-1,-1,0,0
chiudere,2,2,0,0,1,0,0
privatizzare,5,2,-3,-1,1,0,0
regalare,1,4,-3,-1,-1,-1,0
mettere,5,2,-3,-1,1,0,0
affidare,4,7,3,1,1,0,0
passare,31,2,-29,-1,1,0,0
raggiungere,5,5,0,0,1,0,0
trovare,3,13,-10,-1,-1,0,0
rappresentare,2,4,-2,-1,-1,0,0
presentare,42,6,-36,-1,1,0,0
mettere,9,2,-7,-1,1,0,0
fissare,6,3,-3,-1,1,0,0
triplicare,2,3,-1,-1,-1,0,0
concentrare,2,10,-8,-1,-1,0,0
avere,1,11,-10,-1,-1,1,0
avere,2,3,-1,-1,-1,0,0
aspettare,10,3,-7,-1,1,0,0
portare,3,6,-3,-1,-1,0,0
limitare,2,14,-12,-1,-1,0,0
immaginare,4,5,-1,-1,-1,0,0
toccare,4,4,0,0,1,0,0
comprimere,5,3,2,1,-1,0,0
presentare,4,5,-1,-1,-1,0,0
chiudere,2,6,-4,-1,-1,0,0
attribuire,5,27,-22,-1,-1,0,0
influire,28,3,-25,-1,1,0,0
nominare,2,3,-1,-1,-1,0,0
accettare,2,5,-3,-1,-1,0,0
affrontare,8,25,-17,-1,-1,0,0
volere,2,7,-5,-1,-1,0,0
frenare,2,3,-1,-1,-1,0,0
rubricare,33,5,-28,-1,1,0,0
ridurre,7,3,-4,-1,1,0,0
tornare,2,3,-1,-1,-1,0,0
dimostrare,1,22,-21,-1,-1,-1,0
strappare,8,5,-3,-1,1,0,0
subire,7,4,-3,-1,1,0,0
dimostrare,3,2,-1,-1,1,0,0
arrivare,4,3,-1,-1,1,0,0
parlare,9,3,6,1,-1,0,0
approvare,2,5,-3,-1,-1,0,0
pulire,3,19,-16,-1,-1,0,0
correggere,2,3,-1,-1,-1,0,0
raggiungere,5,3,-2,-1,1,0,0
calcolare,3,15,-12,-1,-1,0,0
portare,9,2,-7,-1,1,0,0
chiudere,2,6,-4,-1,-1,0,0
dare,2,12,-10,-1,-1,0,0
celebrare,5,3,2,1,-1,0,0
esporre,9,4,-5,-1,1,0,0
inviare,2,2,0,0,-1,0,0
consegnare,13,6,-7,-1,1,0,0
riassumere,6,3,3,1,-1,0,0
votare,13,3,-10,-1,1,0,0
invitare,6,33,-27,-1,-1,0,0
accogliere,2,3,-1,-1,-1,0,0
rovesciare,1,9,-8,-1,-1,0,0
inscenare,2,4,-2,-1,-1,0,0
montare,8,3,-5,-1,1,0,0
circondare,3,9,-6,-1,-1,0,0
ripagare,1,22,-21,-1,-1,-1,0
lanciare,6,2,-4,-1,1,0,0
ripetere,4,4,0,0,1,0,0
sentire,3,3,0,0,-1,0,0
passare,2,2,0,0,1,0,0
registrare,5,4,1,1,-1,0,0
prendere,2,10,-8,-1,-1,0,0
paragonare,2,8,-6,-1,-1,0,0
dare,3,4,-1,-1,-1,0,0
paragonare,3,15,-12,-1,-1,1,0
rivolgere,3,5,-2,-1,-1,0,0
sfruttare,11,12,-1,-1,-1,0,0
prevedere,9,3,-6,-1,1,0,0
paragonare,2,11,-9,-1,-1,1,0
aprire,2,2,0,0,-1,0,0
ripulire,2,5,-3,-1,-1,0,0
permettere,2,9,-7,-1,-1,0,0
dare,2,3,-1,-1,-1,1,0
assalire,6,4,-2,-1,1,0,0
riprendere,1,3,-2,-1,-1,0,0
lanciare,6,33,-27,-1,-1,0,0
ricollegare,4,17,-13,-1,-1,0,0
invocare,2,3,1,1,1,0,0
arginare,3,3,0,0,1,0,0
avere,6,3,-3,-1,1,0,0
pagare,2,7,-5,-1,-1,0,0
avere,3,6,-3,-1,-1,0,0
stroncare,2,3,-1,-1,-1,0,0
chiedere,5,10,-5,-1,-1,1,0
riempire,3,3,0,0,-1,1,0
usare,1,3,-2,-1,-1,-1,0
invitare,2,3,-1,-1,-1,0,0
richiamare,28,8,20,1,-1,0,0
fare,1,15,-14,-1,-1,0,0
entrare,10,3,-7,-1,1,0,0
aumentare,7,2,-5,-1,1,0,0
difendere,3,2,-1,-1,1,0,0
analizzare,2,6,-4,-1,-1,0,0
fare,3,4,-1,-1,-1,0,0
trovare,4,21,17,1,1,0,0
fare,11,3,-8,-1,1,0,0
stabilire,12,5,-7,-1,1,0,0
concedere,2,3,-1,-1,-1,0,0
dosare,7,3,-4,-1,1,0,0
gettare,1,3,-2,-1,-1,0,0
dichiarare,5,4,-1,-1,1,0,0
portare,9,3,-6,-1,1,0,0
inviare,2,4,-2,-1,-1,0,0
mettere,1,2,-1,-1,-1,-1,0
discutere,2,3,1,1,1,0,0
ricevere,5,4,1,1,-1,0,0
simulare,13,2,-11,-1,1,0,0
trasportare,1,4,-3,-1,-1,0,0
aumentare,6,3,-3,-1,1,0,0
provocare,13,3,-10,-1,1,0,0
denunciare,3,21,-18,-1,-1,-1,0
perdere,7,4,-3,-1,1,0,0
portare,6,2,4,1,-1,0,0
ridurre,6,10,-4,-1,-1,0,0
lasciare,6,4,2,1,-1,-1,0
riprendere,7,4,3,1,-1,0,0
revocare,9,4,-5,-1,1,0,0
concludere,6,9,3,1,1,0,0
dirigere,3,2,-1,-1,1,0,0
frequentare,6,26,-20,-1,-1,0,0
raccontare,44,9,-35,-1,1,0,0
portare,1,4,-3,-1,-1,0,0
avere,36,3,-33,-1,1,0,0
sostenere,18,3,-15,-1,1,0,0
guidare,6,3,-3,-1,1,0,0
portare,2,2,0,0,-1,0,0
rinviare,1,3,-2,-1,-1,-1,0
imporre,13,3,-10,-1,1,0,0
tirare,2,4,-2,-1,-1,0,0
mettere,13,2,-11,-1,1,0,0
fare,1,3,-2,-1,-1,0,0
risparmiare,3,3,0,0,1,0,0
riempire,2,4,-2,-1,-1,0,0
dare,1,2,-1,-1,-1,0,0
avere,5,2,-3,-1,1,0,0
rimettere,2,2,0,0,1,0,0
ripetere,1,2,-1,-1,-1,-1,0
raccontare,2,3,1,1,1,0,0
convocare,3,9,-6,-1,-1,0,0
avere,5,14,-9,-1,-1,0,0
accertare,4,5,-1,-1,-1,0,0
trovare,2,6,-4,-1,-1,0,0
usare,2,3,1,1,1,0,0
fornire,7,3,-4,-1,1,0,0
fornire,18,2,-16,-1,1,0,0
riguardare,3,6,-3,-1,-1,0,0
preparare,2,2,0,0,-1,0,0
chiedere,5,4,-1,-1,1,0,0
chiamare,8,2,-6,-1,1,0,0
fare,1,4,-3,-1,-1,0,0
prendere,2,10,-8,-1,-1,0,0
sorvolare,2,3,1,1,1,0,0
avere,10,2,-8,-1,1,0,0
sottoporre,11,17,6,1,1,0,0
fare,1,6,-5,-1,-1,0,0
avere,2,17,-15,-1,-1,0,0
decidere,3,4,-1,-1,-1,0,0
lanciare,2,22,-20,-1,-1,0,0
aumentare,5,3,2,1,-1,0,0
percorrere,2,4,-2,-1,-1,0,0
