Verb,NP_len,PP_len,Len_diff,Len,Arg_status,Pronominality,Order
completar,5,24,19,1,1,0,1
ofrecer,6,13,7,1,1,0,1
recoger,35,3,32,1,-1,0,1
tomar,4,2,2,1,-1,0,1
producir,2,4,2,1,1,0,1
incentivar,11,3,8,1,-1,0,1
terminar,1,4,3,1,1,1,1
tener,5,4,-1,-1,1,0,1
reducir,1,2,1,1,1,1,1
recibir,21,5,-16,-1,1,0,1
proporcionar,11,5,-6,-1,1,0,1
fusionar,6,16,10,1,1,0,1
contar,2,3,1,1,1,0,1
emplear,5,8,3,1,1,0,1
poner,5,2,3,1,-1,0,1
volver,2,3,1,1,1,0,1
estimar,8,7,-1,-1,1,0,1
difundir,7,11,4,1,1,0,1
anunciar,12,13,1,1,1,0,1
cubrir,3,3,0,0,1,0,1
urgir,6,40,34,1,1,0,1
cumplir,4,7,3,1,1,0,1
insertar,3,4,1,1,1,0,1
dar,4,7,3,1,1,0,1
distinguir,8,4,4,1,-1,0,1
impedir,2,3,1,1,1,0,1
demandar,2,2,0,0,1,0,1
dividir,3,3,0,0,1,0,1
tramitar,1,4,3,1,1,1,1
pasar,10,5,5,1,-1,0,1
cerrar,3,7,4,1,1,0,1
tomar,7,2,5,1,-1,0,1
perder,3,3,0,0,1,0,1
cerrar,1,6,5,1,1,0,1
presentar,23,7,16,1,-1,0,1
dar,1,3,2,1,1,0,1
engrosar,4,8,4,1,1,0,1
formalizar,12,23,11,1,1,0,1
administrar,4,2,2,1,-1,0,1
presentar,1,12,11,1,1,1,1
dar,2,6,4,1,1,0,1
incrementar,1,6,5,1,1,1,1
poner,11,3,8,1,-1,0,1
convocar,2,7,5,1,1,0,1
condenar,6,3,3,1,-1,0,1
revolver,4,10,6,1,1,0,1
tener,6,14,8,1,1,0,1
hacer,2,12,10,1,1,0,1
intercambiar,2,4,2,1,1,0,1
expulsar,2,2,0,0,1,0,1
tener,1,2,1,1,1,0,1
recibir,8,2,6,1,-1,0,1
solicitar,13,14,1,1,1,0,1
aumentar,2,6,4,1,1,0,1
dificultar,7,19,12,1,1,0,1
preparar,5,4,1,1,-1,0,1
llamar,2,10,8,1,1,0,1
recibir,6,3,3,1,-1,0,1
representar,2,15,13,1,1,0,1
competir,3,5,2,1,1,0,1
aplazar,2,3,-1,-1,-1,0,1
contar,9,8,-1,-1,1,0,1
mantener,1,19,18,1,1,0,1
crear,1,22,21,1,1,1,1
enviar,1,2,1,1,1,0,1
vender,7,7,0,0,1,0,1
suponer,4,7,3,1,1,0,1
sufrir,2,26,24,1,1,0,1
tratar,3,3,0,0,1,0,1
dar,1,3,2,1,1,0,1
engrosar,4,8,4,1,1,0,1
formalizar,12,23,11,1,1,0,1
administrar,4,2,2,1,-1,0,1
presentar,1,8,7,1,1,1,1
verter,2,10,8,1,1,0,1
verter,2,25,23,1,1,0,1
luchar,7,5,-2,-1,1,0,1
poner,5,2,3,1,-1,0,1
agarrar,1,3,2,1,1,1,1
responder,3,4,1,1,1,0,1
conducir,1,4,3,1,1,1,1
rescatar,3,2,1,1,-1,0,1
llamar,2,44,42,1,1,0,1
reducir,11,3,-8,-1,1,0,1
situar,7,11,4,1,1,0,1
recurrir,5,6,1,1,1,0,1
situar,4,8,4,1,1,0,1
converger,8,6,-2,-1,1,0,1
abordar,10,3,7,1,-1,0,1
situar,4,10,6,1,1,0,1
pedir,2,10,8,1,1,0,1
ocupar,2,27,25,1,1,0,1
tener,1,39,38,1,1,0,1
ocupar,5,7,-2,-1,-1,0,1
registrar,7,2,5,1,-1,0,1
controlar,16,5,11,1,-1,0,1
obtener,12,2,10,1,-1,0,1
acabar,5,4,-1,-1,1,0,1
acabar,4,3,1,1,-1,0,1
visitar,2,3,-1,-1,-1,0,1
suponer,4,7,3,1,1,0,1
sufrir,2,26,24,1,1,0,1
fijar,5,4,-1,-1,1,0,1
levantar,3,6,3,1,1,0,1
romper,19,3,16,1,-1,0,1
recibir,32,4,28,1,-1,0,1
analizar,1,3,2,1,1,1,1
acudir,11,3,8,1,-1,0,1
pedir,4,5,1,1,1,0,1
atacar,6,4,-2,-1,1,0,1
someter,2,5,3,1,1,0,1
poner,17,2,15,1,-1,0,1
agregar,14,3,11,1,-1,0,1
deportar,10,8,2,1,-1,0,1
garantizar,8,9,1,1,1,0,1
representar,2,22,20,1,1,0,1
sufrir,3,8,5,1,1,0,1
sustituir,15,4,11,1,-1,0,1
continuar,8,24,16,1,1,0,1
perpetuar,2,3,1,1,1,0,1
sacar,2,3,1,1,1,0,1
lanzar,3,5,2,1,1,0,1
entrevistar,15,3,12,1,-1,0,1
hablar,5,3,-2,-1,1,0,1
faltar,4,2,2,1,-1,0,1
sancionar,2,9,7,1,1,0,1
poseer,2,5,3,1,1,0,1
aprobar,1,2,1,1,1,1,1
soportar,5,9,4,1,1,0,1
atacar,2,7,5,1,1,0,1
ayudar,14,3,11,1,-1,0,1
impulsar,5,3,2,1,-1,0,1
apoyar,23,9,-14,-1,1,0,1
respaldar,9,17,8,1,1,0,1
criticar,23,2,21,1,-1,0,1
recibir,7,2,-5,-1,1,0,1
cerrar,2,12,10,1,1,0,1
romper,2,2,0,0,-1,1,1
hacer,3,6,3,1,1,0,1
contemplar,2,7,5,1,1,0,1
visitar,2,11,9,1,1,0,1
poner,4,5,-1,-1,-1,0,1
llevar,1,2,1,1,1,1,1
levantar,1,2,1,1,1,0,1
plantar,2,3,-1,-1,-1,0,1
quedar,1,6,5,1,1,0,1
devolver,1,3,2,1,1,1,1
poner,1,3,2,1,1,0,1
echar,3,2,-1,-1,1,0,1
emitir,7,4,3,1,-1,0,1
sentir,1,3,2,1,1,0,1
ahincar,1,3,2,1,1,1,1
oír,6,3,3,1,-1,0,1
decapitar,2,3,1,1,1,0,1
concebir,1,4,3,1,1,1,1
desprender,1,3,2,1,1,1,1
ver,2,3,1,1,1,0,1
escapar,1,2,1,1,1,1,1
quedar,1,3,2,1,1,0,1
sacar,1,6,5,1,1,1,1
bautizar,3,18,15,1,1,0,1
tomar,2,4,2,1,1,0,1
decir,1,16,15,1,1,0,1
recoger,3,2,-1,-1,1,0,1
sentar,1,6,5,1,1,0,1
tener,2,6,4,1,1,0,1
poner,1,5,4,1,1,1,1
suscribir,12,6,6,1,-1,0,1
imponer,3,6,-3,-1,-1,0,1
confortar,1,4,3,1,1,1,1
derramar,3,4,1,1,1,0,1
beber,4,2,-2,-1,1,0,1
jugar,9,2,7,1,-1,1,1
tirar,5,5,0,0,-1,-1,1
comportar,1,6,5,1,1,1,1
poner,2,3,1,1,1,0,1
andar,1,5,4,1,1,0,1
practicar,1,8,7,1,1,1,1
esperar,4,3,1,1,-1,0,1
llevar,1,3,2,1,1,1,1
encontrar,1,3,2,1,1,0,1
seguir,5,3,2,1,-1,0,1
reunir,6,2,-4,-1,1,0,1
pisar,2,10,8,1,1,0,1
sorprender,4,25,21,1,1,0,1
resultar,2,2,0,0,1,-1,1
eliminar,2,30,28,1,1,0,1
tener,5,3,2,1,-1,0,1
multar,3,17,14,1,1,0,1
poner,7,24,17,1,1,0,1
meter,5,4,-1,-1,1,0,1
aplicar,7,5,2,1,-1,0,1
encerrar,1,5,4,1,1,1,1
tener,8,3,5,1,-1,0,1
enguarrar,1,10,9,1,1,0,1
dejar,5,3,2,1,-1,0,1
dar,3,8,5,1,1,0,1
poner,1,2,1,1,1,1,1
dar,1,8,7,1,1,1,1
registrar,3,5,2,1,1,0,1
inscribir,3,7,4,1,1,0,1
destrozar,9,3,-6,-1,1,0,1
celebrar,3,5,2,1,1,0,1
escribir,7,2,5,1,-1,0,1
afirmar,1,7,6,1,1,1,1
equilibrar,1,4,3,1,1,1,1
atraer,4,3,-1,-1,1,0,1
sacrificar,5,7,2,1,1,0,1
esperar,2,3,1,1,1,0,1
elegir,5,4,1,1,-1,0,1
liar,1,2,1,1,1,1,1
situar,2,4,2,1,1,0,1
acabar,3,3,0,0,-1,0,1
exigir,5,2,-3,-1,1,0,1
bajar,3,3,0,0,-1,0,1
derramar,8,10,2,1,1,-1,1
tratar,19,4,15,1,-1,0,1
poner,1,8,7,1,1,0,1
decir,9,3,6,1,-1,0,1
recuperar,2,2,0,0,1,0,1
provocar,2,4,2,1,1,0,1
hacer,2,54,52,1,1,1,1
dominar,3,3,0,0,1,0,1
llevar,4,2,2,1,-1,0,1
cambiar,5,5,0,0,1,0,1
combatir,1,3,2,1,1,1,1
ilustrar,69,2,67,1,-1,0,1
contar,2,2,0,0,1,1,1
señalar,6,2,4,1,-1,0,1
rescatar,4,3,-1,-1,1,0,1
requerir,3,3,0,0,1,0,1
tener,1,7,6,1,1,0,1
proyectar,1,3,2,1,1,1,1
mantener,2,3,1,1,1,0,1
sentar,1,6,5,1,1,1,1
arrinconar,2,18,16,1,1,0,1
quedar,3,7,4,1,1,0,1
practicar,5,3,-2,-1,1,0,1
jugar,4,7,3,1,1,0,1
estar,3,3,0,0,1,0,1
liberar,1,5,4,1,1,1,1
imitar,3,10,7,1,1,0,1
tener,1,4,3,1,1,0,1
mantener,3,2,-1,-1,1,0,1
atacar,2,3,1,1,1,0,1
romper,2,12,10,1,1,0,1
retrasar,5,3,2,1,-1,0,1
defender,1,9,8,1,1,1,1
despertar,5,4,1,1,-1,0,1
tener,3,2,1,1,-1,0,1
aproximar,1,2,1,1,1,0,1
aplicar,2,5,3,1,1,0,1
cumplir,3,3,0,0,1,0,1
igualar,11,2,9,1,-1,0,1
hacer,7,2,5,1,-1,0,1
desarrollar,3,16,13,1,1,0,1
dar,48,4,44,1,-1,0,1
depender,8,3,5,1,-1,0,1
sorprender,4,4,0,0,-1,0,1
presentar,2,7,5,1,1,0,1
tener,2,6,4,1,1,0,1
atesorar,4,3,1,1,-1,0,1
revelar,4,11,7,1,1,0,1
manipular,3,7,4,1,1,0,1
encontrar,1,8,7,1,1,1,1
lanzar,18,2,16,1,-1,0,1
generar,8,2,6,1,-1,1,1
llevar,2,2,0,0,-1,1,1
radicalizar,4,6,2,1,1,0,1
resultar,7,3,-4,-1,1,0,1
traer,1,2,-1,-1,-1,0,1
dar,4,2,2,1,-1,0,1
pesar,6,2,4,1,-1,0,1
hacer,1,4,3,1,1,0,1
conservar,3,6,3,1,1,0,1
iniciar,1,21,20,1,1,1,1
enterrar,3,3,0,0,1,0,1
destruir,1,3,2,1,1,0,1
tener,1,2,1,1,1,0,1
mezclar,5,4,-1,-1,1,0,1
pulverizar,5,15,10,1,1,0,1
expeler,2,7,5,1,1,0,1
introducir,5,5,0,0,1,0,1
introducir,3,3,0,0,1,0,1
contar,3,4,1,1,1,0,1
depender,19,3,16,1,-1,0,1
llevar,2,3,1,1,1,0,1
fundar,3,3,0,0,1,0,1
doblar,8,3,5,1,-1,0,1
experimentar,2,13,11,1,1,0,1
romper,5,3,2,1,-1,0,1
retener,7,2,5,1,-1,0,1
minar,6,24,18,1,1,0,1
descubrir,4,2,-2,-1,1,0,1
alcanzar,3,2,1,1,-1,0,1
decidir,2,5,3,1,1,0,1
introducir,8,20,12,1,1,0,1
adoptar,1,2,1,1,1,-1,1
hacer,3,9,6,1,1,0,1
descomponer,5,15,10,1,1,0,1
desajustar,8,3,5,1,-1,0,1
rayar,2,3,1,1,1,0,1
devolver,2,4,2,1,1,0,1
arrastrar,3,2,-1,-1,1,0,1
presentar,35,2,33,1,-1,0,1
presentar,13,2,11,1,-1,0,1
recorrer,2,3,1,1,1,0,1
montar,2,17,15,1,1,0,1
celebrar,4,3,-1,-1,1,0,1
poner,2,2,0,0,1,0,1
bombardear,3,3,0,0,-1,0,1
envenenar,11,3,8,1,-1,0,1
contemplar,7,4,3,1,-1,0,1
sufrir,1,9,8,1,1,0,1
firmar,17,2,15,1,-1,0,1
fijar,2,7,5,1,1,0,1
pulsar,2,4,2,1,1,0,1
llevar,1,21,20,1,1,1,1
iniciar,2,3,1,1,1,0,1
calcular,3,12,9,1,1,0,1
medir,15,18,3,1,1,0,1
corroborar,4,9,-5,-1,-1,0,1
comprobar,7,4,-3,-1,1,0,1
esparcir,4,3,1,1,-1,0,1
doblegar,1,7,6,1,1,1,1
ensayar,4,7,3,1,1,0,1
bombardear,25,4,21,1,-1,0,1
alcanzar,3,23,20,1,1,0,1
lanzar,14,3,11,1,-1,0,1
resultar,3,15,12,1,1,0,1
fijar,19,3,16,1,-1,0,1
alterar,6,11,5,1,1,0,1
clavar,2,6,4,1,1,0,1
transmitir,1,8,7,1,1,0,1
tripular,2,6,4,1,1,0,1
conectar,1,5,4,1,1,1,1
colocar,12,7,5,1,-1,0,1
dividir,5,3,-2,-1,1,0,1
crear,3,3,0,0,1,0,1
conducir,1,9,8,1,1,0,1
poner,2,2,0,0,-1,0,1
encontrar,2,11,9,1,1,0,1
tomar,4,5,1,1,1,0,1
implicar,3,5,2,1,1,0,1
lograr,5,4,-1,-1,1,0,1
cumplir,2,5,3,1,1,0,1
conseguir,2,22,20,1,1,0,1
justificar,15,31,16,1,1,0,1
sintetizar,6,4,2,1,-1,0,1
presentar,4,3,-1,-1,1,0,1
utilizar,1,5,4,1,1,-1,1
contar,13,3,10,1,-1,0,1
desarrollar,1,7,6,1,1,1,1
presentar,2,10,8,1,1,0,1
permitir,11,5,6,1,-1,0,1
permitir,3,4,1,1,1,0,1
conducir,24,2,22,1,-1,0,1
conseguir,12,3,9,1,-1,-1,1
corresponder,6,3,3,1,-1,0,1
producir,1,7,6,1,1,1,1
alcanzar,1,3,2,1,1,0,1
encontrar,6,5,1,1,-1,-1,1
aumentar,2,12,10,1,1,0,1
reclamar,2,4,2,1,1,0,1
decir,1,3,2,1,1,1,1
propiciar,2,5,3,1,1,0,1
poner,14,5,9,1,-1,0,1
simbolizar,10,7,-3,-1,1,0,1
reforzar,1,4,3,1,1,1,1
ejercer,2,5,3,1,1,0,1
propiciar,2,5,3,1,1,0,1
puntuar,8,3,5,1,-1,0,1
disfrutar,4,6,-2,-1,-1,0,1
quedar,1,34,33,1,1,0,1
identificar,2,6,4,1,1,0,1
tener,2,2,0,0,-1,0,1
añadir,2,8,6,1,1,1,1
describir,6,3,3,1,-1,0,1
adquirir,8,3,5,1,-1,0,1
llegar,49,2,47,1,-1,0,1
diferenciar,6,2,4,1,-1,1,1
unir,2,2,0,0,-1,1,1
venir,1,30,29,1,1,0,1
contener,4,2,2,1,-1,1,1
adoptar,6,3,3,1,-1,0,1
colocar,1,5,4,1,1,1,1
alejar,2,43,41,1,1,0,1
poner,7,4,3,1,-1,0,1
tomar,1,3,2,1,1,0,1
estudiar,1,2,1,1,1,0,1
abandonar,2,4,2,1,1,0,1
abrir,2,6,4,1,1,0,1
escribir,2,9,7,1,1,0,1
sumar,1,24,23,1,1,1,1
hacer,3,5,2,1,1,0,1
integrar,1,4,3,1,1,1,1
poner,1,9,8,1,1,0,1
acabar,9,5,-4,-1,1,0,1
mantener,2,10,8,1,1,0,1
saldar,3,5,2,1,1,0,1
acomodar,1,3,2,1,1,1,1
conseguir,1,5,4,1,1,1,1
hacer,2,3,1,1,1,0,1
aprovisionar,1,3,2,1,1,1,1
prohibir,5,2,-3,-1,1,0,1
solidarizar,1,2,1,1,1,0,1
fumar,1,32,31,1,1,0,1
mezclar,9,3,6,1,-1,0,1
hacer,1,20,19,1,1,0,1
estar,1,4,3,1,1,0,1
poner,1,5,4,1,1,1,1
enjuagar,2,14,12,1,1,0,1
estar,2,5,3,1,1,0,1
mandar,10,3,7,1,-1,0,1
calcular,14,3,11,1,-1,0,1
instalar,1,4,3,1,1,1,1
cruzar,2,3,1,1,1,0,1
probar,1,5,4,1,1,0,1
abrir,1,3,2,1,1,0,1
mandar,3,2,-1,-1,1,0,1
abrir,2,4,2,1,1,0,1
emplear,3,4,1,1,1,0,1
solidarizar,1,2,1,1,1,0,1
estar,6,4,2,1,-1,0,1
tener,5,3,2,1,-1,0,1
dejar,4,2,2,1,-1,0,1
sentar,2,6,4,1,1,0,1
completar,2,13,11,1,1,0,1
carecer,4,9,5,1,1,0,1
vivir,4,8,4,1,1,0,1
desviar,2,4,2,1,1,0,1
albergar,2,3,1,1,1,0,1
saber,32,4,28,1,-1,0,1
pedir,2,4,2,1,1,0,1
quedar,1,2,1,1,1,1,1
compartir,13,2,11,1,-1,1,1
enganchar,1,3,2,1,1,1,1
conocer,4,4,0,0,1,0,1
traer,3,2,-1,-1,1,0,1
dar,9,2,7,1,-1,0,1
mantener,10,4,6,1,-1,0,1
tener,2,5,3,1,1,0,1
asolar,2,9,7,1,1,0,1
desbordar,7,17,10,1,1,0,1
dejar,1,5,4,1,1,0,1
esperar,13,5,8,1,-1,0,1
urdir,3,2,1,1,-1,1,1
encontrar,3,6,3,1,1,0,1
fugarse,1,2,1,1,1,1,1
coser,9,5,4,1,-1,0,1
descubrir,40,2,38,1,-1,1,1
rechazar,3,20,17,1,1,0,1
identificar,1,3,2,1,1,1,1
precipitar,1,14,13,1,1,0,1
seguir,13,3,10,1,-1,0,1
suplicar,1,8,7,1,1,1,1
mantener,3,4,1,1,1,0,1
contemplar,2,11,9,1,1,0,1
jugar,2,6,4,1,1,0,1
quedar,1,6,5,1,1,1,1
levantar,7,3,-4,-1,1,0,1
levantar,2,5,3,1,1,0,1
alzar,2,2,0,0,1,0,1
volver,2,41,39,1,1,0,1
tumbar,1,4,3,1,1,1,1
construir,9,4,5,1,-1,0,1
contemplar,8,4,4,1,-1,0,1
volver,1,3,2,1,1,1,1
repartir,5,3,-2,-1,1,0,1
conservar,5,17,12,1,1,0,1
respetar,2,6,4,1,1,0,1
volver,6,3,-3,-1,1,0,1
decir,2,8,6,1,1,0,1
tratar,19,3,16,1,-1,0,1
creer,3,3,0,0,1,0,1
exponer,5,10,5,1,1,0,1
ver,5,3,2,1,-1,0,1
envidiar,2,3,1,1,1,0,1
inventar,3,5,-2,-1,-1,0,1
inventar,2,4,-2,-1,-1,0,1
fabricar,10,5,-5,-1,1,0,1
entender,1,41,40,1,1,1,1
pasar,2,3,1,1,1,0,1
ir,1,3,2,1,1,1,1
decir,3,2,-1,-1,1,0,1
usar,2,6,4,1,1,0,1
rodear,1,7,6,1,1,1,1
vaciar,5,3,-2,-1,1,0,1
sentar,1,2,1,1,1,0,1
echar,4,14,10,1,1,0,1
sacar,3,2,-1,-1,1,0,1
frotar,1,5,4,1,1,1,1
dar,2,6,4,1,1,-1,1
apartar,19,3,16,1,-1,0,1
pegar,3,3,0,0,1,0,1
intercambiar,34,2,32,1,-1,1,1
llamar,2,3,1,1,1,0,1
acercar,5,3,2,1,-1,0,1
ascender,1,5,4,1,1,0,1
abrir,4,2,-2,-1,1,0,1
impregnar,2,9,7,1,1,0,1
levantar,2,3,1,1,1,0,1
mostrar,1,15,14,1,1,0,1
tomar,6,4,-2,-1,1,0,1
sortear,3,8,5,1,1,0,1
desnudar,2,2,0,0,1,0,1
rodear,5,3,2,1,-1,0,1
acercar,2,3,1,1,1,0,1
iluminar,11,2,9,1,-1,1,1
participar,11,2,9,1,-1,0,1
construir,2,2,0,0,1,0,1
invertir,8,12,4,1,1,0,1
adquirir,35,3,32,1,-1,0,1
ofrecer,4,2,-2,-1,1,0,1
ofrecer,3,9,6,1,1,0,1
aprovechar,3,19,16,1,1,0,1
asegurar,3,4,1,1,1,0,1
abrir,2,4,2,1,1,0,1
ganar,4,5,1,1,1,0,1
ganar,1,6,5,1,1,0,1
alcanzar,3,2,-1,-1,1,0,1
obtener,7,15,8,1,1,0,1
compartir,3,19,16,1,1,0,1
tener,2,44,42,1,1,0,1
anunciar,3,27,24,1,1,0,1
causar,2,3,1,1,1,0,1
garantizar,2,4,2,1,1,0,1
registrar,3,11,8,1,1,0,1
mostrar,3,6,3,1,1,0,1
firmar,2,9,7,1,1,0,1
subir,6,3,-3,-1,1,0,1
romper,3,6,3,1,1,0,1
promover,2,10,8,1,1,0,1
rechazar,13,6,7,1,-1,0,1
requerir,37,3,34,1,-1,0,1
condenar,22,3,19,1,-1,0,1
conseguir,11,4,7,1,-1,0,1
imponer,1,3,2,1,1,1,1
reafirmar,4,27,23,1,1,0,1
permanecer,1,8,7,1,1,0,1
impedir,4,6,2,1,1,0,1
visitar,2,4,2,1,1,0,1
evaluar,9,3,6,1,-1,0,1
sobrevolar,9,12,3,1,1,0,1
corear,12,2,10,1,-1,0,1
dejar,5,2,-3,-1,1,0,1
luchar,7,2,5,1,-1,0,1
recibir,19,3,16,1,-1,0,1
ironizar,11,5,-6,-1,1,0,1
vencer,17,7,10,1,-1,0,1
guardar,4,8,4,1,1,0,1
acompañar,2,11,9,1,1,0,1
suponer,2,13,11,1,1,0,1
tener,4,7,3,1,1,0,1
tener,2,3,1,1,1,0,1
jugar,7,3,-4,-1,1,0,1
negociar,4,4,0,0,1,0,1
expresar,2,11,9,1,1,0,1
instar,12,24,-12,-1,-1,0,1
demandar,4,8,4,1,1,0,1
citar,11,3,8,1,-1,0,1
detener,13,5,8,1,-1,0,1
subrayar,22,2,20,1,-1,0,1
participar,4,11,7,1,1,0,1
hacer,1,7,6,1,1,0,1
promover,2,5,3,1,1,0,1
incrementar,12,3,-9,-1,1,0,1
felicitar,4,13,9,1,1,0,1
adelantar,10,4,6,1,-1,0,1
hacer,1,3,2,1,1,1,1
tratar,11,6,-5,-1,1,0,1
abrir,2,9,7,1,1,0,1
cerrar,1,2,1,1,1,0,1
presentar,54,4,50,1,-1,0,1
revisar,5,14,9,1,1,0,1
buscar,2,4,2,1,1,0,1
informar,4,3,1,1,-1,0,1
tratar,11,6,5,1,-1,0,1
eliminar,2,4,2,1,1,0,1
recalificar,1,6,5,1,1,1,1
ganar,4,7,3,1,1,1,1
favorecer,3,7,4,1,1,0,1
copar,3,9,6,1,1,0,1
ofrecer,9,8,-1,-1,1,0,1
aceptar,5,7,2,1,1,0,1
deleitar,3,36,33,1,1,0,1
volver,3,5,2,1,1,-1,1
tener,3,3,0,0,1,0,1
tener,5,10,5,1,1,0,1
albergar,1,2,1,1,1,1,1
poner,11,5,6,1,-1,0,1
poner,2,2,0,0,1,0,1
ganar,14,2,-12,-1,1,0,1
enfrentar,4,11,7,1,1,0,1
tener,2,4,2,1,1,0,1
enfrentar,2,4,-2,-1,-1,0,1
hacer,1,3,2,1,1,0,1
tener,4,4,0,0,1,0,1
jugar,3,4,1,1,1,0,1
tener,3,2,-1,-1,1,-1,1
llegar,24,3,21,1,-1,0,1
recibir,8,18,10,1,1,0,1
registrar,7,4,-3,-1,1,0,1
esperar,11,31,20,1,1,0,1
analizar,4,17,13,1,1,0,1
conseguir,17,2,15,1,-1,0,1
llevar,5,3,2,1,-1,0,1
llegar,9,3,6,1,-1,0,1
superar,26,4,22,1,-1,0,1
salir,2,3,1,1,1,0,1
afrontar,2,9,7,1,1,0,1
confiar,1,14,13,1,1,1,1
predecir,13,2,11,1,-1,0,1
recorrer,2,4,2,1,1,0,1
condenar,7,6,-1,-1,1,0,1
mencionar,5,47,42,1,1,0,1
poner,1,3,2,1,1,0,1
continuar,2,6,4,1,1,0,1
tener,17,3,-14,-1,1,0,1
celebrar,2,2,0,0,1,0,1
anunciar,29,2,27,1,-1,0,1
sacar,2,6,4,1,1,0,1
suponer,8,3,5,1,-1,0,1
impulsar,5,5,0,0,1,0,1
privatizar,3,5,2,1,1,0,1
mantener,6,2,4,1,-1,0,1
compartir,5,5,0,0,-1,0,1
canalizar,2,7,5,1,1,0,1
reorientar,2,3,1,1,1,0,1
dejar,30,3,27,1,-1,0,1
ganar,4,4,0,0,1,0,1
encajar,2,3,1,1,1,0,1
ascender,6,33,27,1,1,0,1
alcanzar,2,2,0,0,1,0,1
contribuir,9,11,-2,-1,-1,0,1
superar,3,3,0,0,-1,0,1
disputar,4,2,-2,-1,1,0,1
enviar,12,4,8,1,-1,0,1
ceder,2,2,0,0,1,0,1
visitar,2,2,0,0,1,0,1
destinar,4,10,6,1,1,0,1
desactivar,4,2,-2,-1,1,0,1
acompañar,9,13,4,1,1,0,1
retomar,2,3,1,1,1,0,1
apoyar,4,4,0,0,1,0,1
capturar,2,3,1,1,1,0,1
felicitar,4,24,20,1,1,0,1
transportar,4,12,8,1,1,0,1
afectar,9,28,19,1,1,0,1
asumir,8,10,2,1,1,0,1
exportar,2,8,6,1,1,0,1
exportar,2,16,14,1,1,0,1
perder,6,6,0,0,-1,0,1
reclamar,2,13,11,1,1,0,1
hacer,15,4,-11,-1,1,0,1
cumplir,7,2,5,1,-1,0,1
condenar,5,4,-1,-1,1,0,1
conformar,3,3,0,0,-1,0,1
volver,1,4,3,1,1,1,1
capturar,1,3,2,1,1,0,1
hacer,1,4,3,1,1,1,1
quedar,5,24,19,1,1,0,1
impedir,4,3,-1,-1,1,0,1
alargar,1,4,3,1,1,1,1
desempeñar,4,4,0,0,1,0,1
empezar,3,4,1,1,1,0,1
poner,3,2,1,1,-1,0,1
adoptar,1,4,3,1,1,0,1
lanzar,2,2,0,0,1,0,1
trasladar,2,8,6,1,1,0,1
diseñar,3,4,1,1,1,0,1
hacer,1,8,7,1,1,0,1
mostrar,14,4,10,1,-1,0,1
mantener,2,4,2,1,1,0,1
mantener,3,6,3,1,1,0,1
tocar,2,12,10,1,1,0,1
llevar,5,2,3,1,-1,0,1
poner,1,3,2,1,1,0,1
ejecutar,11,2,9,1,-1,0,1
colar,2,4,2,1,1,0,1
poner,3,2,1,1,-1,0,1
derrotar,5,17,12,1,1,0,1
poner,13,3,10,1,-1,0,1
emplear,2,3,1,1,1,0,1
mantener,2,5,3,1,1,0,1
intentar,3,5,2,1,1,0,1
aventajar,2,2,0,0,1,0,1
aumentar,4,2,-2,-1,1,0,1
dejar,3,3,0,0,1,0,1
poner,3,3,0,0,-1,0,1
imponer,1,4,3,1,1,1,1
ganar,4,4,0,0,1,0,1
mejorar,2,2,0,0,1,0,1
llevar,2,8,6,1,1,0,1
dar,2,14,12,1,1,0,1
aumentar,4,17,13,1,1,0,1
afrontar,6,9,3,1,1,-1,1
merecer,7,4,3,1,-1,0,1
apoyar,2,8,6,1,1,0,1
eliminar,16,3,-13,-1,1,0,1
favorecer,5,5,0,0,1,0,1
dirigir,6,2,-4,-1,1,0,1
representar,8,10,-2,-1,-1,0,1
iniciar,4,4,0,0,-1,0,1
pronunciar,2,34,32,1,1,0,1
tener,1,7,6,1,1,0,1
hallar,2,3,1,1,1,0,1
generar,6,2,4,1,-1,0,1
respaldar,2,3,1,1,1,0,1
matar,4,3,-1,-1,1,0,1
entregar,15,3,12,1,-1,0,1
destacar,2,28,26,1,1,0,1
lanzar,17,3,14,1,-1,0,1
controlar,2,8,6,1,1,0,1
derrotar,3,6,3,1,1,0,1
hacer,7,16,9,1,1,0,1
subir,1,5,4,1,1,0,1
tener,2,7,5,1,1,0,1
indexar,5,7,2,1,1,0,1
situar,2,4,2,1,1,0,1
conducir,3,7,4,1,1,0,1
resultar,1,8,7,1,1,0,1
tener,23,11,12,1,-1,0,1
emprender,3,2,-1,-1,1,0,1
abrir,1,3,2,1,1,0,1
disputar,2,4,2,1,1,0,1
eliminar,1,8,7,1,1,1,1
disputar,4,5,1,1,1,0,1
superar,3,3,0,0,1,0,1
disputar,2,10,8,1,1,0,1
exponer,2,3,1,1,1,0,1
registrar,3,4,-1,-1,-1,0,1
hacer,1,3,2,1,1,0,1
invertir,4,11,7,1,1,0,1
tener,2,17,15,1,1,0,1
aumentar,2,9,7,1,1,0,1
sacar,9,2,7,1,-1,0,1
garantizar,6,8,2,1,1,0,1
adoptar,18,6,12,1,-1,0,1
vencer,4,3,1,1,-1,0,1
comenzar,5,26,21,1,1,0,1
mantener,1,3,2,1,1,1,1
producir,9,5,4,1,-1,0,1
representar,14,2,12,1,-1,0,1
exportar,13,4,9,1,-1,0,1
calcular,20,2,18,1,-1,0,1
provocar,2,3,1,1,1,0,1
cerrar,3,16,13,1,1,0,1
lograr,7,13,6,1,1,0,1
sumar,3,7,4,1,1,0,1
lograr,2,4,2,1,1,0,1
contar,2,2,0,0,1,0,1
aprobar,35,9,26,1,-1,0,1
perder,2,3,1,1,1,0,1
suspender,6,9,3,1,1,0,1
contar,7,7,0,0,1,0,1
sacar,2,3,1,1,1,0,1
mantener,1,3,2,1,1,1,1
investir,1,8,7,1,1,0,1
destacar,4,8,4,1,1,0,1
mantener,2,3,-1,-1,-1,0,1
poner,2,2,0,0,-1,0,1
tener,2,3,1,1,1,0,1
aceptar,4,3,1,1,-1,0,1
recuperar,1,5,4,1,1,0,1
poner,3,2,-1,-1,1,0,1
encontrar,1,6,5,1,1,1,1
hacer,4,3,-1,-1,1,0,1
conllevar,2,28,26,1,1,0,1
conseguir,5,28,23,1,1,0,1
dejar,4,5,1,1,1,0,1
comenzar,3,4,1,1,1,0,1
tener,2,20,18,1,1,0,1
conseguir,4,11,7,1,1,0,1
perder,2,10,8,1,1,0,1
escuchar,15,8,7,1,-1,0,1
exhibir,7,2,5,1,-1,0,1
tener,1,9,8,1,1,0,1
vender,2,8,6,1,1,0,1
contar,12,3,9,1,-1,0,1
contar,4,3,1,1,-1,0,1
posicionar,1,11,10,1,1,1,1
llegar,6,8,2,1,1,0,1
sacar,8,30,22,1,1,0,1
jugar,4,8,4,1,1,0,1
enviar,18,2,16,1,-1,0,1
producir,7,2,-5,-1,1,0,1
establecer,4,18,14,1,1,0,1
concretar,1,5,4,1,1,1,1
ceder,4,19,15,1,1,0,1
tener,1,6,5,1,1,0,1
poner,2,3,1,1,1,0,1
facilitar,2,10,8,1,1,0,1
emitir,28,2,26,1,-1,1,1
echar,1,3,2,1,1,1,1
mantener,2,4,2,1,1,0,1
negociar,16,3,13,1,-1,0,1
destruir,5,5,0,0,1,0,1
causar,2,24,22,1,1,0,1
mantener,3,3,0,0,1,0,1
clausurar,7,2,5,1,-1,0,1
ahormar,6,7,1,1,1,0,1
arraigar,2,2,0,0,1,0,1
asumir,4,3,1,1,-1,0,1
hacer,1,27,26,1,1,0,1
preparar,2,2,0,0,1,-1,1
hacer,3,3,0,0,1,0,1
pagar,2,3,1,1,1,0,1
disputar,3,2,-1,-1,1,0,1
burlar,3,16,13,1,1,0,1
dialogar,3,3,0,0,1,0,1
pesidir,38,6,32,1,-1,0,1
potenciar,9,3,-6,-1,1,0,1
implantar,9,3,6,1,-1,0,1
cimentar,2,6,4,1,1,0,1
acercar,1,15,14,1,1,1,1
volver,1,9,8,1,1,0,1
sufrir,5,9,4,1,1,0,1
obtener,8,7,-1,-1,1,0,1
jugar,8,6,-2,-1,1,0,1
presentar,2,11,9,1,1,0,1
continuar,3,11,8,1,1,0,1
solicitar,2,2,0,0,1,0,1
organizar,2,5,3,1,1,0,1
recuperar,2,9,7,1,1,0,1
mostrar,18,4,14,1,-1,0,1
tener,3,4,1,1,1,0,1
recibir,4,4,0,0,-1,0,1
considerar,13,6,7,1,-1,0,1
ir,1,3,2,1,1,1,1
hacer,3,3,0,0,1,0,1
colocar,5,9,4,1,1,0,1
hacer,1,6,5,1,1,1,1
demostrar,5,11,6,1,1,0,1
favorecer,11,26,15,1,1,0,1
coger,4,2,2,1,-1,0,1
presentar,2,3,1,1,1,0,1
presentar,1,3,2,1,1,1,1
reconducir,3,16,13,1,1,0,1
ocupar,5,25,20,1,1,0,1
sustituir,13,3,10,1,-1,0,1
precisar,15,3,-12,-1,1,0,1
manifestar,1,14,13,1,1,1,1
preservar,23,3,20,1,-1,0,1
afrontar,1,16,15,1,1,1,1
crear,3,4,1,1,1,0,1
combatir,2,2,0,0,-1,0,1
detectar,2,3,1,1,1,0,1
crear,3,8,5,1,1,0,1
complementar,1,7,6,1,1,1,1
establecer,2,6,4,1,1,0,1
llamar,2,43,41,1,1,0,1
fortalecer,5,33,28,1,1,0,1
llevar,17,2,15,1,-1,0,1
comenzar,7,4,3,1,-1,0,1
comunicar,2,3,-1,-1,-1,0,1
dejar,4,27,23,1,1,0,1
recibir,2,12,10,1,1,0,1
quedar,1,33,32,1,1,0,1
ganar,2,7,-5,-1,-1,0,1
sacar,1,18,17,1,1,0,1
enfrentar,4,6,2,1,1,0,1
reclamar,4,17,13,1,1,0,1
derrotar,5,10,5,1,1,0,1
terminar,2,6,4,1,1,0,1
expulsar,11,3,-8,-1,1,0,1
vencer,2,2,0,0,1,0,1
convertir,3,4,1,1,1,0,1
formar,3,6,3,1,1,0,1
confiar,2,4,2,1,1,1,1
pertenecer,5,3,-2,-1,1,0,1
llegar,23,2,21,1,-1,0,1
celebrar,15,4,11,1,-1,0,1
dar,2,9,7,1,1,0,1
poner,1,3,2,1,1,0,1
compartir,1,2,1,1,1,0,1
contar,2,13,11,1,1,0,1
emplear,1,4,3,1,1,1,1
presentar,2,8,6,1,1,0,1
defender,3,9,-6,-1,-1,0,1
resolver,1,3,2,1,1,1,1
intimidar,4,3,-1,-1,1,0,1
asumir,3,15,12,1,1,0,1
condenar,3,7,4,1,1,0,1
pesidir,8,3,5,1,-1,0,1
ocasionar,1,3,2,1,1,0,1
iniciar,2,2,0,0,1,0,1
llevar,2,3,1,1,1,0,1
estar,1,4,3,1,1,0,1
agilizar,10,3,7,1,-1,0,1
contar,18,6,12,1,-1,0,1
operar,4,2,2,1,-1,0,1
iniciar,10,2,8,1,-1,0,1
operar,3,2,-1,-1,1,0,1
conseguir,3,16,13,1,1,0,1
aumentar,6,2,4,1,-1,0,1
vencer,3,4,1,1,1,0,1
ganar,19,5,14,1,-1,0,1
sumar,2,5,3,1,1,0,1
ver,2,3,1,1,1,0,1
alejar,2,6,4,1,1,0,1
lucir,1,3,2,1,1,0,1
tener,19,3,16,1,-1,0,1
presentar,2,2,0,0,1,0,1
suspender,21,9,-12,-1,1,0,1
vender,2,4,2,1,1,0,1
verter,2,3,1,1,1,0,1
volar,2,3,1,1,1,0,1
sentar,12,2,10,1,-1,0,1
arrojar,6,10,4,1,1,0,1
volar,2,24,22,1,1,0,1
corregir,13,10,3,1,-1,0,1
convocar,3,4,1,1,1,0,1
recibir,3,8,-5,-1,-1,0,1
fabricar,4,6,2,1,1,0,1
retirar,7,2,5,1,-1,0,1
retirar,7,3,4,1,-1,0,1
retirar,1,5,4,1,1,1,1
emplear,2,6,4,1,1,0,1
mostrar,2,29,27,1,1,0,1
visitar,2,17,15,1,1,0,1
poner,3,3,0,0,1,0,1
anunciar,15,14,1,1,-1,0,1
imponer,11,5,-6,-1,1,0,1
hallar,10,4,-6,-1,1,0,1
gestionar,37,5,32,1,-1,0,1
pronunciar,1,3,2,1,1,1,1
presentar,2,6,4,1,1,0,1
introducir,1,3,2,1,1,1,1
conducir,2,3,1,1,1,0,1
presentar,6,2,4,1,-1,0,1
producir,9,13,4,1,1,0,1
gastar,3,2,-1,-1,1,0,1
comprobar,5,4,-1,-1,1,0,1
despedir,18,10,8,1,-1,0,1
lograr,2,4,2,1,1,0,1
adecuar,1,8,7,1,1,1,1
crear,3,5,-2,-1,-1,0,1
ver,2,2,0,0,1,0,1
situar,2,12,10,1,1,0,1
informar,4,20,16,1,1,0,1
apoyar,12,20,8,1,1,0,1
autorizar,9,3,6,1,-1,0,1
enviar,5,11,6,1,1,0,1
celebrar,1,10,9,1,1,1,1
impedir,8,3,5,1,-1,0,1
reformar,3,27,24,1,1,0,1
concluir,2,9,7,1,1,0,1
presentar,2,15,13,1,1,0,1
prever,12,5,7,1,-1,0,1
quedar,1,7,6,1,1,0,1
presentar,5,8,-3,-1,-1,0,1
arraigar,1,4,3,1,1,1,1
abogar,5,8,3,1,1,0,1
fijar,1,4,3,1,1,0,1
rebajar,1,5,4,1,1,1,1
abrir,3,2,-1,-1,1,0,1
incrementar,3,3,0,0,1,0,1
tener,4,8,4,1,1,0,1
inaugurar,6,3,-3,-1,1,0,1
tener,3,7,4,1,1,0,1
tener,4,2,-2,-1,1,0,1
reforzar,3,6,3,1,1,0,1
conseguir,16,11,-5,-1,1,0,1
apoyar,3,3,0,0,1,0,1
hacer,2,2,0,0,1,0,1
acompañar,2,3,1,1,1,0,1
finiquitar,6,4,-2,-1,1,0,1
enseñar,2,5,3,1,1,0,1
presentar,1,3,2,1,1,1,1
acoger,17,8,9,1,-1,0,1
abrir,4,24,20,1,1,0,1
defender,4,5,1,1,1,0,1
ganar,5,5,0,0,1,0,1
encontrar,1,3,2,1,1,1,1
dar,2,2,0,0,1,0,1
bajar,6,2,4,1,-1,0,1
ir,1,4,3,1,1,1,1
ganar,2,3,1,1,1,0,1
hacer,4,6,2,1,1,0,1
defender,6,2,4,1,-1,0,1
recibir,2,3,1,1,1,0,1
desarrollar,2,4,2,1,1,0,1
valorar,15,3,12,1,-1,0,1
desempeñar,3,9,6,1,1,0,1
canalizar,1,31,30,1,1,1,1
conocer,2,5,3,1,1,0,1
adquirir,8,20,-12,-1,-1,0,1
obtener,3,22,19,1,1,0,1
provenir,4,5,-1,-1,-1,0,1
conseguir,1,4,3,1,1,0,1
medir,4,5,1,1,1,0,1
emitir,13,2,11,1,-1,0,1
bloquear,2,3,-1,-1,-1,0,1
extender,22,16,6,1,-1,0,1
quedar,1,4,3,1,1,0,1
solicitar,8,16,8,1,1,0,1
viajar,12,2,10,1,-1,0,1
cubrir,6,29,23,1,1,0,1
dar,2,15,13,1,1,0,1
cruzar,35,2,33,1,-1,0,1
dañar,6,14,8,1,1,0,1
colocar,1,5,4,1,1,1,1
perder,3,3,0,0,1,0,1
superar,2,6,4,1,1,0,1
cruzar,2,5,3,1,1,0,1
entrar,2,2,0,0,1,0,1
elevar,2,4,2,1,1,0,1
terminar,2,3,1,1,1,0,1
elevar,2,3,1,1,1,0,1
proponer,5,3,2,1,-1,0,1
verter,2,58,56,1,1,0,1
conducir,11,9,-2,-1,1,0,1
quedar,1,3,2,1,1,-1,1
resultar,1,9,8,1,1,0,1
buscar,2,9,7,1,1,0,1
ver,2,3,-1,-1,-1,0,1
ofrecer,5,3,2,1,-1,0,1
lograr,14,8,-6,-1,1,0,1
alcanzar,33,3,30,1,-1,0,1
ofrecer,7,5,-2,-1,1,0,1
dar,3,14,11,1,1,0,1
presentar,1,16,15,1,1,0,1
ver,27,3,24,1,-1,0,1
limitar,26,7,19,1,-1,0,1
ejercer,2,4,2,1,1,0,1
analizar,24,3,21,1,-1,0,1
establecer,2,9,7,1,1,0,1
jugar,2,4,2,1,1,0,1
hacer,14,27,13,1,1,0,1
poner,9,6,-3,-1,1,0,1
recoger,18,3,15,1,-1,0,1
pedir,5,3,2,1,-1,0,1
hacer,1,4,3,1,1,1,1
recibir,36,6,30,1,-1,0,1
visitar,5,5,0,0,-1,0,1
abandonar,5,5,0,0,1,0,1
organizar,4,4,0,0,1,0,1
agitar,3,4,1,1,1,0,1
discutir,3,35,32,1,1,0,1
debatir,3,3,0,0,-1,0,1
detener,6,6,0,0,1,0,1
financiar,5,11,6,1,1,0,1
tener,3,3,0,0,1,0,1
desembolsar,4,5,1,1,1,0,1
empujar,3,2,1,1,-1,0,1
fijar,1,4,3,1,1,1,1
adquirir,4,4,0,0,-1,0,1
registrar,3,4,1,1,1,0,1
situar,2,3,1,1,1,0,1
considerar,2,2,0,0,-1,0,1
mantener,5,5,0,0,1,0,1
controlar,5,2,3,1,-1,0,1
aumentar,2,4,-2,-1,-1,0,1
tener,2,8,6,1,1,0,1
ofrecer,5,14,9,1,1,0,1
incorporar,2,6,4,1,1,0,1
prever,4,4,0,0,1,0,1
consensuar,3,7,4,1,1,0,1
justificar,2,18,16,1,1,0,1
apoyar,2,2,0,0,1,0,1
apoyar,2,9,7,1,1,0,1
encabezar,2,3,-1,-1,-1,0,1
aumentar,2,3,-1,-1,-1,0,1
tener,3,24,21,1,1,0,1
reunir,2,16,14,1,1,0,1
tener,8,3,5,1,-1,0,1
disponer,14,3,11,1,-1,0,1
reunir,3,2,1,1,-1,1,1
acercar,1,5,4,1,1,1,1
controlar,2,3,1,1,1,0,1
utilizar,19,5,14,1,-1,0,1
presentar,12,2,10,1,-1,0,1
expresar,4,3,1,1,-1,0,1
disponer,19,3,16,1,-1,0,1
rematar,9,5,4,1,-1,0,1
gobernar,3,7,4,1,1,0,1
tocar,2,2,0,0,-1,0,1
recibir,2,5,3,1,1,0,1
revitalizar,2,5,3,1,1,0,1
subir,2,4,2,1,1,0,1
adelantar,3,3,0,0,1,0,1
establecer,4,2,-2,-1,1,0,1
contribuir,2,8,6,1,1,0,1
instalar,1,2,1,1,1,1,1
mantener,8,5,-3,-1,1,0,1
volver,1,6,5,1,1,1,1
admitir,31,3,28,1,-1,0,1
analizar,3,2,-1,-1,1,0,1
bajar,2,5,3,1,1,0,1
situar,1,19,18,1,1,1,1
ofrecer,6,14,8,1,1,0,1
recortar,4,27,23,1,1,0,1
situar,5,8,3,1,1,0,1
dejar,1,9,8,1,1,1,1
disputar,10,5,-5,-1,1,0,1
dar,6,2,4,1,-1,0,1
denunciar,4,6,2,1,1,0,1
abandonar,6,3,-3,-1,1,0,1
situar,4,2,-2,-1,1,0,1
sancionar,2,10,8,1,1,0,1
jugar,2,3,1,1,1,0,1
adelantar,1,7,6,1,1,1,1
afrontar,2,3,1,1,1,0,1
salir,1,2,1,1,1,0,1
convocar,15,6,9,1,-1,0,1
convocar,2,6,4,1,1,0,1
apoyar,2,3,1,1,1,0,1
dirigir,5,9,4,1,1,0,1
tener,1,4,3,1,1,0,1
impedir,3,39,36,1,1,0,1
perder,6,15,9,1,1,0,1
adherir,4,6,2,1,1,0,1
producir,7,7,0,0,1,0,1
producir,4,4,0,0,1,0,1
retener,9,5,-4,-1,1,0,1
significar,24,4,20,1,-1,0,1
hacer,2,26,24,1,1,0,1
destacar,8,3,5,1,-1,0,1
probar,19,3,16,1,-1,0,1
recoger,5,3,2,1,-1,0,1
emprender,3,2,1,1,-1,0,1
garantizar,6,2,-4,-1,1,0,1
recibir,5,2,3,1,-1,0,1
participar,27,3,24,1,-1,0,1
velar,6,5,-1,-1,1,0,1
hacer,2,4,2,1,1,0,1
quedar,1,6,5,1,1,0,1
vencer,2,11,9,1,1,0,1
realizar,5,7,2,1,1,0,1
practicar,5,24,19,1,1,0,1
afrontar,10,3,7,1,-1,0,1
confiar,1,4,3,1,1,1,1
afrontar,3,3,0,0,1,0,1
extraer,3,3,0,0,1,0,1
reflotar,1,3,2,1,1,1,1
participar,3,10,7,1,1,0,1
hundir,2,4,2,1,1,0,1
abrir,18,3,15,1,-1,0,1
introducir,2,4,-2,-1,-1,0,1
limpiar,2,12,10,1,1,0,1
explorar,2,13,11,1,1,0,1
adquirir,2,4,2,1,1,0,1
comenzar,5,2,-3,-1,1,0,1
continuar,12,15,3,1,1,0,1
introducir,3,4,-1,-1,-1,0,1
protagonizar,5,20,15,1,1,0,1
tener,3,3,0,0,1,0,1
mantener,2,2,0,0,1,0,1
ver,2,6,-4,-1,-1,0,1
vituperar,4,2,2,1,-1,0,1
culminar,2,6,4,1,1,0,1
ampliar,2,14,12,1,1,0,1
ganar,2,2,0,0,1,0,1
hacer,2,5,3,1,1,0,1
presentar,20,4,16,1,-1,0,1
estrenar,5,5,0,0,-1,-1,1
comercializar,3,3,0,0,-1,0,1
ver,5,6,1,1,1,0,1
celebrar,16,4,-12,-1,1,0,1
hundir,3,5,-2,-1,-1,0,1
lograr,11,14,3,1,1,0,1
conseguir,2,4,2,1,1,0,1
poner,5,17,12,1,1,0,1
conocer,2,4,2,1,1,0,1
aumentar,9,2,7,1,-1,0,1
tener,43,2,41,1,-1,0,1
cubrir,26,3,23,1,-1,0,1
mantener,13,5,8,1,-1,0,1
repetir,4,6,-2,-1,-1,0,1
elevar,4,7,3,1,1,0,1
justificar,2,13,11,1,1,0,1
reducir,7,4,-3,-1,1,0,1
personificar,20,25,5,1,1,0,1
convocar,10,17,7,1,1,0,1
ver,11,2,9,1,-1,0,1
hacer,2,3,1,1,1,0,1
expresar,2,3,1,1,1,0,1
restablecer,2,15,13,1,1,0,1
recibir,10,3,7,1,-1,0,1
suponer,6,2,4,1,-1,0,1
dar,1,2,1,1,1,1,1
expulsar,3,3,0,0,1,0,1
fijar,2,3,1,1,1,0,1
provocar,4,3,-1,-1,1,0,1
lanzar,1,3,2,1,1,0,1
derrotar,5,2,3,1,-1,0,1
regalar,2,2,0,0,1,0,1
evitar,4,2,-2,-1,1,0,1
abanicar,2,7,5,1,1,1,1
privilegiar,3,7,4,1,1,0,1
elegir,8,12,4,1,1,0,1
orientar,2,8,6,1,1,0,1
suscitar,3,3,0,0,1,0,1
dar,4,2,2,1,-1,0,1
evitar,4,5,1,1,1,0,1
ratificar,32,3,29,1,-1,0,1
tener,1,7,6,1,1,0,1
retirar,10,2,8,1,-1,0,1
proceder,3,19,16,1,1,0,1
estudiar,5,26,21,1,1,0,1
hacer,2,6,4,1,1,0,1
construir,4,11,7,1,1,0,1
realizar,8,3,5,1,-1,0,1
realizar,1,3,2,1,1,1,1
establecer,33,3,30,1,-1,0,1
tener,8,3,5,1,-1,0,1
cambiar,4,4,0,0,1,0,1
perder,2,7,5,1,1,0,1
derrotar,2,2,0,0,-1,0,1
conquistar,2,4,2,1,1,0,1
perder,5,15,10,1,1,0,1
atravesar,2,3,1,1,1,0,1
pedir,14,22,8,1,1,0,1
depender,3,7,4,1,1,-1,1
representar,2,35,33,1,1,0,1
encontrar,1,19,18,1,1,0,1
indemnizar,6,5,1,1,-1,0,1
detener,3,10,7,1,1,0,1
robar,3,10,7,1,1,0,1
dar,2,9,7,1,1,0,1
consumir,1,3,-2,-1,-1,0,1
ganar,4,10,6,1,1,0,1
mentalizar,1,19,18,1,1,1,1
perder,2,11,9,1,1,0,1
rubricar,7,4,3,1,-1,0,1
buscar,3,4,1,1,1,0,1
acercar,1,3,2,1,1,1,1
competir,6,8,2,1,1,0,1
conseguir,8,11,3,1,1,0,1
entrenar,4,9,5,1,1,0,1
defender,4,15,11,1,1,0,1
honrar,27,6,21,1,-1,0,1
vender,10,2,8,1,-1,0,1
obtener,9,2,7,1,-1,1,1
necesitar,5,18,13,1,1,0,1
ganar,1,6,5,1,1,-1,1
recibir,8,23,15,1,1,0,1
desarrollar,7,10,3,1,1,0,1
marcar,2,11,9,1,1,0,1
hundir,3,4,1,1,1,0,1
desatar,3,4,1,1,1,0,1
dañar,6,3,-3,-1,1,0,1
justificar,1,2,1,1,1,1,1
justificar,2,4,2,1,1,0,1
mantener,3,17,14,1,1,0,1
mantener,1,6,5,1,1,1,1
envalentonar,31,3,28,1,-1,0,1
sacar,1,25,24,1,1,0,1
perder,1,21,20,1,1,0,1
hacer,2,4,2,1,1,0,1
perdonar,2,3,-1,-1,-1,0,1
perder,2,8,6,1,1,0,1
provocar,2,2,0,0,1,0,1
aprobar,11,5,6,1,-1,0,1
gestionar,7,5,-2,-1,1,0,1
manejar,3,16,13,1,1,0,1
negociar,5,20,15,1,1,0,1
operar,7,4,-3,-1,1,1,1
controlar,3,14,11,1,1,0,1
obtener,2,5,3,1,1,0,1
cuidar,2,6,4,1,1,0,1
tener,2,3,1,1,1,0,1
apelar,2,7,5,1,1,0,1
extender,1,4,3,1,1,1,1
poner,2,2,0,0,1,0,1
crear,6,38,32,1,1,0,1
presentar,2,9,7,1,1,0,1
responder,9,6,3,1,-1,0,1
dejar,2,3,-1,-1,-1,0,1
comprometer,5,6,1,1,1,0,1
subir,4,2,-2,-1,1,0,1
subir,4,2,-2,-1,1,0,1
cruzar,2,11,9,1,1,0,1
reducir,2,3,1,1,1,0,1
disputar,8,2,-6,-1,1,0,1
cruzar,1,5,4,1,1,1,1
jugar,4,2,-2,-1,1,0,1
hacer,3,2,-1,-1,1,0,1
contar,23,3,20,1,-1,0,1
recuperar,4,10,6,1,1,0,1
garantizar,2,4,2,1,1,0,1
ganar,2,2,0,0,-1,0,1
defender,6,7,-1,-1,-1,0,1
poner,4,2,2,1,-1,0,1
empatar,2,8,6,1,1,0,1
relevar,3,3,0,0,1,0,1
ver,2,3,1,1,1,1,1
mantener,3,3,0,0,1,0,1
interpretar,23,3,20,1,-1,0,1
constatar,34,3,31,1,-1,0,1
precipitar,6,2,4,1,-1,0,1
presentar,3,11,8,1,1,0,1
utilizar,1,4,3,1,1,1,1
reiterar,2,28,26,1,1,0,1
arrastrar,7,3,4,1,-1,0,1
elevar,6,2,4,1,-1,0,1
hacer,1,9,8,1,1,1,1
aprovechar,2,3,1,1,1,0,1
definir,6,25,19,1,1,0,1
derrotar,2,5,3,1,1,0,1
cumplimentar,29,3,26,1,-1,0,1
corresponder,30,17,-13,-1,1,0,1
crear,3,3,0,0,1,0,1
contratar,1,10,9,1,1,0,1
destacar,26,5,21,1,-1,0,1
motivar,5,6,1,1,1,0,1
tener,2,21,19,1,1,0,1
alejar,4,4,0,0,1,0,1
favorecer,8,5,-3,-1,1,0,1
solicitar,2,8,6,1,1,1,1
ganar,1,5,4,1,1,0,1
abandonar,2,4,2,1,1,0,1
representar,24,2,22,1,-1,0,1
suponer,9,4,5,1,-1,0,1
explicar,6,26,20,1,1,0,1
dejar,6,5,-1,-1,1,0,1
mandar,3,2,-1,-1,1,0,1
volver,1,9,8,1,1,1,1
desmontar,2,2,0,0,1,0,1
probar,2,4,2,1,1,0,1
canalizar,8,5,-3,-1,1,0,1
paralizar,4,7,3,1,1,0,1
llevar,3,7,-4,-1,-1,0,1
poner,4,6,2,1,1,0,1
ver,3,5,2,1,1,0,1
llegar,3,2,1,1,-1,0,1
conciliar,2,29,27,1,1,0,1
pasar,2,3,1,1,1,0,1
pasar,2,3,1,1,1,0,1
asolar,1,4,3,1,1,0,1
culminar,3,6,3,1,1,0,1
enviar,4,2,-2,-1,1,0,1
recibir,1,3,2,1,1,0,1
reservar,8,3,-5,-1,1,0,1
acompañar,3,8,5,1,1,0,1
dar,2,2,0,0,1,0,1
alcanzar,7,4,-3,-1,1,0,1
capturar,2,5,3,1,1,0,1
tener,5,6,-1,-1,-1,0,1
perder,6,3,3,1,-1,0,1
ganar,3,8,5,1,1,0,1
ver,32,2,30,1,-1,0,1
colaborar,5,3,-2,-1,1,0,1
iniciar,6,23,17,1,1,0,1
lograr,8,24,16,1,1,0,1
corresponder,10,3,-7,-1,1,0,1
saber,2,3,1,1,1,1,1
convertir,2,6,4,1,1,0,1
alcanzar,7,4,-3,-1,1,0,1
educar,4,3,-1,-1,1,0,1
entregar,10,3,7,1,-1,0,1
efectuar,8,3,-5,-1,1,0,1
cometer,15,5,-10,-1,1,0,1
clausurar,11,3,8,1,-1,0,1
suspender,2,8,6,1,1,0,1
llevar,6,7,1,1,1,0,1
sumar,1,3,2,1,1,0,1
lograr,3,3,0,0,1,0,1
significar,3,3,0,0,1,0,1
obtener,5,29,24,1,1,0,1
justificar,17,27,10,1,1,0,1
establecer,2,3,1,1,1,0,1
referir,1,3,2,1,1,1,1
hacer,2,32,30,1,1,0,1
guardar,4,6,2,1,1,0,1
mandar,3,3,0,0,1,0,1
acorralar,2,3,1,1,1,0,1
rememorar,2,5,3,1,1,0,1
incluir,27,4,23,1,-1,0,1
aplazar,4,8,4,1,1,0,1
aventajar,17,3,14,1,-1,0,1
presentar,7,3,4,1,-1,0,1
provocar,1,9,8,1,1,0,1
protagonizar,4,4,0,0,1,0,1
realizar,9,2,7,1,-1,0,1
garantizar,5,6,1,1,1,0,1
organizar,2,2,0,0,1,0,1
favorecer,12,3,9,1,-1,0,1
cubrir,3,3,0,0,-1,0,1
suspender,9,3,-6,-1,1,0,1
trasladar,1,3,2,1,1,1,1
legitimar,3,18,15,1,1,0,1
asumir,1,3,2,1,1,0,1
sobrepasar,3,4,1,1,1,0,1
poner,3,2,1,1,-1,0,1
cubrir,3,3,0,0,-1,0,1
contar,5,3,2,1,-1,0,1
formar,6,4,-2,-1,1,0,1
expulsar,6,4,-2,-1,1,0,1
movilizar,3,5,2,1,1,0,1
incluir,2,6,4,1,1,0,1
garantizar,2,13,11,1,1,0,1
afrontar,4,5,1,1,1,0,1
presentar,5,4,-1,-1,1,0,1
subir,2,4,2,1,1,0,1
amar,2,6,4,1,1,0,1
aceptar,5,7,2,1,1,0,1
crear,5,3,-2,-1,1,0,1
expulsar,4,5,-1,-1,-1,0,1
suavizar,1,13,12,1,1,1,1
vencer,4,3,1,1,-1,0,1
recibir,4,12,8,1,1,0,1
superar,3,27,24,1,1,0,1
llegar,1,5,4,1,1,0,1
rematar,10,10,0,0,1,0,1
imponer,1,4,3,1,1,1,1
ganar,9,5,4,1,-1,0,1
vencer,14,3,11,1,-1,0,1
compartir,1,8,7,1,1,0,1
tener,29,4,25,1,-1,0,1
apoyar,5,4,-1,-1,1,0,1
quedar,1,2,1,1,1,0,1
renunciar,7,5,-2,-1,1,0,1
mencionar,46,2,44,1,-1,0,1
sufrir,4,14,10,1,1,0,1
gritar,9,5,4,1,-1,0,1
mostrar,28,6,22,1,-1,0,1
alinear,3,5,2,1,1,0,1
expresar,10,3,7,1,-1,0,1
cambiar,2,3,1,1,1,0,1
crear,1,3,2,1,1,0,1
centrar,4,6,2,1,1,0,1
defender,4,13,9,1,1,0,1
tratar,2,18,16,1,1,0,1
alimentar,1,3,2,1,1,1,1
experimentar,7,6,-1,-1,1,0,1
alcanzar,4,3,1,1,-1,0,1
visitar,22,4,18,1,-1,0,1
cruzar,4,3,-1,-1,1,0,1
superar,4,6,-2,-1,-1,0,1
tener,2,4,2,1,1,0,1
perder,2,4,2,1,1,0,1
votar,3,8,5,1,1,0,1
apoyar,3,14,11,1,1,0,1
lograr,6,3,-3,-1,1,0,1
ocupar,5,7,2,1,1,0,1
realizar,6,21,15,1,1,0,1
consultar,3,2,-1,-1,1,0,1
cumplir,6,12,6,1,1,0,1
provocar,5,2,-3,-1,1,0,1
renunciar,3,16,13,1,1,0,1
usar,2,3,1,1,1,0,1
probar,6,6,0,0,1,0,1
desarrollar,3,22,19,1,1,0,1
liderar,2,3,1,1,1,0,1
disputar,2,5,3,1,1,0,1
tener,3,5,2,1,1,0,1
ganar,4,4,0,0,1,0,1
noquear,5,3,-2,-1,1,0,1
ensuciar,2,5,-3,-1,-1,0,1
conseguir,5,4,1,1,-1,0,1
ofrecer,10,4,6,1,-1,0,1
reorganizar,3,6,3,1,1,0,1
contar,4,5,1,1,1,0,1
situar,1,2,1,1,1,1,1
sumar,2,3,1,1,1,0,1
significar,3,4,1,1,1,0,1
vencer,3,7,4,1,1,0,1
lograr,3,3,0,0,1,0,1
completar,6,3,-3,-1,1,0,1
dar,2,2,0,0,1,0,1
conseguir,14,4,-10,-1,1,0,1
tener,1,8,7,1,1,0,1
liderar,6,5,-1,-1,1,0,1
concluir,2,5,3,1,1,0,1
dejar,22,5,17,1,-1,0,1
despejar,1,5,4,1,1,1,1
firmar,19,9,10,1,-1,0,1
alcanzar,10,3,-7,-1,1,0,1
seguir,3,2,1,1,-1,0,1
detectar,3,5,2,1,1,0,1
iniciar,2,7,5,1,1,0,1
resultar,2,5,3,1,1,0,1
llevar,4,3,-1,-1,1,0,1
prolongar,2,5,3,1,1,0,1
sentenciar,5,10,5,1,1,0,1
repartir,3,19,16,1,1,0,1
llevar,21,4,17,1,-1,0,1
tener,3,3,0,0,1,0,1
hacer,1,2,1,1,1,0,1
comprobar,9,3,6,1,-1,0,1
caber,2,4,2,1,1,0,1
expresar,38,3,35,1,-1,0,1
ganar,1,8,7,1,1,0,1
conectar,2,4,2,1,1,0,1
conocer,25,4,21,1,-1,0,1
tener,2,2,0,0,1,0,1
tener,6,3,3,1,-1,0,1
corresponder,15,3,12,1,-1,0,1
llevar,7,3,4,1,-1,0,1
compensar,16,6,10,1,-1,-1,1
anunciar,18,6,12,1,-1,0,1
tener,22,3,19,1,-1,0,1
tener,6,2,4,1,-1,0,1
regresar,4,3,1,1,-1,0,1
derrotar,5,8,3,1,1,0,1
conseguir,4,7,3,1,1,0,1
regresar,2,5,3,1,1,0,1
obtener,4,3,-1,-1,1,0,1
limitar,5,7,2,1,1,0,1
consolidar,4,10,6,1,1,0,1
dejar,24,3,21,1,-1,0,1
promocionar,7,4,-3,-1,1,0,1
contar,16,3,13,1,-1,0,1
anotar,2,41,39,1,1,0,1
dominar,2,3,1,1,1,0,1
pasar,1,5,4,1,1,1,1
desplazar,8,2,6,1,-1,0,1
ganar,34,2,32,1,-1,0,1
cosechar,5,3,2,1,-1,0,1
anotar,2,6,4,1,1,0,1
cerrar,2,7,5,1,1,0,1
perder,10,2,8,1,-1,0,1
recuperar,4,4,0,0,1,0,1
pagar,4,22,18,1,1,0,1
sorprender,32,4,28,1,-1,0,1
contratar,2,2,0,0,1,0,1
generar,4,3,-1,-1,1,0,1
usar,1,4,3,1,1,1,1
pesidir,26,3,23,1,-1,0,1
acercar,2,3,1,1,1,0,1
ocupar,1,3,2,1,1,0,1
acercar,1,4,3,1,1,1,1
acercar,1,11,10,1,1,1,1
tener,1,7,6,1,1,0,1
optar,2,2,0,0,1,0,1
mirar,1,3,2,1,1,1,1
estudiar,1,2,1,1,1,0,1
esperar,1,2,1,1,1,-1,1
esperar,1,2,1,1,1,-1,1
conceder,8,24,16,1,1,0,1
conceder,4,3,-1,-1,1,0,1
explicar,30,2,28,1,-1,0,1
tener,2,3,1,1,1,0,1
descartar,2,8,6,1,1,0,1
ir,1,2,1,1,1,1,1
recoger,11,4,7,1,-1,0,1
eliminar,4,4,0,0,1,0,1
facilitar,3,5,2,1,1,0,1
dejar,25,6,19,1,-1,0,1
ganar,2,4,-2,-1,-1,0,1
disputar,5,4,1,1,-1,0,1
vencer,2,3,1,1,1,0,1
encontrar,1,3,2,1,1,1,1
abandonar,1,6,5,1,1,0,1
hacer,3,2,1,1,-1,0,1
hacer,43,15,28,1,-1,0,1
controlar,4,5,1,1,1,0,1
acatar,2,12,10,1,1,0,1
asumir,5,22,17,1,1,0,1
conducir,3,21,18,1,1,0,1
traer,7,4,3,1,-1,0,1
entrevistar,1,5,4,1,1,1,1
constituir,1,13,12,1,1,1,1
poner,1,8,7,1,1,1,1
establecer,3,5,2,1,1,0,1
tener,3,3,0,0,-1,0,1
recibir,24,2,22,1,-1,0,1
repartir,1,3,2,1,1,0,1
estrenar,3,6,3,1,1,0,1
realizar,1,3,2,1,1,0,1
tener,14,3,11,1,-1,0,1
decidir,2,3,1,1,1,0,1
arrojar,2,4,2,1,1,0,1
recibir,4,35,31,1,1,0,1
aumentar,4,6,-2,-1,-1,0,1
perder,3,3,0,0,1,0,1
poner,12,2,10,1,-1,0,1
calcular,1,6,5,1,1,0,1
retener,8,8,0,0,1,0,1
dirimir,5,2,3,1,-1,0,1
acercar,5,2,3,1,-1,-1,1
acariciar,10,5,-5,-1,1,0,1
meter,2,5,3,1,1,0,1
conseguir,2,8,6,1,1,0,1
encarar,2,32,30,1,1,0,1
comprobar,33,5,28,1,-1,0,1
causar,1,8,7,1,1,0,1
arrastrar,1,4,3,1,1,0,1
ganar,3,8,5,1,1,0,1
recuperar,19,3,16,1,-1,0,1
salir,7,6,-1,-1,1,0,1
disponer,8,4,-4,-1,1,0,1
inquietar,2,7,5,1,1,0,1
poner,3,2,1,1,-1,0,1
disponer,5,3,-2,-1,1,0,1
jugar,4,3,1,1,-1,0,1
exclamar,1,4,-3,-1,-1,0,1
mostrar,4,13,9,1,1,0,1
recibir,7,5,2,1,-1,0,1
necesitar,1,9,8,1,1,0,1
hablar,3,12,9,1,1,-1,1
permitir,3,3,0,0,1,0,1
pedir,2,3,-1,-1,-1,0,1
sustituir,2,5,3,1,1,0,1
profesar,2,3,1,1,1,0,1
sacar,2,3,1,1,1,0,1
registrar,5,3,-2,-1,1,0,1
colgar,1,2,1,1,1,1,1
ganar,4,2,-2,-1,1,0,1
salir,1,2,1,1,1,0,1
mantener,1,5,4,1,1,1,1
concluir,2,6,4,1,1,0,1
mantener,1,3,2,1,1,1,1
renunciar,2,15,13,1,1,1,1
renunciar,4,16,12,1,1,0,1
participar,26,4,22,1,-1,0,1
vencer,3,3,0,0,1,0,1
marcar,3,22,19,1,1,0,1
inaugurar,15,6,9,1,-1,0,1
recibir,21,16,5,1,-1,0,1
descubrir,3,5,2,1,1,0,1
seguir,51,6,45,1,-1,0,1
promulgar,9,2,7,1,-1,0,1
revitalizar,8,45,37,1,1,0,1
expulsar,1,2,1,1,1,1,1
sacar,2,3,-1,-1,-1,0,1
provocar,4,4,0,0,1,0,1
sentar,1,7,6,1,1,1,1
evolucionar,21,2,19,1,-1,0,1
hacer,2,8,6,1,1,0,1
lograr,4,7,3,1,1,0,1
tener,1,2,1,1,1,0,1
sumar,2,5,3,1,1,0,1
administrar,7,3,-4,-1,1,0,1
batir,5,3,2,1,-1,0,1
perder,2,2,0,0,1,0,1
hacer,1,6,5,1,1,1,1
despedir,6,36,30,1,1,0,1
acompañar,14,3,11,1,-1,0,1
iniciar,4,21,17,1,1,0,1
tener,5,22,17,1,1,0,1
recorrer,9,4,-5,-1,1,0,1
acompañar,3,8,5,1,1,0,1
producir,5,11,6,1,1,0,1
hacer,3,17,14,1,1,0,1
prohibir,4,4,0,0,1,0,1
conducir,2,6,4,1,1,0,1
viajar,1,2,-1,-1,-1,0,1
enumerar,26,3,23,1,-1,0,1
destruir,11,17,6,1,1,0,1
poseer,2,4,2,1,1,0,1
celebrar,14,2,12,1,-1,0,1
cortar,13,7,6,1,-1,0,1
hacer,2,10,8,1,1,0,1
sufrir,3,12,9,1,1,0,1
conseguir,4,17,13,1,1,0,1
hacer,7,7,0,0,1,0,1
conseguir,2,6,4,1,1,0,1
permitir,1,3,2,1,1,1,1
ganar,7,3,-4,-1,1,0,1
garantizar,3,9,6,1,1,0,1
renunciar,3,2,-1,-1,1,0,1
disputar,8,3,5,1,-1,0,1
tener,3,3,0,0,1,0,1
contar,3,3,0,0,1,0,1
devolver,2,4,2,1,1,0,1
promover,3,4,1,1,1,0,1
recibir,40,6,34,1,-1,0,1
establecer,16,6,10,1,-1,0,1
adecuar,10,4,6,1,-1,0,1
pertenecer,3,44,41,1,1,0,1
criticar,35,3,32,1,-1,0,1
tener,4,5,1,1,1,0,1
plantar,2,7,5,1,1,0,1
entregar,2,6,4,1,1,0,1
enrolar,1,18,17,1,1,1,1
ganar,1,3,2,1,1,0,1
sonar,1,4,3,1,1,0,1
crear,4,8,4,1,1,0,1
manifestar,1,4,3,1,1,1,1
dejar,2,4,-2,-1,-1,0,1
iniciar,8,4,-4,-1,1,0,1
contribuir,5,4,-1,-1,1,0,1
afrontar,2,3,1,1,1,0,1
ganar,3,2,-1,-1,1,0,1
tener,2,22,20,1,1,0,1
instalar,6,2,-4,-1,1,0,1
instalar,2,2,0,0,1,0,1
celebrar,28,2,26,1,-1,0,1
preparar,4,36,32,1,1,0,1
argumentar,20,6,14,1,-1,0,1
lamentar,18,14,-4,-1,1,0,1
tratar,2,33,31,1,1,0,1
dirimir,2,3,1,1,1,0,1
poner,5,2,3,1,-1,0,1
descender,2,4,-2,-1,-1,0,1
abrir,6,27,21,1,1,0,1
quedar,1,7,6,1,1,0,1
traer,7,2,5,1,-1,0,1
celebrar,14,4,10,1,-1,0,1
comenzar,2,2,0,0,1,0,1
unir,4,4,0,0,-1,0,1
comenzar,2,23,21,1,1,0,1
conocer,15,7,8,1,-1,0,1
pertenecer,4,13,9,1,1,0,1
explicar,11,8,-3,-1,1,0,1
pasear,2,5,3,1,1,0,1
contar,2,3,1,1,1,0,1
advertir,1,3,2,1,1,1,1
centrar,10,8,-2,-1,1,0,1
captar,3,4,1,1,1,0,1
establecer,2,3,1,1,1,0,1
subir,4,4,0,0,1,0,1
aprobar,26,4,-22,-1,1,0,1
adoptar,6,11,-5,-1,-1,0,1
aumentar,2,9,7,1,1,0,1
vender,18,3,-15,-1,1,0,1
competir,4,24,20,1,1,0,1
acabar,5,4,-1,-1,1,0,1
generar,3,2,-1,-1,1,0,1
hablar,3,3,0,0,-1,0,1
presentar,2,14,12,1,1,0,1
caer,1,10,9,1,1,0,1
explotar,2,3,-1,-1,-1,0,1
explicar,5,11,6,1,1,0,1
diseñar,1,3,2,1,1,1,1
reclamar,14,2,12,1,-1,0,1
denunciar,25,3,22,1,-1,0,1
buscar,2,11,9,1,1,0,1
consultar,26,4,22,1,-1,0,1
afianzar,3,2,-1,-1,1,0,1
ubicar,3,8,5,1,1,0,1
poner,3,2,1,1,-1,0,1
ganar,2,3,1,1,1,0,1
bajar,2,3,1,1,1,0,1
causar,1,6,5,1,1,0,1
llegar,3,2,-1,-1,1,-1,1
abrir,2,8,6,1,1,0,1
iniciar,1,4,3,1,1,0,1
impulsar,3,3,0,0,1,0,1
condimentar,13,5,8,1,-1,0,1
dejar,1,3,2,1,1,0,1
responder,6,3,3,1,-1,0,1
ocupar,3,6,3,1,1,0,1
alcanzar,3,3,0,0,1,0,1
afrontar,3,4,1,1,1,0,1
cerrar,2,7,5,1,1,0,1
culminar,3,8,5,1,1,0,1
servir,8,3,5,1,-1,0,1
acompañar,2,3,-1,-1,-1,0,1
compartir,11,2,9,1,-1,1,1
abandonar,1,21,20,1,1,0,1
mantener,4,4,0,0,1,0,1
ganar,2,3,1,1,1,-1,1
defender,2,2,0,0,-1,0,1
iniciar,2,13,11,1,1,0,1
incluir,2,6,4,1,1,0,1
pasar,5,3,-2,-1,1,0,1
tener,1,3,2,1,1,0,1
llevar,11,3,8,1,-1,0,1
recuperar,6,9,3,1,1,0,1
tener,2,4,2,1,1,0,1
disputar,10,14,4,1,1,0,1
lanzar,17,3,14,1,-1,0,1
concentrar,1,4,3,1,1,1,1
tener,3,7,4,1,1,0,1
disponer,3,4,1,1,1,0,1
significar,8,5,-3,-1,1,0,1
establecer,3,6,3,1,1,0,1
superar,9,5,-4,-1,1,0,1
adelantar,12,14,2,1,1,0,1
reducir,3,7,4,1,1,0,1
reducir,3,7,4,1,1,0,1
cumplir,12,7,-5,-1,1,0,1
desglosar,2,5,3,1,1,0,1
perder,1,3,2,1,1,0,1
impartir,2,2,0,0,1,0,1
sorprender,2,6,4,1,1,0,1
dar,2,19,17,1,1,0,1
redimir,2,23,21,1,1,0,1
controlar,3,4,1,1,1,0,1
fabricar,12,4,8,1,-1,1,1
inyectar,5,11,6,1,1,-1,1
integrar,9,3,6,1,-1,0,1
hacer,1,9,8,1,1,0,1
formar,4,2,2,1,-1,1,1
recibir,2,12,10,1,1,0,1
estrenar,4,12,8,1,1,0,1
traspasar,4,3,-1,-1,1,0,1
cambiar,5,13,8,1,1,0,1
compensar,3,11,8,1,1,0,1
oír,1,3,2,1,1,1,1
diseñar,9,3,6,1,-1,0,1
echar,2,3,1,1,1,0,1
lograr,3,3,0,0,1,0,1
aprobar,1,4,3,1,1,1,1
perder,8,6,-2,-1,1,0,1
justificar,2,12,10,1,1,0,1
mandar,1,3,2,1,1,1,1
bajar,2,3,1,1,1,0,1
exigir,11,3,8,1,-1,0,1
aumentar,2,18,16,1,1,0,1
ahogar,1,6,5,1,1,1,1
esconder,1,5,4,1,1,1,1
denunciar,22,3,19,1,-1,0,1
recurrir,2,9,7,1,1,0,1
desarrollar,1,3,2,1,1,1,1
pujar,3,5,2,1,1,0,1
mantener,3,2,-1,-1,1,0,1
felicitar,1,3,2,1,1,1,1
perjudicar,2,7,5,1,1,0,1
eliminar,3,2,1,1,-1,0,1
dividir,2,2,0,0,1,0,1
dividir,2,2,0,0,1,0,1
tramitar,1,4,3,1,1,1,1
explicar,2,7,5,1,1,0,1
registrar,4,5,1,1,1,0,1
subir,2,2,0,0,1,0,1
aumentar,2,2,0,0,1,0,1
acumular,4,7,3,1,1,0,1
cuestionar,19,4,15,1,-1,0,1
recibir,6,10,4,1,1,0,1
suspender,2,3,-1,-1,-1,0,1
adquirir,6,5,-1,-1,1,0,1
tener,2,4,2,1,1,0,1
tener,5,2,-3,-1,1,0,1
financiar,2,4,2,1,1,0,1
proporcionar,5,19,14,1,1,0,1
comprar,1,4,3,1,1,0,1
adquirir,1,6,5,1,1,0,1
relanzar,5,8,3,1,1,0,1
generar,5,2,-3,-1,1,0,1
caer,6,4,2,1,-1,0,1
quitar,2,3,1,1,1,0,1
tener,5,3,-2,-1,1,0,1
ayudar,3,9,6,1,1,0,1
asesorar,3,5,-2,-1,-1,0,1
realizar,1,3,2,1,1,1,1
permanecer,9,5,4,1,-1,0,1
llevar,2,5,3,1,1,0,1
preparar,4,4,0,0,1,0,1
hacer,1,2,1,1,1,1,1
ir,1,2,1,1,1,1,1
resucitar,3,3,0,0,1,0,1
saludar,6,3,3,1,-1,0,1
jugar,3,3,0,0,1,0,1
tener,2,3,1,1,1,0,1
alcanzar,4,2,-2,-1,1,0,1
contar,7,4,3,1,-1,0,1
afectar,17,3,14,1,-1,0,1
situar,1,2,1,1,1,1,1
mantener,2,3,1,1,1,0,1
ver,3,6,3,1,1,0,1
ceder,4,3,-1,-1,1,0,1
mantener,4,3,-1,-1,1,0,1
rechazar,20,10,-10,-1,1,0,1
incrementar,2,3,1,1,1,0,1
mantener,2,20,18,1,1,0,1
reconducir,2,4,2,1,1,0,1
volver,3,13,10,1,1,0,1
acoger,15,2,13,1,-1,0,1
pensar,2,6,4,1,1,0,1
sancionar,12,9,3,1,-1,0,1
pedir,8,9,1,1,1,0,1
dejar,2,3,-1,-1,-1,0,1
recobrar,2,6,4,1,1,0,1
ganar,3,4,1,1,1,0,1
aumentar,2,3,1,1,1,0,1
utilizar,2,3,1,1,1,0,1
utilizar,5,4,-1,-1,1,0,1
afrontar,5,3,-2,-1,1,0,1
provocar,3,3,0,0,1,0,1
valorar,2,3,1,1,1,0,1
preocupar,1,8,7,1,1,1,1
dar,3,10,7,1,1,0,1
derrotar,2,5,3,1,1,0,1
aplicar,3,4,1,1,1,0,1
firmar,2,20,18,1,1,0,1
recibir,2,10,8,1,1,0,1
poner,2,22,20,1,1,0,1
construir,11,6,5,1,-1,0,1
dejar,2,7,5,1,1,0,1
percibir,10,2,8,1,-1,0,1
hacer,4,5,1,1,1,0,1
ganar,2,3,1,1,1,0,1
llevar,4,3,-1,-1,1,0,1
administrar,2,6,4,1,1,0,1
estampar,1,3,2,1,1,1,1
fraguar,8,3,5,1,-1,0,1
dejar,4,3,-1,-1,1,0,1
encontrar,1,7,6,1,1,0,1
cambiar,2,3,1,1,1,0,1
asistir,1,23,22,1,1,0,1
romper,16,2,14,1,-1,0,1
esperar,3,7,4,1,1,0,1
poner,7,4,-3,-1,1,0,1
pasar,8,6,-2,-1,1,0,1
salir,19,4,15,1,-1,0,1
pedir,1,33,32,1,1,0,1
estar,1,3,2,1,1,0,1
aceptar,4,5,1,1,1,0,1
colaborar,3,7,4,1,1,0,1
crear,4,16,12,1,1,0,1
tener,2,2,0,0,1,0,1
asumir,5,28,23,1,1,0,1
demostrar,2,9,7,1,1,0,1
dar,1,3,2,1,1,1,1
tener,2,14,12,1,1,0,1
controlar,5,4,1,1,-1,0,1
enfrentar,2,15,13,1,1,0,1
cruzar,1,3,2,1,1,1,1
poner,3,3,0,0,1,0,1
depositar,3,4,1,1,1,0,1
trasladar,2,6,4,1,1,0,1
quedar,1,3,2,1,1,1,1
reubicar,2,10,8,1,1,0,1
desempeñar,1,3,2,1,1,0,1
firmar,1,3,2,1,1,0,1
reír,1,3,2,1,1,1,1
convertir,1,3,2,1,1,1,1
escribir,5,2,3,1,-1,1,1
cantar,1,3,2,1,1,1,1
temer,2,6,4,1,1,0,1
pedir,3,3,0,0,-1,0,1
volver,3,7,4,1,1,0,1
probar,3,2,1,1,-1,0,1
probar,3,2,-1,-1,1,0,1
poner,1,3,2,1,1,1,1
encabezar,3,7,-4,-1,-1,0,1
estrenar,8,2,6,1,-1,0,1
tener,3,3,0,0,-1,0,1
hacer,2,27,25,1,1,0,1
hacer,2,8,6,1,1,0,1
probar,2,7,5,1,1,0,1
comprobar,5,15,10,1,1,0,1
perder,14,13,-1,-1,1,0,1
jugar,3,4,1,1,1,0,1
escribir,4,20,16,1,1,0,1
alcanzar,4,5,1,1,1,0,1
casar,1,2,1,1,1,1,1
rebatir,7,6,1,1,-1,0,1
poseer,2,5,3,1,1,0,1
realizar,11,5,-6,-1,1,0,1
recibir,2,6,4,1,1,0,1
pasar,4,3,1,1,-1,0,1
explicar,5,3,2,1,-1,0,1
tener,3,3,0,0,1,0,1
completar,1,20,19,1,1,1,1
presentar,2,23,21,1,1,0,1
estrenar,11,2,9,1,-1,0,1
estrenar,12,3,9,1,-1,0,1
ver,2,4,2,1,1,0,1
olvidar,2,5,3,1,1,0,1
construir,2,11,9,1,1,0,1
reafirmar,7,3,-4,-1,1,0,1
desviar,2,39,37,1,1,0,1
avistar,2,6,4,1,1,0,1
evidenciar,3,7,-4,-1,-1,0,1
ganar,4,2,2,1,-1,1,1
conocer,5,4,-1,-1,1,0,1
poner,2,5,3,1,1,0,1
encontrar,1,17,16,1,1,0,1
dar,6,2,4,1,-1,0,1
mantener,2,41,39,1,1,0,1
contribuir,16,9,7,1,-1,0,1
reunir,35,2,33,1,-1,0,1
mantener,5,18,13,1,1,0,1
recibir,23,10,13,1,-1,0,1
contemplar,2,9,7,1,1,0,1
recuperar,2,14,12,1,1,0,1
animar,10,11,1,1,1,0,1
ejecutar,2,12,10,1,1,0,1
servir,2,9,7,1,1,0,1
defender,2,5,3,1,1,0,1
mantener,1,2,1,1,1,1,1
desarticular,25,2,23,1,-1,0,1
introducir,3,2,-1,-1,1,0,1
detener,3,6,3,1,1,0,1
poner,22,6,16,1,-1,0,1
construir,5,23,18,1,1,0,1
hacer,1,4,3,1,1,0,1
batir,2,38,36,1,1,0,1
encender,4,4,0,0,1,0,1
plantar,1,2,1,1,1,1,1
ejercer,3,7,-4,-1,-1,0,1
elegir,6,2,4,1,-1,0,1
echar,1,3,2,1,1,1,1
pegar,4,3,1,1,-1,0,1
tener,1,4,3,1,1,0,1
recibir,3,2,-1,-1,1,0,1
descubrir,4,3,-1,-1,1,0,1
acordonar,6,7,-1,-1,-1,0,1
restringir,2,13,11,1,1,0,1
centralizar,2,2,0,0,1,0,1
delatar,7,3,4,1,-1,0,1
precipitar,2,4,2,1,1,0,1
superar,5,6,1,1,1,0,1
provocar,3,3,0,0,1,0,1
lucir,4,9,5,1,1,0,1
perder,4,20,16,1,1,0,1
fallar,2,3,1,1,1,0,1
acusar,2,2,0,0,1,0,1
encontrar,9,2,7,1,-1,0,1
ganar,8,15,7,1,1,0,1
llevar,4,5,-1,-1,-1,0,1
apostar,6,15,9,1,1,0,1
tocar,2,3,1,1,1,0,1
empezar,4,8,4,1,1,0,1
llevar,9,3,-6,-1,1,0,1
acabar,1,3,2,1,1,0,1
observar,3,3,0,0,-1,0,1
compartir,1,18,17,1,1,0,1
caer,2,2,0,0,1,0,1
tomar,22,2,20,1,-1,0,1
seguir,1,3,2,1,1,0,1
filmar,4,5,1,1,1,0,1
presentar,10,2,8,1,-1,0,1
narrar,21,7,14,1,-1,0,1
ocupar,9,5,4,1,-1,0,1
trabajar,2,6,4,1,1,0,1
trabajar,2,7,5,1,1,0,1
escribir,1,8,7,1,1,0,1
plantear,11,2,9,1,-1,-1,1
tener,16,3,13,1,-1,0,1
encontrar,3,3,0,0,1,0,1
ofrecer,26,2,24,1,-1,0,1
sacar,2,3,1,1,1,0,1
exhibir,6,2,4,1,-1,0,1
obtener,5,6,1,1,1,0,1
sufrir,3,3,0,0,1,0,1
representar,12,6,-6,-1,1,0,1
batir,1,6,5,1,1,0,1
hacer,1,2,1,1,1,0,1
expresar,19,3,16,1,-1,0,1
rodar,2,15,13,1,1,0,1
mezclar,2,3,1,1,1,0,1
colocar,5,9,4,1,1,0,1
pasear,2,7,5,1,1,0,1
levantar,1,5,4,1,1,1,1
presentar,1,2,1,1,1,1,1
acompañar,5,3,2,1,-1,0,1
estructurar,3,4,1,1,1,0,1
centrar,4,15,11,1,1,0,1
regresar,1,3,2,1,1,0,1
poner,2,2,0,0,1,0,1
abrir,2,21,19,1,1,0,1
participar,4,44,40,1,1,0,1
hacer,2,10,8,1,1,0,1
hacer,2,3,1,1,1,0,1
tomar,1,2,1,1,1,1,1
seguir,1,27,26,1,1,0,1
pasar,5,4,-1,-1,1,0,1
situar,2,3,1,1,1,0,1
reír,1,4,3,1,1,1,1
llevar,21,2,19,1,-1,0,1
presentar,2,2,0,0,1,0,1
justificar,2,27,25,1,1,0,1
lograr,4,12,8,1,1,0,1
satisfacer,4,7,3,1,1,0,1
realizar,2,4,2,1,1,0,1
preparar,1,4,3,1,1,0,1
acompañar,3,7,4,1,1,0,1
poner,6,10,4,1,1,0,1
invadir,1,5,4,1,1,0,1
encarnar,3,4,1,1,1,0,1
acreditar,4,3,1,1,-1,0,1
igualar,13,3,10,1,-1,0,1
controlar,2,3,1,1,1,0,1
superar,3,2,-1,-1,1,0,1
recoger,1,6,5,1,1,0,1
apoyar,3,2,1,1,-1,0,1
elevar,1,6,5,1,1,1,1
modernizar,2,7,5,1,1,0,1
desenvolver,1,3,2,1,1,1,1
mover,1,5,4,1,1,1,1
pedir,1,6,5,1,1,0,1
obtener,6,3,3,1,-1,0,1
provocar,2,5,3,1,1,0,1
reconciliar,1,4,3,1,1,1,1
sorprender,5,4,1,1,-1,0,1
dormir,2,4,2,1,1,0,1
interpretar,12,17,5,1,1,0,1
utilizar,4,4,0,0,1,0,1
abrir,2,3,1,1,1,0,1
incorporar,1,3,2,1,1,0,1
presentar,3,3,0,0,-1,0,1
producir,5,11,6,1,1,0,1
lograr,7,12,5,1,1,0,1
sumar,2,10,8,1,1,0,1
superar,1,2,1,1,1,1,1
marcar,2,5,3,1,1,0,1
afrontar,2,8,6,1,1,0,1
responsabilizar,1,21,20,1,1,1,1
oponer,4,23,19,1,1,0,1
tener,7,2,5,1,-1,0,1
hacer,3,6,3,1,1,0,1
fusilar,2,3,-1,-1,-1,0,1
maquillar,1,6,5,1,1,1,1
cancelar,2,4,2,1,1,0,1
cambiar,1,12,11,1,1,1,1
hacer,1,3,2,1,1,0,1
parodiar,2,7,5,1,1,0,1
quedar,1,3,2,1,1,0,1
abrir,2,4,2,1,1,0,1
vender,10,3,-7,-1,1,0,1
hacer,4,9,5,1,1,0,1
presentar,17,5,12,1,-1,0,1
corresponder,6,2,4,1,-1,0,1
sentar,4,3,1,1,-1,0,1
mantener,13,2,11,1,-1,0,1
tener,2,6,4,1,1,0,1
poner,4,3,-1,-1,1,0,1
repasar,2,6,4,1,1,0,1
conseguir,4,3,-1,-1,1,0,1
componer,5,4,-1,-1,1,0,1
elevar,2,4,2,1,1,0,1
hacer,15,2,13,1,-1,0,1
pasar,2,2,0,0,1,0,1
visitar,3,3,0,0,1,0,1
sustituir,3,5,2,1,1,0,1
dirigir,1,6,5,1,1,1,1
interpretar,2,3,1,1,1,0,1
acoger,19,2,17,1,-1,0,1
estrenar,1,2,1,1,1,1,1
confeccionar,2,5,3,1,1,0,1
anunciar,4,3,-1,-1,1,0,1
resolver,16,6,-10,-1,1,0,1
acudir,15,5,10,1,-1,0,1
recibir,4,8,4,1,1,0,1
pulsar,5,2,3,1,-1,0,1
guardar,2,7,5,1,1,0,1
valer,2,5,3,1,1,0,1
intimidar,1,7,6,1,1,1,1
argumentar,13,4,9,1,-1,0,1
ver,8,8,0,0,1,0,1
presentar,8,2,6,1,-1,0,1
filmar,3,2,-1,-1,1,0,1
detestar,1,7,6,1,1,0,1
retener,2,2,0,0,1,0,1
quedar,1,3,2,1,1,1,1
iniciar,5,3,-2,-1,1,0,1
volver,1,7,6,1,1,0,1
poner,2,7,5,1,1,0,1
tirar,22,2,20,1,-1,0,1
llevar,2,7,5,1,1,0,1
hacer,3,2,-1,-1,1,0,1
hacer,2,3,1,1,1,0,1
aparcar,5,4,-1,-1,1,0,1
lanzar,2,2,0,0,1,0,1
tener,2,7,5,1,1,0,1
retomar,2,23,21,1,1,0,1
mostrar,9,9,0,0,-1,-1,1
comercializar,26,4,22,1,-1,0,1
grabar,4,3,-1,-1,1,0,1
guardar,2,6,4,1,1,0,1
morder,2,2,0,0,1,0,1
sumar,6,10,4,1,1,0,1
dirigir,4,10,6,1,1,0,1
salir,1,3,-2,-1,-1,0,1
sacrificar,2,9,7,1,1,0,1
caber,2,3,1,1,1,1,1
tener,1,3,2,1,1,0,1
volcar,1,2,1,1,1,1,1
resumir,1,25,24,1,1,1,1
tener,1,14,13,1,1,0,1
entender,1,12,11,1,1,1,1
contestar,12,9,-3,-1,1,0,1
producir,1,3,2,1,1,0,1
tener,3,2,1,1,-1,0,1
promover,11,27,16,1,1,0,1
ejercer,14,3,11,1,-1,-1,1
regularizar,2,3,1,1,1,0,1
cubrir,2,3,1,1,1,0,1
limitar,1,3,2,1,1,1,1
abonar,5,16,11,1,1,0,1
externalizar,1,11,10,1,1,1,1
exteriorizar,2,13,11,1,1,0,1
extender,21,18,-3,-1,1,0,1
capitalizar,2,6,4,1,1,0,1
conceder,2,8,6,1,1,0,1
confinar,5,4,-1,-1,1,0,1
dar,1,2,1,1,1,0,1
ver,10,8,2,1,-1,0,1
recibir,4,3,-1,-1,1,0,1
ir,1,3,2,1,1,0,1
lanzar,8,5,-3,-1,1,0,1
reclamar,7,3,4,1,-1,0,1
causar,2,4,2,1,1,0,1
poner,5,2,3,1,-1,0,1
disponer,4,5,1,1,1,0,1
anular,2,4,2,1,1,0,1
retirar,13,13,0,0,1,0,1
querer,1,4,-3,-1,-1,0,1
emitir,12,2,10,1,-1,0,1
falsear,2,6,4,1,1,0,1
celebrar,1,6,5,1,1,1,1
transmitir,9,5,-4,-1,1,0,1
retrasar,3,3,0,0,-1,0,1
saludar,2,3,1,1,1,0,1
dejar,2,4,2,1,1,0,1
recibir,2,21,19,1,1,0,1
poner,14,3,11,1,-1,0,1
hacer,1,2,1,1,1,0,1
tener,2,3,1,1,1,0,1
planificar,50,3,47,1,-1,0,1
superar,2,3,1,1,1,0,1
aplicar,1,4,3,1,1,1,1
aplicar,2,4,2,1,1,0,1
tener,2,6,4,1,1,0,1
buscar,3,13,10,1,1,0,1
resolver,1,27,26,1,1,1,1
acotar,3,3,0,0,-1,0,1
evitar,16,3,13,1,-1,0,1
proceder,3,6,3,1,1,0,1
afrontar,2,7,5,1,1,0,1
decir,15,6,9,1,-1,0,1
navegar,3,3,0,0,-1,0,1
buscar,4,3,-1,-1,1,0,1
tratar,3,2,1,1,-1,1,1
pasar,2,22,20,1,1,0,1
tener,2,2,0,0,1,0,1
adquirir,2,10,8,1,1,0,1
justificar,8,11,3,1,1,0,1
pisar,1,2,1,1,1,0,1
degradar,2,5,3,1,1,0,1
introducir,1,4,3,1,1,1,1
desmentir,8,2,6,1,-1,0,1
prestar,4,5,1,1,1,0,1
lamentar,28,6,22,1,-1,0,1
tener,4,2,2,1,-1,0,1
conducir,6,3,-3,-1,1,0,1
descubrir,2,18,16,1,1,0,1
rescatar,14,3,11,1,-1,0,1
cortar,2,6,4,1,1,0,1
verificar,3,2,1,1,-1,0,1
precintar,3,5,2,1,1,0,1
abrir,2,3,1,1,1,0,1
tener,2,4,2,1,1,0,1
recibir,2,5,3,1,1,0,1
alertar,8,5,3,1,-1,0,1
acercar,1,3,2,1,1,1,1
aplicar,7,7,0,0,-1,0,1
aplicar,3,5,2,1,1,0,1
llevar,2,3,1,1,1,0,1
lanzar,2,7,5,1,1,0,1
criticar,2,7,5,1,1,0,1
reafirmar,4,34,30,1,1,0,1
acabar,3,4,1,1,1,0,1
colocar,1,2,1,1,1,1,1
lanzar,3,3,0,0,1,0,1
repeler,2,4,2,1,1,0,1
recoger,13,2,11,1,-1,0,1
camuflar,1,3,2,1,1,1,1
modular,3,3,0,0,-1,0,1
completar,1,7,6,1,1,1,1
dejar,10,7,-3,-1,1,0,1
hacer,7,11,4,1,1,0,1
encontrar,1,3,2,1,1,1,1
pedir,8,5,-3,-1,1,0,1
pedir,5,3,-2,-1,1,0,1
provocar,4,4,0,0,1,0,1
salir,1,4,3,1,1,1,1
transportar,2,6,4,1,1,0,1
ver,2,3,1,1,1,0,1
estrellar,1,23,22,1,1,1,1
ver,2,3,1,1,1,1,1
exigir,2,7,5,1,1,0,1
meter,1,4,3,1,1,0,1
bombardear,11,10,-1,-1,1,0,1
lanzar,8,8,0,0,1,0,1
hacer,2,2,0,0,1,0,1
dar,11,4,7,1,-1,0,1
ofrecer,2,12,10,1,1,0,1
poner,4,5,1,1,1,0,1
hablar,4,13,9,1,1,0,1
conducir,2,15,13,1,1,0,1
señalar,2,8,6,1,1,0,1
jugar,1,5,4,1,1,0,1
saludar,5,8,-3,-1,-1,0,1
tener,1,2,1,1,1,-1,1
hacer,1,15,14,1,1,1,1
colocar,2,9,7,1,1,0,1
disfrutar,3,2,-1,-1,1,0,1
mantener,3,5,2,1,1,0,1
hacer,2,3,-1,-1,-1,0,1
desviar,4,8,4,1,1,0,1
dar,2,2,0,0,1,0,1
abrir,4,3,-1,-1,1,0,1
aportar,5,3,2,1,-1,0,1
efectuar,2,2,0,0,1,0,1
provocar,2,3,1,1,1,0,1
quedar,5,5,0,0,1,0,1
superar,3,7,4,1,1,0,1
unir,3,6,3,1,1,0,1
acompañar,3,5,2,1,1,0,1
rescatar,3,3,0,0,1,0,1
disparar,4,4,0,0,1,0,1
reafirmar,7,5,2,1,-1,0,1
presentar,1,5,4,1,1,1,1
hacer,27,5,22,1,-1,0,1
mantener,5,13,8,1,1,0,1
mantener,4,5,1,1,1,0,1
abrir,10,6,-4,-1,1,0,1
provocar,3,9,6,1,1,0,1
reforzar,8,6,-2,-1,1,0,1
tener,1,3,2,1,1,0,1
permitir,11,3,8,1,-1,0,1
poner,2,2,0,0,-1,0,1
marchar,1,2,1,1,1,1,1
iniciar,4,2,2,1,-1,0,1
condicionar,3,7,4,1,1,0,1
poner,2,15,13,1,1,0,1
poner,4,2,2,1,-1,0,1
entrar,6,6,0,0,-1,0,1
asegurar,3,3,0,0,1,0,1
preparar,3,8,5,1,1,0,1
preservar,2,5,3,1,1,0,1
crear,3,3,0,0,1,0,1
decir,1,8,7,1,1,1,1
recordar,13,3,10,1,-1,0,1
emplear,4,6,2,1,1,0,1
colocar,2,2,0,0,1,0,1
recibir,3,6,-3,-1,-1,0,1
desencadenar,3,4,1,1,1,0,1
colocar,2,7,5,1,1,0,1
causar,3,7,4,1,1,0,1
recibir,5,6,1,1,1,0,1
desplazar,1,13,12,1,1,1,1
sentar,1,5,4,1,1,1,1
desbloquear,2,3,1,1,1,0,1
tener,2,19,17,1,1,0,1
quedar,2,19,17,1,1,0,1
aprender,5,2,-3,-1,1,0,1
dar,2,3,1,1,1,0,1
tener,3,3,0,0,1,0,1
trabajar,2,5,3,1,1,0,1
pasar,2,8,6,1,1,0,1
sentir,2,3,1,1,1,0,1
catalogar,2,2,0,0,1,0,1
traer,1,2,1,1,1,0,1
causar,2,5,3,1,1,0,1
sacar,2,3,1,1,1,0,1
colocar,1,8,7,1,1,1,1
pesidir,1,4,3,1,1,0,1
sumar,8,3,5,1,-1,0,1
hacer,2,10,8,1,1,0,1
pisotear,4,5,1,1,1,0,1
conseguir,1,7,6,1,1,0,1
adquirir,2,7,5,1,1,0,1
costar,4,2,2,1,-1,0,1
hacer,2,3,1,1,1,0,1
presentar,1,4,3,1,1,0,1
reubicar,1,3,2,1,1,1,1
bombardear,4,27,23,1,1,0,1
destruir,2,3,1,1,1,0,1
librar,11,6,-5,-1,1,0,1
alimentar,2,8,6,1,1,0,1
preparar,1,16,15,1,1,1,1
extender,1,6,5,1,1,1,1
acompañar,2,29,27,1,1,0,1
lograr,4,4,0,0,1,0,1
aumentar,2,3,1,1,1,0,1
lograr,4,4,0,0,-1,0,1
dar,2,5,3,1,1,0,1
traducir,3,2,1,1,-1,0,1
tener,2,2,0,0,1,0,1
tener,1,2,1,1,1,1,1
reducir,10,6,-4,-1,1,0,1
destruir,1,6,5,1,1,0,1
dar,2,2,0,0,1,0,1
adoptado,3,5,2,1,1,0,1
sacar,4,2,-2,-1,1,0,1
pactar,1,5,4,1,1,0,1
contar,6,21,15,1,1,0,1
tener,7,3,4,1,-1,0,1
recibir,3,5,2,1,1,0,1
batir,7,5,-2,-1,1,0,1
adormecer,1,3,2,1,1,1,1
poner,2,3,1,1,1,0,1
acercar,2,10,8,1,1,0,1
notar,1,23,22,1,1,1,1
incorporar,1,3,2,1,1,0,1
presentar,3,5,2,1,1,0,1
dar,6,2,4,1,-1,0,1
atenuar,1,3,2,1,1,1,1
llegar,1,6,5,1,1,1,1
proponer,14,2,12,1,-1,0,1
sellar,13,2,11,1,-1,0,1
integrar,2,5,3,1,1,0,1
excluir,27,4,23,1,-1,0,1
solicitar,2,17,15,1,1,0,1
almacenar,3,10,7,1,1,0,1
desalojar,1,2,1,1,1,1,1
evaluar,2,14,12,1,1,0,1
utilizar,3,3,0,0,1,0,1
repeler,2,3,1,1,1,0,1
reunir,5,8,3,1,1,0,1
guardar,4,10,6,1,1,0,1
dominar,2,2,0,0,1,0,1
volver,1,7,6,1,1,1,1
retrasar,5,4,-1,-1,1,0,1
tener,1,3,2,1,1,0,1
observar,2,5,3,1,1,0,1
identificar,14,5,9,1,-1,0,1
marcar,7,3,4,1,-1,0,1
iniciar,6,2,-4,-1,1,0,1
despertar,4,19,15,1,1,0,1
provocar,3,2,-1,-1,1,0,1
poner,2,10,8,1,1,0,1
situar,2,14,12,1,1,0,1
crucificar,3,2,1,1,-1,0,1
derrotar,2,3,1,1,1,0,1
arrebatar,1,3,2,1,1,1,1
dialogar,4,7,3,1,1,0,1
suscribir,14,2,12,1,-1,1,1
tener,3,4,1,1,1,0,1
reforzar,5,3,2,1,-1,0,1
acallar,2,3,1,1,1,0,1
excluir,4,5,1,1,1,0,1
practicar,2,11,9,1,1,0,1
secuestrar,3,15,12,1,1,0,1
dejar,10,3,7,1,-1,0,1
ilustrar,4,3,1,1,-1,0,1
poner,2,14,12,1,1,0,1
crear,4,3,-1,-1,1,0,1
cambiar,6,3,3,1,-1,0,1
atender,10,3,7,1,-1,0,1
recibir,10,5,-5,-1,1,0,1
dar,1,3,2,1,1,0,1
pedir,1,3,2,1,1,0,1
llevar,6,11,-5,-1,-1,0,1
reservar,1,12,11,1,1,0,1
batir,8,4,4,1,-1,0,1
recibir,6,9,3,1,1,0,1
perder,3,5,2,1,1,0,1
cruzar,4,14,10,1,1,0,1
protagonizar,5,5,0,0,-1,0,1
colocar,4,8,4,1,1,0,1
defender,2,8,6,1,1,0,1
inscribir,3,3,0,0,1,0,1
renovar,7,10,3,1,1,0,1
reiterar,5,9,4,1,1,0,1
poner,2,5,3,1,1,0,1
ocupar,3,3,0,0,-1,0,1
tener,4,4,0,0,1,0,1
defender,2,11,9,1,1,0,1
alcanzar,1,18,17,1,1,0,1
casar,1,2,1,1,1,0,1
pactar,10,9,-1,-1,1,0,1
exponer,2,39,37,1,1,0,1
finalizar,2,6,4,1,1,0,1
promocionar,2,3,-1,-1,-1,0,1
suponer,3,4,1,1,1,0,1
publicar,2,2,0,0,1,0,1
explicar,19,4,15,1,-1,0,1
enmarcar,5,5,0,0,1,0,1
ocupar,3,2,-1,-1,1,0,1
ver,2,3,1,1,1,0,1
hacer,3,9,6,1,1,0,1
recoger,7,2,5,1,-1,0,1
hacer,1,2,1,1,1,0,1
servir,5,3,2,1,-1,0,1
colgar,6,3,3,1,-1,0,1
tener,2,2,0,0,1,0,1
conocer,2,2,0,0,1,0,1
pensar,5,3,-2,-1,1,0,1
tener,8,3,5,1,-1,0,1
tocar,1,12,11,1,1,0,1
cambiar,1,2,1,1,1,0,1
perder,2,11,9,1,1,0,1
rastrear,2,23,21,1,1,0,1
colocar,2,3,1,1,1,0,1
hacer,1,6,5,1,1,0,1
cambiar,5,5,0,0,1,0,1
apagar,5,9,4,1,1,0,1
salir,5,6,1,1,1,0,1
coger,6,2,4,1,-1,0,1
revolucionar,3,3,0,0,1,0,1
poner,1,3,2,1,1,1,1
considerar,5,6,1,1,1,0,1
sufrir,1,5,4,1,1,0,1
establecer,4,2,2,1,-1,0,1
eliminar,3,3,0,0,1,0,1
situar,5,7,2,1,1,0,1
proteger,3,4,1,1,1,0,1
evitar,3,3,0,0,1,0,1
manejar,1,8,7,1,1,1,1
tener,2,4,2,1,1,0,1
dirigir,2,4,2,1,1,0,1
padecer,7,3,-4,-1,1,0,1
acercar,1,3,2,1,1,1,1
concentrar,1,6,5,1,1,1,1
desalojar,4,6,2,1,1,0,1
declarar,4,5,-1,-1,-1,0,1
decretar,4,6,2,1,1,0,1
desalojar,3,7,4,1,1,0,1
repasar,3,2,1,1,-1,0,1
tener,3,2,-1,-1,1,0,1
ratificar,11,4,7,1,-1,0,1
controlar,2,5,3,1,1,0,1
justificar,2,5,3,1,1,0,1
disminuir,2,3,1,1,1,0,1
apurar,7,5,-2,-1,1,0,1
llegar,3,2,-1,-1,1,0,1
renunciar,10,3,-7,-1,1,0,1
impedir,4,5,1,1,1,0,1
tener,1,4,3,1,1,0,1
prometer,4,13,9,1,1,0,1
atacar,2,2,0,0,-1,0,1
atraer,13,21,8,1,1,0,1
entablar,3,3,0,0,1,0,1
volver,13,3,10,1,-1,0,1
discutir,6,2,4,1,-1,0,1
participar,17,2,15,1,-1,0,1
analizar,3,3,0,0,1,0,1
tener,1,6,5,1,1,0,1
añadir,10,15,-5,-1,-1,0,1
mover,1,15,14,1,1,0,1
luchar,4,4,0,0,1,0,1
ensalzar,3,2,1,1,-1,0,1
confirmar,32,2,30,1,-1,0,1
traducir,5,2,3,1,-1,0,1
seguir,2,3,1,1,1,0,1
trasladar,1,2,1,1,1,1,1
dejar,7,3,-4,-1,1,0,1
compartir,20,7,13,1,-1,0,1
revolucionar,15,4,11,1,-1,0,1
hacer,2,7,5,1,1,0,1
hacer,1,4,3,1,1,1,1
llevar,5,2,3,1,-1,1,1
seguir,1,3,2,1,1,0,1
abordar,7,21,14,1,1,0,1
ensayar,4,2,2,1,-1,1,1
quedar,1,7,6,1,1,0,1
provocar,2,5,3,1,1,0,1
encontrar,30,3,27,1,-1,0,1
imaginar,3,5,2,1,1,0,1
maltratar,3,6,3,1,1,0,1
coger,7,6,-1,-1,1,-1,1
poner,4,3,-1,-1,1,0,1
acceder,3,4,1,1,1,0,1
formar,2,18,16,1,1,-1,1
seguir,1,6,5,1,1,1,1
encontrar,1,18,17,1,1,1,1
lanzar,2,4,2,1,1,0,1
levantar,6,3,-3,-1,1,0,1
firmar,3,14,11,1,1,0,1
contar,3,2,1,1,-1,0,1
suspender,11,4,7,1,-1,0,1
recibir,3,3,0,0,1,0,1
demandar,14,14,0,0,1,0,1
buscar,2,8,6,1,1,0,1
correr,1,3,2,1,1,0,1
ejercer,2,2,0,0,1,-1,1
resultar,2,3,1,1,1,0,1
ocupar,8,12,4,1,1,0,1
convocar,2,24,22,1,1,0,1
perder,6,2,4,1,-1,0,1
justificar,7,38,31,1,1,0,1
redistribuir,1,14,13,1,1,1,1
arrastrar,2,3,1,1,1,0,1
incrementar,6,4,2,1,-1,0,1
invertir,4,2,-2,-1,1,0,1
conducir,2,4,2,1,1,0,1
desempeñar,2,6,4,1,1,0,1
ordenar,5,30,25,1,1,0,1
recurrir,35,6,29,1,-1,0,1
tener,3,2,-1,-1,1,0,1
imputar,16,3,13,1,-1,0,1
completar,2,6,4,1,1,0,1
desestimar,12,3,9,1,-1,0,1
obtener,3,5,-2,-1,-1,0,0
recurrir,2,3,-1,-1,-1,0,0
presentar,5,25,-20,-1,-1,0,0
suscribir,21,3,-18,-1,1,0,0
sobrepasar,3,5,2,1,1,0,0
acumular,4,5,-1,-1,-1,0,0
aprender,3,3,0,0,1,0,0
llevar,1,6,-5,-1,-1,-1,0
compartir,10,22,-12,-1,-1,0,0
acoger,8,2,-6,-1,1,0,0
desbordar,1,3,-2,-1,-1,0,0
caminar,1,24,-23,-1,-1,0,0
fundir,6,3,-3,-1,1,0,0
pasar,2,3,-1,-1,-1,0,0
llevar,1,3,-2,-1,-1,0,0
recorrer,1,5,-4,-1,-1,-1,0
llevar,2,2,0,0,-1,0,0
desplazar,1,3,-2,-1,-1,-1,0
marcar,11,25,-14,-1,-1,0,0
presionar,2,3,-1,-1,-1,0,0
hablar,6,5,1,1,-1,0,0
hacer,3,3,0,0,-1,0,0
responder,16,2,-14,-1,1,0,0
dilatar,6,3,-3,-1,1,0,0
ocupar,8,19,-11,-1,-1,0,0
gozar,4,7,-3,-1,-1,0,0
seguir,2,3,-1,-1,-1,0,0
explicar,4,6,2,1,1,0,0
recibir,2,2,0,0,-1,0,0
hablar,2,2,0,0,-1,-1,0
dejar,2,10,-8,-1,-1,0,0
ofrecer,2,3,-1,-1,-1,0,0
lanzar,6,5,1,1,-1,0,0
mejorar,4,3,1,1,-1,0,0
acceder,2,3,-1,-1,-1,0,0
sufrir,32,10,-22,-1,1,1,0
afectar,3,2,1,1,-1,0,0
pasar,2,11,-9,-1,-1,0,0
descargar,1,5,-4,-1,-1,0,0
sufrir,32,10,-22,-1,1,1,0
afectar,3,2,1,1,-1,0,0
pasar,2,11,-9,-1,-1,0,0
descargar,1,5,-4,-1,-1,0,0
nombrar,3,9,-6,-1,-1,0,0
realizar,1,2,-1,-1,-1,-1,0
presentar,9,3,-6,-1,1,0,0
proyectar,3,10,-7,-1,-1,0,0
levantar,3,3,0,0,-1,0,0
reaprovechar,3,3,0,0,-1,0,0
apurar,6,8,-2,-1,-1,0,0
limitar,2,5,-3,-1,-1,0,0
incluir,4,3,1,1,-1,0,0
usar,3,3,0,0,-1,0,0
protagonizar,34,5,-29,-1,1,0,0
matar,6,13,-7,-1,-1,0,0
colocar,3,3,0,0,-1,0,0
llevar,5,2,-3,-1,1,0,0
atracar,15,8,-7,-1,1,0,0
informar,3,9,-6,-1,-1,-1,0
sacar,2,3,-1,-1,-1,0,0
ejercer,2,8,-6,-1,-1,0,0
compartir,3,2,-1,-1,1,0,0
incorporar,2,3,-1,-1,-1,0,0
vender,3,7,-4,-1,-1,0,0
sacar,12,2,-10,-1,1,0,0
mantener,7,2,5,1,-1,0,0
investigar,2,4,-2,-1,-1,0,0
impulsar,4,6,-2,-1,-1,0,0
integrar,34,10,-24,-1,1,0,0
querer,2,7,-5,-1,-1,0,0
participar,4,4,0,0,1,0,0
indemnizar,2,2,0,0,-1,0,0
reclamar,2,9,-7,-1,-1,0,0
aprobar,23,7,-16,-1,1,0,0
mandar,4,5,-1,-1,-1,0,0
condenar,8,11,-3,-1,-1,0,0
anunciar,13,5,-8,-1,1,0,0
controlar,2,5,-3,-1,-1,0,0
hacer,14,8,6,1,-1,0,0
dejar,6,3,3,1,-1,0,0
reducir,2,3,-1,-1,-1,0,0
pasar,2,2,0,0,-1,0,0
revisar,3,3,0,0,-1,0,0
reelaborar,4,4,0,0,-1,0,0
introducir,3,2,1,1,-1,0,0
empezar,2,18,-16,-1,-1,0,0
poner,1,4,-3,-1,-1,0,0
implantar,2,5,-3,-1,-1,0,0
integrar,4,3,-1,-1,1,0,0
constituir,2,3,-1,-1,-1,0,0
perder,10,2,-8,-1,1,0,0
tener,6,3,3,1,-1,0,0
crecer,2,8,-6,-1,-1,0,0
rodear,3,5,-2,-1,-1,0,0
precisar,1,2,-1,-1,-1,0,0
continuar,5,10,-5,-1,-1,0,0
poner,5,2,-3,-1,1,0,0
entregar,3,5,-2,-1,-1,0,0
requerir,1,4,-3,-1,-1,0,0
inscribir,12,3,-9,-1,1,0,0
comenzar,4,2,-2,-1,1,0,0
tomar,2,6,-4,-1,-1,0,0
asumir,7,3,-4,-1,1,0,0
vaticinar,35,2,-33,-1,1,0,0
subir,3,4,1,1,1,0,0
presentar,4,2,-2,-1,1,-1,0
prestar,1,8,-7,-1,-1,0,0
abordar,17,3,-14,-1,1,0,0
exponer,2,5,-3,-1,-1,0,0
retener,3,5,-2,-1,-1,0,0
dar,3,22,-19,-1,-1,0,0
salir,10,4,-6,-1,1,0,0
rodear,2,15,-13,-1,-1,0,0
acoger,7,8,-1,-1,-1,0,0
conducir,1,2,-1,-1,-1,-1,0
llevar,1,2,-1,-1,-1,-1,0
liberar,3,5,2,1,1,0,0
proteger,1,3,-2,-1,-1,-1,0
sostener,2,3,1,1,1,0,0
integrar,9,10,-1,-1,-1,0,0
permanecer,6,7,-1,-1,-1,0,0
sustituir,3,4,-1,-1,-1,0,0
trasladar,3,2,1,1,-1,0,0
actuar,2,10,-8,-1,-1,0,0
recorrer,2,10,-8,-1,-1,0,0
perseguir,2,3,-1,-1,-1,0,0
seguir,2,5,-3,-1,-1,1,0
crecer,5,5,0,0,-1,0,0
sacar,3,4,-1,-1,-1,0,0
alcanzar,5,4,1,1,-1,0,0
subir,2,2,0,0,1,0,0
caer,2,5,-3,-1,-1,0,0
conseguir,11,2,-9,-1,1,0,0
recibir,4,2,2,1,-1,0,0
acumular,5,3,2,1,-1,0,0
ganar,2,3,-1,-1,-1,0,0
tener,2,4,-2,-1,-1,0,0
distribuir,4,2,2,1,-1,0,0
requerir,5,34,-29,-1,-1,0,0
hallar,7,3,-4,-1,1,0,0
encontrar,23,3,-20,-1,1,0,0
trabajar,4,7,-3,-1,-1,0,0
encontrar,2,5,-3,-1,-1,0,0
escuchar,5,3,-2,-1,1,0,0
matar,5,5,0,0,-1,0,0
insultar,1,8,-7,-1,-1,-1,0
presentar,2,2,0,0,-1,0,0
escuchar,1,3,-2,-1,-1,0,0
llegar,1,3,2,1,1,0,0
hacer,6,3,3,1,-1,0,0
atacar,8,3,-5,-1,1,0,0
extraer,2,4,-2,-1,-1,0,0
sacar,2,14,-12,-1,-1,0,0
mantener,2,4,-2,-1,-1,0,0
ingresar,5,5,0,0,1,0,0
celebrar,3,11,-8,-1,-1,0,0
eliminar,8,3,-5,-1,1,0,0
aportar,6,20,-14,-1,-1,0,0
celebrar,7,2,-5,-1,1,0,0
rebajar,4,4,0,0,-1,0,0
llevar,2,27,-25,-1,-1,0,0
representar,29,2,-27,-1,1,0,0
agrupar,19,3,-16,-1,1,0,0
revisar,1,2,-1,-1,-1,0,0
ofrecer,9,4,-5,-1,1,0,0
perder,4,3,1,1,-1,0,0
facturar,2,6,-4,-1,-1,0,0
suprimir,2,3,-1,-1,-1,0,0
justificar,2,5,-3,-1,-1,0,0
acumular,5,4,1,1,-1,0,0
paralizar,4,36,-32,-1,-1,0,0
lucir,6,3,-3,-1,1,0,0
perder,5,8,-3,-1,-1,0,0
suponer,2,3,-1,-1,-1,0,0
censar,4,14,-10,-1,-1,0,0
suicidarse,1,6,-5,-1,-1,-1,0
decidir,1,3,-2,-1,-1,-1,0
grabar,2,2,0,0,-1,0,0
poner,13,2,-11,-1,1,0,0
suspender,7,17,-10,-1,-1,0,0
tener,3,3,0,0,-1,0,0
poner,2,8,-6,-1,-1,0,0
encadenar,3,3,0,0,-1,0,0
tratar,5,12,-7,-1,-1,0,0
sustraer,1,2,-1,-1,-1,0,0
arrestar,1,6,-5,-1,-1,-1,0
sufrir,2,4,-2,-1,-1,0,0
iniciar,2,12,-10,-1,-1,0,0
reforzar,2,2,0,0,-1,0,0
prever,8,3,5,1,-1,0,0
aumentar,2,4,-2,-1,-1,0,0
alcanzar,19,5,-14,-1,1,0,0
provocar,3,7,-4,-1,-1,0,0
realizar,8,6,2,1,-1,0,0
suponer,6,5,1,1,-1,0,0
enlazar,3,8,-5,-1,-1,0,0
continuar,6,3,3,1,-1,0,0
encerrar,1,5,-4,-1,-1,-1,0
tener,2,3,-1,-1,-1,0,0
apretar,2,3,-1,-1,-1,0,0
crear,1,7,-6,-1,-1,0,0
subsanar,6,4,-2,-1,1,0,0
favorecer,12,18,-6,-1,-1,0,0
apostar,3,12,-9,-1,-1,0,0
proteger,2,7,-5,-1,-1,0,0
sacrificar,4,8,-4,-1,-1,0,0
asumir,2,3,1,1,1,0,0
imponer,1,18,-17,-1,-1,-1,0
lanzar,3,2,1,1,-1,0,0
promover,3,4,-1,-1,-1,0,0
asegurar,4,9,-5,-1,-1,0,0
decretar,5,9,-4,-1,-1,0,0
saborear,4,3,-1,-1,1,0,0
preferir,3,4,-1,-1,-1,0,0
realizar,9,5,4,1,-1,0,0
puntualizar,7,6,1,1,-1,0,0
visitar,9,19,-10,-1,-1,0,0
abrir,2,2,0,0,-1,0,0
entregar,1,13,-12,-1,-1,-1,0
promover,2,9,-7,-1,-1,0,0
tener,4,5,1,1,1,0,0
optimizar,7,4,3,1,-1,0,0
integrar,5,11,-6,-1,-1,0,0
impulsar,3,19,-16,-1,-1,0,0
tener,2,3,1,1,1,0,0
poner,7,2,-5,-1,1,0,0
tener,6,3,3,1,-1,0,0
celebrar,2,3,-1,-1,-1,0,0
pedir,7,6,1,1,-1,0,0
rebajar,2,9,-7,-1,-1,0,0
recibir,2,2,0,0,-1,0,0
matar,12,9,3,1,-1,0,0
cerrar,4,2,2,1,-1,0,0
ceder,2,4,-2,-1,-1,0,0
mantener,2,5,-3,-1,-1,0,0
mantener,4,4,0,0,-1,0,0
despeñar,3,7,4,1,1,0,0
tener,2,6,-4,-1,-1,0,0
bajar,17,6,-11,-1,1,0,0
propagar,1,4,-3,-1,-1,-1,0
importar,1,3,-2,-1,-1,-1,0
responder,3,33,-30,-1,-1,0,0
poner,6,3,-3,-1,1,0,0
tomar,2,18,-16,-1,-1,0,0
indemnizar,6,4,2,1,-1,0,0
causar,5,18,-13,-1,-1,0,0
atribuir,2,24,-22,-1,-1,0,0
dar,1,5,-4,-1,-1,0,0
castigar,7,7,0,0,1,0,0
precisar,2,3,-1,-1,-1,0,0
cursar,25,3,22,1,-1,0,0
lanzar,1,3,-2,-1,-1,0,0
regresar,2,7,-5,-1,-1,0,0
estrenar,43,3,-40,-1,1,0,0
ver,1,3,-2,-1,-1,0,0
sentar,1,3,-2,-1,-1,-1,0
incorporar,1,3,-2,-1,-1,-1,0
estrenar,3,2,-1,-1,1,0,0
representar,2,15,-13,-1,-1,0,0
mirar,2,2,0,0,-1,0,0
barrer,12,9,-3,-1,1,0,0
rozar,3,4,-1,-1,-1,0,0
lanzar,6,11,-5,-1,-1,0,0
repartir,7,11,-4,-1,-1,0,0
suponer,5,3,2,1,-1,0,0
sumar,7,2,-5,-1,1,0,0
vivir,2,3,-1,-1,-1,0,0
derrochar,1,10,-9,-1,-1,0,0
llevar,3,9,-6,-1,-1,0,0
limpiar,2,2,0,0,1,0,0
utilizar,3,3,0,0,1,0,0
tener,2,4,2,1,1,0,0
detener,27,5,-22,-1,1,0,0
actuar,2,2,0,0,1,0,0
optar,14,4,-10,-1,1,0,0
mover,2,18,-16,-1,-1,0,0
pillar,3,7,-4,-1,-1,0,0
tramitar,3,5,-2,-1,-1,0,0
pedir,7,2,-5,-1,1,0,0
pedir,12,37,-25,-1,-1,0,0
provocar,3,3,0,0,1,0,0
acompañar,3,2,1,1,-1,0,0
promover,4,17,-13,-1,-1,0,0
utilizar,1,2,-1,-1,-1,-1,0
superar,2,5,3,1,1,0,0
abandonar,2,4,-2,-1,-1,0,0
presenciar,3,3,0,0,-1,0,0
amenazar,3,6,-3,-1,-1,0,0
finalizar,32,2,-30,-1,1,0,0
sustituir,31,5,-26,-1,1,0,0
adecuar,3,4,-1,-1,-1,0,0
aguantar,3,2,-1,-1,1,0,0
recolocar,3,3,0,0,-1,0,0
mandar,9,4,-5,-1,1,0,0
hacer,1,3,-2,-1,-1,-1,0
colocar,2,7,-5,-1,-1,0,0
luchar,3,6,-3,-1,-1,0,0
estudiar,4,8,-4,-1,-1,0,0
picar,1,2,-1,-1,-1,0,0
fichar,3,26,-23,-1,-1,0,0
demostrar,4,7,-3,-1,-1,0,0
pasar,2,2,0,0,-1,0,0
resultar,1,14,-13,-1,-1,0,0
subir,4,3,-1,-1,1,0,0
buscar,3,2,1,1,-1,0,0
desplegar,3,7,-4,-1,-1,0,0
sacar,10,3,-7,-1,1,0,0
acumular,1,6,-5,-1,-1,0,0
tener,1,30,-29,-1,-1,0,0
detener,19,2,-17,-1,1,0,0
condenar,5,3,-2,-1,1,0,0
recibir,3,9,-6,-1,-1,1,0
hallar,1,4,-3,-1,-1,-1,0
juzgar,23,5,-18,-1,1,0,0
pedir,2,4,2,1,1,0,0
ejercer,2,2,0,0,-1,0,0
asesorar,2,18,-16,-1,-1,0,0
ganar,3,3,0,0,-1,0,0
denunciar,13,4,-9,-1,1,0,0
tener,10,3,7,1,-1,0,0
despedir,8,4,4,1,-1,0,0
afectar,3,2,1,1,-1,0,0
reducir,6,3,-3,-1,1,0,0
hacer,3,7,-4,-1,-1,0,0
informar,3,2,-1,-1,1,0,0
tener,5,15,-10,-1,-1,0,0
informar,3,7,-4,-1,-1,0,0
utilizar,5,4,-1,-1,1,0,0
hacer,1,4,-3,-1,-1,0,0
acercar,1,3,-2,-1,-1,-1,0
atribuir,1,3,-2,-1,-1,0,0
ofrecer,7,6,1,1,-1,0,0
avisar,3,3,0,0,-1,0,0
acometer,2,17,-15,-1,-1,0,0
publicar,10,2,-8,-1,1,0,0
recurrir,2,4,-2,-1,-1,0,0
traicionar,5,8,-3,-1,-1,0,0
felicitar,2,20,-18,-1,-1,0,0
necesitar,4,2,2,1,-1,0,0
situar,3,9,-6,-1,-1,0,0
conectar,7,6,1,1,-1,0,0
aplicar,2,3,-1,-1,-1,0,0
ganar,2,2,0,0,-1,0,0
marcar,5,28,-23,-1,-1,0,0
destacar,1,11,-10,-1,-1,-1,0
justificar,11,3,-8,-1,1,0,0
mantener,2,2,0,0,-1,0,0
encontrar,3,9,-6,-1,-1,0,0
desviar,2,2,0,0,-1,0,0
rehacer,1,6,-5,-1,-1,-1,0
desviar,2,6,-4,-1,-1,0,0
ocupar,4,4,0,0,1,0,0
situar,1,5,-4,-1,-1,-1,0
reponer,1,3,-2,-1,-1,-1,0
conseguir,1,5,-4,-1,-1,-1,0
avisar,9,4,-5,-1,1,0,0
ejercer,2,2,0,0,-1,0,0
permitir,4,3,1,1,-1,0,0
entrar,1,3,-2,-1,-1,0,0
rociar,2,2,0,0,-1,0,0
lanzar,1,3,-2,-1,-1,0,0
reducir,2,2,0,0,-1,0,0
presentar,2,6,-4,-1,-1,0,0
pasar,2,3,-1,-1,-1,0,0
retomar,4,14,-10,-1,-1,0,0
fichar,2,5,-3,-1,-1,0,0
tener,11,3,-8,-1,1,0,0
contar,2,7,-5,-1,-1,0,0
ampliar,4,4,0,0,-1,0,0
registrar,12,2,-10,-1,1,0,0
llevar,3,3,0,0,-1,0,0
arrojar,2,2,0,0,-1,0,0
estampar,4,3,1,1,-1,0,0
suspender,15,3,12,1,-1,0,0
recibir,15,5,-10,-1,1,0,0
superar,5,2,3,1,-1,0,0
reducir,7,3,4,1,-1,0,0
contar,25,6,19,1,-1,0,0
seguir,3,3,0,0,-1,0,0
llevar,2,3,-1,-1,-1,0,0
ver,2,10,-8,-1,-1,0,0
celebrar,3,11,-8,-1,-1,0,0
rellenar,6,9,-3,-1,-1,0,0
criticar,22,2,-20,-1,1,0,0
programar,12,14,2,1,1,0,0
elegir,4,3,1,1,-1,0,0
presentar,3,8,-5,-1,-1,0,0
aumentar,5,10,-5,-1,-1,0,0
bailar,2,16,-14,-1,-1,0,0
meter,2,10,-8,-1,-1,0,0
distribuir,10,4,-6,-1,1,0,0
colocar,2,3,-1,-1,-1,0,0
predicar,27,2,-25,-1,1,0,0
hinchar,1,9,-8,-1,-1,0,0
lanzar,14,26,-12,-1,-1,0,0
pescar,2,4,-2,-1,-1,0,0
echar,2,10,-8,-1,-1,0,0
evadir,1,9,-8,-1,-1,0,0
pasar,2,32,-30,-1,-1,0,0
cerrar,5,4,1,1,-1,0,0
ofender,4,3,1,1,-1,0,0
constituir,4,6,-2,-1,-1,-1,0
incumplir,7,5,2,1,-1,0,0
posicionar,3,22,-19,-1,-1,0,0
producir,5,3,2,1,-1,0,0
preparar,3,2,1,1,-1,0,0
tener,2,2,0,0,-1,-1,0
haber,1,3,-2,-1,-1,0,0
asegurar,5,13,-8,-1,-1,0,0
tener,3,7,-4,-1,-1,0,0
separar,2,3,-1,-1,-1,0,0
comparar,2,11,-9,-1,-1,1,0
llevándo,7,2,5,1,-1,0,0
convertir,2,3,-1,-1,-1,0,0
haber,5,7,-2,-1,-1,0,0
tener,7,3,4,1,-1,0,0
realizan,2,10,-8,-1,-1,0,0
tener,3,2,1,1,-1,0,0
tener,6,2,-4,-1,1,0,0
finalizar,2,3,-1,-1,-1,0,0
lograr,2,6,-4,-1,-1,0,0
vender,1,9,-8,-1,-1,0,0
soplar,2,14,-12,-1,-1,0,0
tener,1,4,-3,-1,-1,0,0
dedicar,9,9,0,0,-1,0,0
utilizar,5,2,3,1,-1,0,0
contener,1,2,-1,-1,-1,0,0
reducir,2,10,-8,-1,-1,0,0
vender,2,3,-1,-1,-1,0,0
ver,1,3,-2,-1,-1,-1,0
dejar,8,3,5,1,-1,0,0
realizar,11,6,-5,-1,1,0,0
tener,2,2,0,0,-1,0,0
utilizar,6,3,3,1,-1,0,0
separar,3,10,-7,-1,-1,1,0
tener,1,16,-15,-1,-1,0,0
hacer,4,3,1,1,-1,0,0
enseñar,2,4,-2,-1,-1,0,0
organizar,2,6,-4,-1,-1,0,0
facilitar,5,5,0,0,-1,0,0
ver,6,5,-1,-1,1,0,0
situar,2,15,-13,-1,-1,0,0
incluir,4,5,-1,-1,-1,0,0
representar,3,3,0,0,-1,0,0
dejar,40,3,-37,-1,1,0,0
hacer,1,2,-1,-1,-1,0,0
tenido,1,4,-3,-1,-1,0,0
permitir,1,5,-4,-1,-1,0,0
poner,22,2,-20,-1,1,0,0
convertir,1,8,-7,-1,-1,0,0
mantener,3,74,-71,-1,-1,0,0
controlar,2,6,-4,-1,-1,0,0
convertir,3,5,-2,-1,-1,0,0
cambiar,6,6,0,0,-1,0,0
autorizar,6,23,-17,-1,-1,0,0
transformar,6,5,-1,-1,1,0,0
abandonar,2,8,-6,-1,-1,0,0
solucionar,2,7,-5,-1,-1,0,0
colocar,1,6,-5,-1,-1,-1,0
celebrar,6,2,-4,-1,1,0,0
reducir,2,3,-1,-1,-1,0,0
dejar,2,2,0,0,-1,0,0
descubrir,2,6,-4,-1,-1,0,0
existir,4,3,1,1,-1,0,0
cantar,2,4,-2,-1,-1,0,0
dictar,7,3,4,1,-1,0,0
dar,2,5,-3,-1,-1,0,0
reciclándo,1,6,-5,-1,-1,-1,0
designar,5,15,-10,-1,-1,0,0
compaginar,2,4,-2,-1,-1,0,0
tener,1,10,-9,-1,-1,0,0
captura,11,7,4,1,-1,0,0
atraer,2,3,-1,-1,-1,0,0
agrupar,4,7,-3,-1,-1,0,0
empujar,7,8,-1,-1,-1,0,0
ganar,6,2,4,1,-1,0,0
presenta,18,3,-15,-1,1,0,0
haber,4,2,2,1,-1,1,0
ver,6,2,4,1,-1,0,0
contener,9,25,-16,-1,-1,0,0
escogir,13,3,10,1,-1,0,0
introducir,6,9,-3,-1,-1,0,0
idear,2,7,-5,-1,-1,0,0
integrar,2,16,-14,-1,-1,0,0
afrontar,22,2,-20,-1,1,0,0
tirar,1,3,-2,-1,-1,-1,0
equivaler,3,3,0,0,1,0,0
examinar,4,7,-3,-1,-1,0,0
dar,2,8,-6,-1,-1,0,0
acompañar,4,20,-16,-1,-1,0,0
destruir,3,2,1,1,-1,0,0
atravesar,2,5,-3,-1,-1,0,0
guir,3,3,0,0,-1,0,0
presentar,9,26,-17,-1,-1,0,0
conocer,3,3,0,0,-1,0,0
obtener,1,14,-13,-1,-1,0,0
alberga,7,3,4,1,-1,0,0
negociar,16,3,-13,-1,1,0,0
dar,1,6,-5,-1,-1,0,0
suprimir,8,6,-2,-1,1,0,0
separan,5,5,0,0,-1,0,0
realizar,4,8,-4,-1,-1,0,0
construir,1,5,-4,-1,-1,0,0
desalojar,3,8,-5,-1,-1,0,0
reconocer,2,2,0,0,-1,0,0
tener,1,8,-7,-1,-1,0,0
dar,8,12,-4,-1,-1,0,0
tener,14,2,-12,-1,1,0,0
reconocer,2,2,0,0,-1,0,0
marcar,11,23,-12,-1,-1,0,0
iniciarion,5,4,1,1,-1,0,0
extender,7,3,4,1,-1,0,0
dotar,6,5,1,1,-1,0,0
recuperar,2,3,-1,-1,-1,0,0
sumar,4,3,1,1,-1,0,0
ejercer,2,4,-2,-1,-1,0,0
llevar,4,3,1,1,-1,0,0
empezar,2,4,-2,-1,-1,0,0
citar,2,2,0,0,1,0,0
recibir,1,7,-6,-1,-1,0,0
llevar,2,3,1,1,1,0,0
ganar,2,7,-5,-1,-1,0,0
comprar,5,2,3,1,-1,1,0
llevar,2,3,-1,-1,-1,0,0
querer,4,26,-22,-1,-1,0,0
buscar,5,9,-4,-1,-1,0,0
publicar,10,2,-8,-1,1,0,0
arrancar,2,6,-4,-1,-1,0,0
tener,2,17,-15,-1,-1,0,0
tomar,1,2,-1,-1,-1,-1,0
tener,1,10,-9,-1,-1,0,0
ganar,4,7,-3,-1,-1,0,0
llevar,7,2,-5,-1,1,0,0
donar,3,8,-5,-1,-1,0,0
consumir,1,11,-10,-1,-1,0,0
derribar,3,3,0,0,1,0,0
halándo,1,3,-2,-1,-1,-1,0
reeditar,12,5,7,1,-1,0,0
poseer,1,11,-10,-1,-1,0,0
formar,3,2,1,1,-1,1,0
ganar,2,3,-1,-1,-1,0,0
cargar,1,3,-2,-1,-1,-1,0
fichar,3,3,0,0,-1,0,0
dista,2,12,-10,-1,-1,0,0
grabar,2,6,-4,-1,-1,0,0
hacer,1,4,-3,-1,-1,-1,0
sorprender,5,14,-9,-1,-1,0,0
unar,1,4,-3,-1,-1,0,0
tener,1,4,-3,-1,-1,0,0
escribir,2,3,-1,-1,-1,0,0
diferenciar,1,7,-6,-1,-1,-1,0
firmar,3,9,-6,-1,-1,0,0
presentar,52,5,-47,-1,1,0,0
presento,1,12,-11,-1,-1,0,0
dar,2,3,-1,-1,-1,0,0
lanzar,3,6,-3,-1,-1,0,0
incluir,3,3,0,0,1,0,0
configurar,2,6,-4,-1,-1,0,0
hacer,2,3,-1,-1,-1,0,0
usar,3,5,-2,-1,-1,0,0
desembolsar,5,10,-5,-1,-1,0,0
tener,4,11,-7,-1,-1,0,0
registrar,16,3,-13,-1,1,0,0
aprender,5,3,-2,-1,1,0,0
necesitar,2,3,-1,-1,-1,-1,0
buscar,3,2,1,1,-1,0,0
celebrándo,2,3,1,1,1,0,0
promocionar,2,21,-19,-1,-1,0,0
colgar,2,4,-2,-1,-1,0,0
llevar,2,2,0,0,1,0,0
proteger,2,3,-1,-1,-1,0,0
lanzar,4,5,-1,-1,-1,0,0
superar,3,2,1,1,-1,1,0
desempeñar,3,4,-1,-1,-1,0,0
causar,3,4,-1,-1,-1,0,0
incrementar,2,3,1,1,1,0,0
llevar,6,7,-1,-1,-1,0,0
eliminar,4,4,0,0,1,0,0
compartir,1,7,-6,-1,-1,0,0
bloqueándo,1,9,-8,-1,-1,-1,0
haber,2,6,-4,-1,-1,0,0
iniciar,5,9,4,1,1,0,0
aprovechar,7,6,1,1,-1,0,0
encontrar,1,3,-2,-1,-1,0,0
instalar,1,4,-3,-1,-1,0,0
incluyir,10,2,-8,-1,1,0,0
representar,4,6,-2,-1,-1,0,0
tener,3,3,0,0,-1,0,0
teniar,2,3,-1,-1,-1,0,0
devolver,2,7,-5,-1,-1,0,0
dar,2,2,0,0,1,0,0
publicar,3,11,-8,-1,-1,0,0
provocar,2,3,-1,-1,-1,0,0
dar,1,3,-2,-1,-1,0,0
hacer,6,6,0,0,-1,0,0
desvincular,5,12,-7,-1,-1,0,0
fusionar,3,5,-2,-1,-1,0,0
hacer,4,10,-6,-1,-1,0,0
tener,6,4,2,1,-1,0,0
haber,2,10,-8,-1,-1,0,0
encontrar,2,27,-25,-1,-1,0,0
tomar,1,4,-3,-1,-1,0,0
significar,1,6,-5,-1,-1,0,0
utilizar,6,2,4,1,-1,0,0
cancelar,4,10,-6,-1,-1,0,0
alcanzar,5,2,3,1,-1,0,0
incluir,15,3,-12,-1,1,0,0
llevar,2,2,0,0,1,0,0
transformar,2,4,-2,-1,-1,0,0
alcanzar,5,4,1,1,-1,0,0
referir,4,3,-1,-1,1,0,0
promocionar,6,20,-14,-1,-1,0,0
tener,5,5,0,0,-1,0,0
defender,12,2,-10,-1,1,0,0
desempeñar,12,4,-8,-1,1,0,0
ocupar,6,16,-10,-1,-1,0,0
distinguir,1,6,-5,-1,-1,-1,0
enterrar,2,6,4,1,1,0,0
tomar,3,8,-5,-1,-1,0,0
poseer,12,3,9,1,-1,-1,0
recibir,10,6,4,1,-1,0,0
pescar,10,3,-7,-1,1,0,0
fundar,4,3,1,1,-1,0,0
disminuyo,3,8,-5,-1,-1,0,0
formar,2,2,0,0,-1,0,0
transformar,3,4,-1,-1,-1,0,0
reforzar,2,3,-1,-1,-1,0,0
provocar,3,3,0,0,-1,0,0
nombrar,2,3,1,1,1,0,0
pedir,2,3,-1,-1,-1,1,0
hacer,4,2,2,1,-1,0,0
obtener,1,5,-4,-1,-1,0,0
comprometer,6,6,0,0,-1,-1,0
cursa,6,12,-6,-1,-1,0,0
comerciar,14,3,11,1,-1,0,0
dividir,13,6,7,1,-1,0,0
apoyar,2,7,-5,-1,-1,0,0
tener,14,3,-11,-1,1,0,0
conocido,6,8,-2,-1,-1,0,0
buscar,6,7,-1,-1,-1,0,0
confundir,3,5,-2,-1,-1,1,0
incluir,15,3,12,1,-1,0,0
situar,20,4,-16,-1,1,0,0
tener,6,2,-4,-1,1,0,0
adquirir,4,20,-16,-1,-1,0,0
tener,5,17,-12,-1,-1,0,0
encontrar,1,4,-3,-1,-1,-1,0
contratar,3,4,-1,-1,-1,0,0
tener,2,3,-1,-1,-1,0,0
convertir,2,3,-1,-1,-1,0,0
convertir,2,7,-5,-1,-1,0,0
terminar,3,9,-6,-1,-1,0,0
ser,3,3,0,0,-1,0,0
llevar,11,3,-8,-1,1,0,0
ornar,4,3,-1,-1,1,0,0
hacer,1,9,-8,-1,-1,0,0
permitir,4,5,-1,-1,-1,0,0
pasar,3,3,0,0,-1,0,0
visita,3,3,0,0,-1,0,0
gestionar,2,3,-1,-1,-1,0,0
dividir,2,23,-21,-1,-1,0,0
demostrar,5,5,0,0,-1,0,0
enfrentar,7,5,2,1,-1,0,0
hacer,5,15,-10,-1,-1,0,0
exhibir,2,12,-10,-1,-1,0,0
estudir,2,6,-4,-1,-1,0,0
catalogar,1,4,-3,-1,-1,-1,0
recibir,1,17,-16,-1,-1,0,0
tener,3,3,0,0,-1,0,0
sufrir,4,2,-2,-1,1,0,0
tener,1,2,-1,-1,-1,0,0
comenzar,2,6,-4,-1,-1,0,0
suponer,5,3,2,1,-1,0,0
bautizar,3,3,0,0,-1,0,0
distinguir,1,10,-9,-1,-1,-1,0
coincidir,5,4,1,1,-1,0,0
vender,3,5,-2,-1,-1,0,0
hacer,1,13,-12,-1,-1,0,0
perder,10,6,4,1,-1,-1,0
convertir,1,12,-11,-1,-1,-1,0
afectar,2,10,-8,-1,-1,0,0
decir,1,3,-2,-1,-1,-1,0
romper,7,2,-5,-1,1,0,0
formar,1,3,-2,-1,-1,0,0
atrapar,4,3,1,1,-1,0,0
desatar,3,9,-6,-1,-1,0,0
recordar,1,10,-9,-1,-1,0,0
acoger,20,3,-17,-1,1,0,0
sugerir,4,2,-2,-1,1,0,0
echar,1,6,-5,-1,-1,0,0
reducir,2,6,-4,-1,-1,0,0
pinta,15,3,-12,-1,1,0,0
tener,2,6,-4,-1,-1,0,0
hundir,2,8,-6,-1,-1,0,0
comenzar,3,6,-3,-1,-1,0,0
probar,1,6,-5,-1,-1,0,0
ganar,4,7,-3,-1,-1,0,0
lanzar,1,5,-4,-1,-1,0,0
fundar,6,2,4,1,-1,0,0
jugar,2,2,0,0,-1,1,0
jugar,2,5,-3,-1,-1,0,0
determinar,7,4,3,1,-1,0,0
hacer,2,4,-2,-1,-1,0,0
tener,4,14,-10,-1,-1,0,0
tener,1,12,-11,-1,-1,0,0
haber,4,5,-1,-1,-1,0,0
sacar,17,2,-15,-1,1,0,0
sacar,3,5,-2,-1,-1,0,0
hundir,2,42,-40,-1,-1,0,0
escoger,3,7,4,1,1,0,0
cursar,6,14,-8,-1,-1,0,0
poseer,19,2,-17,-1,1,-1,0
alcanzar,5,5,0,0,-1,0,0
confirmar,2,3,-1,-1,-1,0,0
jugar,3,3,0,0,-1,0,0
alcanzar,3,12,-9,-1,-1,0,0
esperar,3,3,0,0,-1,0,0
utilizar,2,6,-4,-1,-1,0,0
poner,11,3,-8,-1,1,0,0
significar,1,2,-1,-1,-1,0,0
significar,1,7,-6,-1,-1,0,0
hacer,2,3,-1,-1,-1,0,0
poner,2,4,-2,-1,-1,0,0
representar,2,4,-2,-1,-1,0,0
cerrar,10,13,-3,-1,-1,0,0
rescatar,2,4,2,1,1,0,0
dar,4,3,1,1,-1,0,0
limitar,5,13,-8,-1,-1,0,0
ver,2,3,-1,-1,-1,0,0
maximizar,8,15,-7,-1,-1,0,0
cavar,2,11,-9,-1,-1,0,0
forjar,1,3,-2,-1,-1,0,0
incluir,12,3,-9,-1,1,0,0
ampliar,2,18,-16,-1,-1,0,0
controlar,2,3,-1,-1,-1,0,0
dar,11,2,-9,-1,1,0,0
poner,10,2,-8,-1,1,0,0
ver,1,6,-5,-1,-1,-1,0
querer,9,7,2,1,-1,0,0
ver,1,3,-2,-1,-1,-1,0
mantener,4,4,0,0,-1,0,0
experimentar,2,15,-13,-1,-1,0,0
dar,2,2,0,0,-1,0,0
definir,5,3,-2,-1,1,0,0
capturar,4,5,-1,-1,-1,0,0
hacer,4,8,-4,-1,-1,0,0
encontrar,3,3,0,0,-1,0,0
permitir,11,10,1,1,-1,0,0
propulsar,2,6,-4,-1,-1,0,0
demostrar,3,4,-1,-1,-1,0,0
invocar,3,2,1,1,-1,0,0
forzar,2,14,-12,-1,-1,0,0
llevar,3,15,-12,-1,-1,0,0
trabajar,2,9,-7,-1,-1,0,0
hacer,1,6,-5,-1,-1,0,0
llevebar,6,2,-4,-1,1,0,0
salvar,2,6,-4,-1,-1,0,0
recibir,2,3,-1,-1,-1,0,0
repetir,4,5,-1,-1,-1,0,0
pagar,3,14,-11,-1,-1,0,0
pagar,3,4,-1,-1,-1,0,0
tener,2,7,-5,-1,-1,0,0
recibir,2,5,-3,-1,-1,0,0
estudiar,3,18,-15,-1,-1,0,0
interpretar,2,6,-4,-1,-1,0,0
sumar,10,33,-23,-1,-1,0,0
marcar,3,19,-16,-1,-1,0,0
obtener,2,10,-8,-1,-1,0,0
dividir,2,3,-1,-1,-1,0,0
decir,3,2,-1,-1,1,1,0
tener,2,11,-9,-1,-1,0,0
encontrar,9,6,-3,-1,1,0,0
puntuo,8,8,0,0,-1,0,0
ejercer,6,9,-3,-1,-1,0,0
usar,1,3,-2,-1,-1,-1,0
afrontar,21,2,-19,-1,1,0,0
introducir,2,7,-5,-1,-1,0,0
fundado,8,4,4,1,-1,0,0
clavar,2,5,-3,-1,-1,0,0
aprobar,28,2,-26,-1,1,0,0
presenciar,10,6,4,1,-1,0,0
cambiar,2,4,-2,-1,-1,0,0
realizar,2,28,-26,-1,-1,0,0
instalar,1,7,-6,-1,-1,-1,0
tomar,1,5,-4,-1,-1,0,0
recoger,4,12,-8,-1,-1,0,0
poner,13,2,-11,-1,1,0,0
realizar,3,4,-1,-1,-1,0,0
mantener,3,3,0,0,1,0,0
tocándo,2,3,-1,-1,-1,0,0
buscar,2,2,0,0,-1,0,0
haber,2,8,-6,-1,-1,0,0
hacer,6,3,3,1,-1,0,0
tener,3,5,-2,-1,-1,0,0
ganar,7,2,5,1,-1,0,0
enseñar,12,5,7,1,-1,0,0
disputar,2,3,-1,-1,-1,0,0
usar,2,3,-1,-1,-1,0,0
mejorar,4,3,-1,-1,1,1,0
mostrar,2,12,-10,-1,-1,0,0
hacer,3,3,0,0,-1,0,0
tener,6,2,-4,-1,1,0,0
haber,3,2,1,1,-1,0,0
tener,2,5,-3,-1,-1,0,0
firmo,2,2,0,0,1,0,0
calificar,24,13,11,1,-1,0,0
publico,2,3,-1,-1,-1,0,0
aumentar,2,2,0,0,-1,0,0
planificar,3,3,0,0,-1,0,0
tener,3,2,1,1,-1,0,0
hacer,2,16,-14,-1,-1,0,0
lograr,4,9,-5,-1,-1,0,0
curar,5,4,1,1,-1,0,0
invitar,3,22,-19,-1,-1,0,0
representar,17,4,13,1,-1,0,0
sumar,14,2,-12,-1,1,0,0
alberga,7,3,4,1,-1,0,0
hacer,2,2,0,0,-1,0,0
completar,2,17,-15,-1,-1,0,0
hablar,1,2,-1,-1,-1,0,0
lograr,2,3,-1,-1,-1,0,0
poner,5,2,-3,-1,1,0,0
instalar,12,7,-5,-1,1,-1,0
usar,1,4,-3,-1,-1,0,0
dejar,2,4,-2,-1,-1,0,0
recomendar,3,10,-7,-1,-1,0,0
hacer,1,3,-2,-1,-1,0,0
jugar,2,4,-2,-1,-1,0,0
hacer,3,3,0,0,1,0,0
comprobar,1,4,-3,-1,-1,-1,0
sacrificar,5,3,2,1,-1,0,0
alcanzar,4,2,-2,-1,1,0,0
iniciar,6,9,-3,-1,-1,0,0
efectuar,2,6,-4,-1,-1,0,0
construir,3,6,-3,-1,-1,0,0
importar,1,3,-2,-1,-1,0,0
fabricar,1,3,-2,-1,-1,-1,0
reemplazar,3,2,1,1,-1,0,0
pagar,4,6,-2,-1,-1,0,0
actualizar,2,2,0,0,-1,0,0
enterrar,1,11,-10,-1,-1,-1,0
recompensar,8,3,-5,-1,1,0,0
tener,1,3,-2,-1,-1,0,0
poner,8,2,-6,-1,1,0,0
iniciar,6,5,1,1,-1,0,0
devolver,1,8,-7,-1,-1,-1,0
convertido,5,13,-8,-1,-1,0,0
apuñalar,3,8,-5,-1,-1,0,0
tener,3,2,-1,-1,1,0,0
agarrar,2,3,-1,-1,-1,0,0
empezar,2,14,-12,-1,-1,0,0
llevar,6,6,0,0,-1,0,0
embarcar,2,3,-1,-1,-1,0,0
entrar,5,3,-2,-1,1,0,0
tener,4,3,1,1,-1,0,0
dándo,1,2,-1,-1,-1,0,0
sustituido,4,3,-1,-1,1,0,0
jugar,3,7,-4,-1,-1,0,0
alejar,4,16,-12,-1,-1,0,0
atravesar,2,6,-4,-1,-1,0,0
encomendar,8,4,4,1,-1,0,0
tener,2,7,-5,-1,-1,0,0
dejar,5,2,-3,-1,1,0,0
ocupar,4,2,2,1,-1,0,0
dejar,7,2,-5,-1,1,0,0
obtener,2,2,0,0,-1,0,0
formar,4,10,-6,-1,-1,0,0
hacer,1,2,-1,-1,-1,0,0
conquistar,1,2,-1,-1,-1,0,0
dar,2,7,-5,-1,-1,0,0
promeder,5,6,-1,-1,-1,0,0
organizar,6,2,4,1,-1,0,0
independizar,1,3,-2,-1,-1,-1,0
gobernar,2,3,-1,-1,-1,0,0
tomar,2,3,-1,-1,-1,0,0
tener,13,2,-11,-1,1,0,0
adaptar,1,10,-9,-1,-1,-1,0
sustituir,3,8,-5,-1,-1,0,0
terminado,2,2,0,0,-1,0,0
tener,2,2,0,0,-1,0,0
mirar,2,4,-2,-1,-1,0,0
expresar,18,2,-16,-1,1,0,0
aprovechar,5,4,1,1,-1,0,0
obtener,3,4,-1,-1,-1,0,0
expresar,2,8,-6,-1,-1,0,0
aumentar,6,4,2,1,-1,0,0
jugar,3,3,0,0,-1,0,0
llevar,5,6,-1,-1,-1,0,0
estafar,1,3,-2,-1,-1,-1,0
ampliar,2,15,-13,-1,-1,0,0
defender,4,3,1,1,-1,0,0
tener,5,11,-6,-1,-1,0,0
llevar,3,10,-7,-1,-1,0,0
separar,1,3,-2,-1,-1,-1,0
llevar,3,3,0,0,-1,0,0
asister,18,2,-16,-1,1,-1,0
recoger,2,3,-1,-1,-1,0,0
matar,4,3,1,1,-1,0,0
dejar,16,8,-8,-1,1,0,0
alcanzar,6,18,-12,-1,-1,0,0
participar,15,2,-13,-1,1,0,0
recordar,10,3,-7,-1,1,0,0
ayudar,4,4,0,0,-1,0,0
entregar,6,14,-8,-1,-1,0,0
compartir,1,16,-15,-1,-1,0,0
recorrer,1,3,-2,-1,-1,0,0
dejar,2,5,-3,-1,-1,0,0
realizar,2,5,-3,-1,-1,0,0
enseño,1,2,-1,-1,-1,0,0
tener,5,3,2,1,-1,0,0
disminuir,5,10,-5,-1,-1,0,0
brindar,5,17,-12,-1,-1,0,0
declarar,5,3,2,1,-1,0,0
alquilar,5,2,3,1,-1,0,0
tener,5,15,-10,-1,-1,0,0
tener,6,2,4,1,-1,0,0
agregándo,1,2,-1,-1,-1,-1,0
conseguir,3,4,-1,-1,-1,0,0
mantener,12,12,0,0,-1,0,0
elaborar,3,8,-5,-1,-1,0,0
enviar,3,26,-23,-1,-1,0,0
desarrollar,6,2,-4,-1,1,-1,0
tener,3,5,2,1,1,0,0
llevar,2,5,-3,-1,-1,0,0
encontrar,8,8,0,0,1,0,0
disolver,2,3,1,1,1,0,0
describir,2,34,-32,-1,-1,0,0
mezclar,6,12,-6,-1,-1,0,0
destinar,1,3,-2,-1,-1,-1,0
mover,6,3,-3,-1,1,0,0
abrir,7,4,3,1,-1,0,0
abrir,3,3,0,0,-1,0,0
dirigir,2,4,-2,-1,-1,0,0
preparar,6,6,0,0,-1,0,0
comunicar,11,15,-4,-1,-1,0,0
divida,3,3,0,0,-1,0,0
poner,24,2,-22,-1,1,0,0
concertar,1,3,-2,-1,-1,0,0
terminar,2,6,-4,-1,-1,0,0
utilizar,2,6,-4,-1,-1,0,0
utilizar,1,3,-2,-1,-1,-1,0
emplear,4,3,1,1,-1,0,0
abordar,20,7,-13,-1,1,0,0
llevar,4,3,1,1,-1,0,0
llevar,2,2,0,0,-1,1,0
tener,2,20,-18,-1,-1,0,0
pintar,6,3,3,1,-1,0,0
tener,2,2,0,0,1,0,0
superar,3,3,0,0,-1,0,0
emplear,10,3,-7,-1,1,0,0
dar,2,2,0,0,1,0,0
descubrir,5,2,-3,-1,1,0,0
ser,8,2,6,1,-1,0,0
nombrado,2,2,0,0,-1,0,0
tener,2,2,0,0,-1,0,0
presenciar,4,3,-1,-1,1,0,0
conseguir,2,3,1,1,1,0,0
tomar,6,5,1,1,-1,0,0
atraer,7,3,4,1,-1,0,0
cortar,2,2,0,0,-1,0,0
comparte,1,16,-15,-1,-1,0,0
compartir,1,5,-4,-1,-1,0,0
producir,1,6,-5,-1,-1,0,0
dar,1,3,-2,-1,-1,0,0
seguir,3,16,-13,-1,-1,0,0
encontrar,1,3,-2,-1,-1,0,0
llevar,4,5,-1,-1,-1,0,0
desarrollar,6,6,0,0,-1,0,0
poner,28,2,-26,-1,1,0,0
transformar,3,21,-18,-1,-1,0,0
abrir,4,9,-5,-1,-1,0,0
comprobar,14,5,9,1,-1,0,0
controlar,2,3,1,1,1,0,0
firmar,4,15,-11,-1,-1,0,0
adoptar,6,5,1,1,-1,0,0
comandar,3,7,-4,-1,-1,0,0
conseguir,4,18,14,1,1,0,0
incrementar,8,4,-4,-1,1,0,0
romper,4,21,-17,-1,-1,0,0
tener,12,2,-10,-1,1,0,0
ganar,3,10,-7,-1,-1,0,0
padecer,6,6,0,0,-1,0,0
poner,3,3,0,0,1,0,0
tener,13,3,-10,-1,1,0,0
captar,2,3,-1,-1,-1,0,0
tener,4,4,0,0,-1,0,0
ejerciar,2,3,-1,-1,-1,0,0
pasar,2,5,-3,-1,-1,0,0
llevar,2,2,0,0,1,0,0
limitar,4,3,1,1,-1,0,0
convirtio,9,6,3,1,-1,0,0
fusionar,2,7,-5,-1,-1,0,0
elaborar,2,2,0,0,-1,0,0
poner,1,4,-3,-1,-1,0,0
crear,4,3,1,1,-1,0,0
contar,18,8,10,1,-1,0,0
animar,5,27,-22,-1,-1,0,0
trasladar,2,29,-27,-1,-1,0,0
grabar,1,7,-6,-1,-1,0,0
saqué,2,3,-1,-1,-1,0,0
situar,2,18,-16,-1,-1,0,0
compartir,1,5,-4,-1,-1,0,0
recibir,2,5,-3,-1,-1,0,0
obtener,3,7,-4,-1,-1,0,0
causar,2,3,-1,-1,-1,0,0
elegido,6,3,-3,-1,1,0,0
constituir,3,7,-4,-1,-1,0,0
supervisar,10,7,-3,-1,1,0,0
seguir,3,5,-2,-1,-1,0,0
combinar,1,4,-3,-1,-1,0,0
ver,11,2,-9,-1,1,-1,0
interpretar,6,17,-11,-1,-1,0,0
dudar,1,4,-3,-1,-1,-1,0
representar,4,2,-2,-1,1,0,0
denominar,7,13,-6,-1,-1,0,0
llevar,3,3,0,0,-1,0,0
usar,16,3,13,1,-1,0,0
tener,4,10,-6,-1,-1,0,0
haber,3,3,0,0,-1,0,0
ver,2,6,-4,-1,-1,0,0
abandonar,3,2,-1,-1,1,0,0
encontrar,20,11,9,1,-1,0,0
continú,3,3,0,0,-1,0,0
dificultar,2,3,1,1,1,0,0
alcanzar,7,4,3,1,-1,0,0
obtener,1,3,-2,-1,-1,0,0
recibir,2,9,-7,-1,-1,0,0
aprobar,8,2,-6,-1,1,0,0
casar,6,11,-5,-1,-1,0,0
haber,3,3,0,0,-1,0,0
surtir,15,2,-13,-1,1,0,0
compartir,4,2,-2,-1,1,-1,0
dejar,3,12,-9,-1,-1,0,0
poseer,3,7,-4,-1,-1,1,0
apartar,4,8,-4,-1,-1,0,0
presento,15,6,9,1,-1,0,0
prohibir,2,3,-1,-1,-1,0,0
agregándo,1,14,-13,-1,-1,-1,0
hacer,2,2,0,0,-1,0,0
utilizar,2,3,1,1,1,0,0
suscitar,8,3,-5,-1,1,0,0
tener,3,14,-11,-1,-1,0,0
excluir,2,3,-1,-1,-1,0,0
añadir,4,2,2,1,-1,0,0
buscar,2,4,-2,-1,-1,0,0
controlar,3,3,0,0,1,0,0
ayudar,1,3,-2,-1,-1,-1,0
reconocer,4,2,-2,-1,1,0,0
colocar,11,6,-5,-1,1,0,0
blanquear,2,3,-1,-1,-1,0,0
tomar,4,2,-2,-1,1,0,0
tomar,8,3,-5,-1,1,0,0
seguir,2,4,-2,-1,-1,0,0
tener,5,17,-12,-1,-1,0,0
simbolizar,8,2,-6,-1,1,0,0
publicar,13,2,-11,-1,1,0,0
hacia,1,7,-6,-1,-1,0,0
romper,2,2,0,0,-1,0,0
circular,4,3,1,1,-1,0,0
representar,2,7,-5,-1,-1,0,0
utilizar,1,2,-1,-1,-1,0,0
tener,1,10,-9,-1,-1,0,0
escribir,2,4,2,1,1,0,0
hacer,1,3,-2,-1,-1,0,0
hacer,5,3,-2,-1,1,0,0
evitar,2,6,-4,-1,-1,0,0
echar,2,3,-1,-1,-1,0,0
interpretar,3,8,-5,-1,-1,0,0
tener,1,7,-6,-1,-1,0,0
conseguir,2,3,-1,-1,-1,0,0
completo,2,12,-10,-1,-1,0,0
perder,4,2,2,1,-1,0,0
enviar,3,3,0,0,-1,0,0
vivido,1,3,-2,-1,-1,0,0
monitoreer,7,3,4,1,-1,0,0
realizar,6,15,-9,-1,-1,0,0
marcar,2,7,-5,-1,-1,0,0
sumir,5,5,0,0,-1,0,0
dar,2,6,-4,-1,-1,0,0
retomar,6,12,-6,-1,-1,0,0
tener,1,8,-7,-1,-1,0,0
promover,14,19,-5,-1,-1,0,0
dar,1,32,-31,-1,-1,0,0
denunciar,7,10,-3,-1,-1,0,0
destruir,3,3,0,0,-1,0,0
afrontar,3,4,-1,-1,-1,0,0
realizar,1,6,-5,-1,-1,0,0
aplazar,2,2,0,0,-1,0,0
solucionar,2,3,-1,-1,-1,0,0
hacer,2,5,-3,-1,-1,-1,0
encontrar,14,6,-8,-1,1,0,0
organizar,3,9,-6,-1,-1,0,0
conseguir,6,11,-5,-1,-1,0,0
recortar,1,7,-6,-1,-1,1,0
incorporar,5,9,-4,-1,-1,0,0
gestionar,2,5,3,1,1,0,0
transportar,2,5,-3,-1,-1,0,0
utilizar,3,3,0,0,-1,-1,0
agrupar,5,6,-1,-1,-1,0,0
comenzar,3,2,1,1,-1,0,0
dar,1,6,-5,-1,-1,0,0
dar,6,2,-4,-1,1,0,0
convertir,4,19,-15,-1,-1,1,0
hacer,1,10,-9,-1,-1,0,0
persiguir,3,15,-12,-1,-1,0,0
estudir,1,5,-4,-1,-1,0,0
colocar,1,16,-15,-1,-1,-1,0
seguir,5,2,-3,-1,1,0,0
formar,2,5,-3,-1,-1,0,0
desatar,6,3,3,1,-1,0,0
abrumado,9,13,4,1,1,0,0
eliminar,8,4,4,1,-1,0,0
encomendar,8,4,4,1,-1,0,0
terminar,2,4,-2,-1,-1,0,0
hacer,3,3,0,0,-1,0,0
contradecir,3,3,0,0,-1,0,0
encontrar,7,5,2,1,-1,0,0
sepultar,17,2,-15,-1,1,0,0
enseñar,2,4,-2,-1,-1,0,0
generar,4,4,0,0,-1,0,0
tener,1,8,-7,-1,-1,0,0
obtener,3,4,-1,-1,-1,0,0
registrar,4,4,0,0,-1,0,0
agregar,2,7,-5,-1,-1,0,0
lograr,7,6,1,1,-1,0,0
utilizar,3,6,-3,-1,-1,0,0
lanzar,7,3,-4,-1,1,0,0
adquirir,12,3,-9,-1,1,0,0
estimándo,6,15,-9,-1,-1,0,0
constituir,4,3,1,1,-1,0,0
recitar,7,7,0,0,-1,0,0
dar,1,5,-4,-1,-1,0,0
solicitar,2,7,-5,-1,-1,0,0
tener,2,14,-12,-1,-1,0,0
incluir,18,3,15,1,-1,0,0
buscar,6,4,2,1,-1,0,0
suspendir,2,3,-1,-1,-1,0,0
llenéis,1,25,-24,-1,-1,0,0
estudio,1,11,-10,-1,-1,0,0
apreciar,2,8,-6,-1,-1,0,0
extraer,10,2,-8,-1,1,-1,0
reparar,3,16,-13,-1,-1,0,0
llevar,3,4,-1,-1,-1,0,0
comprar,1,4,-3,-1,-1,0,0
presentar,8,3,-5,-1,1,0,0
dar,4,2,-2,-1,1,0,0
correr,2,3,-1,-1,-1,0,0
ver,3,12,-9,-1,-1,0,0
conservar,2,3,-1,-1,-1,0,0
tener,8,3,-5,-1,1,0,0
tener,2,6,-4,-1,-1,0,0
comandar,4,2,2,1,-1,0,0
empezar,24,2,-22,-1,1,0,0
tener,2,2,0,0,-1,0,0
dar,3,14,11,1,1,0,0
proveyér,1,6,-5,-1,-1,-1,0
derrivar,11,4,-7,-1,1,0,0
denunciar,6,3,-3,-1,1,0,0
alcanzar,2,4,-2,-1,-1,0,0
crear,2,5,-3,-1,-1,0,0
codificar,3,3,0,0,-1,0,0
hacer,4,8,-4,-1,-1,0,0
dar,1,6,-5,-1,-1,0,0
incluir,9,3,-6,-1,1,0,0
ganar,5,6,-1,-1,-1,0,0
perder,5,4,1,1,-1,0,0
tener,2,2,0,0,-1,0,0
prestar,2,4,-2,-1,-1,0,0
poner,18,2,-16,-1,1,0,0
buscar,5,3,2,1,-1,0,0
ver,2,12,-10,-1,-1,0,0
estudir,1,2,-1,-1,-1,0,0
tener,32,5,27,1,-1,0,0
usar,3,2,1,1,-1,0,0
acoger,4,29,-25,-1,-1,0,0
celebrar,12,14,-2,-1,-1,0,0
volver,2,3,-1,-1,-1,0,0
querer,4,3,1,1,-1,0,0
dar,2,4,-2,-1,-1,0,0
mantener,3,2,1,1,-1,0,0
elaborar,4,14,-10,-1,-1,0,0
acompañar,2,2,0,0,-1,0,0
ostentar,4,9,-5,-1,-1,0,0
ahorrar,1,4,-3,-1,-1,0,0
limitar,4,3,1,1,-1,0,0
privar,3,3,0,0,-1,0,0
capturar,7,4,3,1,-1,0,0
convertir,9,31,-22,-1,-1,1,0
recibir,31,3,-28,-1,1,0,0
abundan,15,2,13,1,-1,1,0
recorrer,3,3,0,0,-1,0,0
revalidar,2,4,-2,-1,-1,0,0
escribir,2,4,-2,-1,-1,0,0
iniciar,2,2,0,0,-1,0,0
dedicar,3,7,-4,-1,-1,0,0
haber,4,14,-10,-1,-1,0,0
tomar,1,3,-2,-1,-1,0,0
recibir,3,8,-5,-1,-1,0,0
recuperar,1,5,-4,-1,-1,-1,0
ser,2,8,6,1,1,0,0
sufrir,5,27,-22,-1,-1,0,0
celebrado,8,8,0,0,-1,0,0
derivar,3,3,0,0,-1,0,0
usar,2,3,-1,-1,-1,0,0
lanzar,2,3,-1,-1,-1,0,0
recibir,4,15,-11,-1,-1,0,0
controlar,2,20,-18,-1,-1,0,0
enviar,2,8,-6,-1,-1,0,0
ofrecer,4,5,-1,-1,-1,0,0
permitir,3,4,-1,-1,-1,0,0
marcar,3,7,-4,-1,-1,0,0
provocar,7,5,2,1,-1,0,0
albergar,9,2,7,1,-1,1,0
poner,1,8,-7,-1,-1,0,0
informar,4,4,0,0,-1,1,0
ganar,11,4,-7,-1,1,0,0
haber,1,3,-2,-1,-1,-1,0
hacer,1,3,-2,-1,-1,0,0
enlazar,6,5,1,1,-1,0,0
confundir,3,3,0,0,-1,0,0
aprobar,6,38,-32,-1,-1,0,0
tener,2,32,-30,-1,-1,0,0
tener,3,4,-1,-1,-1,0,0
tener,3,2,-1,-1,1,0,0
orientar,2,3,-1,-1,-1,0,0
ascender,2,2,0,0,1,0,0
encontrar,2,11,-9,-1,-1,0,0
robar,2,5,-3,-1,-1,0,0
iniciar,5,2,3,1,-1,0,0
compaginar,2,3,-1,-1,-1,0,0
ver,1,10,-9,-1,-1,-1,0
devolver,2,3,-1,-1,-1,0,0
impactar,8,12,-4,-1,-1,0,0
llevar,2,5,-3,-1,-1,0,0
dejar,2,3,-1,-1,-1,0,0
ver,11,4,-7,-1,1,0,0
enfrentar,1,3,-2,-1,-1,0,0
comenzar,6,10,-4,-1,-1,0,0
alcanzar,2,3,-1,-1,-1,0,0
cerrar,3,6,-3,-1,-1,0,0
poner,2,2,0,0,-1,0,0
tener,5,10,-5,-1,-1,0,0
tener,3,4,-1,-1,-1,0,0
rechazar,1,3,-2,-1,-1,-1,0
tener,2,3,-1,-1,-1,0,0
inclinar,2,3,-1,-1,-1,0,0
llevar,3,14,-11,-1,-1,0,0
pasar,2,10,-8,-1,-1,0,0
reconocer,3,9,-6,-1,-1,0,0
trasladar,4,3,1,1,-1,0,0
sentir,2,3,-1,-1,-1,0,0
pronunciar,2,7,-5,-1,-1,0,0
ejercer,3,32,-29,-1,-1,0,0
publicar,2,2,0,0,-1,0,0
rivalizavar,3,4,1,1,1,0,0
tener,16,8,-8,-1,1,0,0
representar,2,6,-4,-1,-1,0,0
coronar,2,8,-6,-1,-1,0,0
promediar,2,8,-6,-1,-1,0,0
florecer,6,6,0,0,1,0,0
llevar,8,36,-28,-1,-1,0,0
pesidir,8,4,4,1,-1,0,0
servir,1,5,-4,-1,-1,-1,0
mantener,10,2,8,1,-1,0,0
enfrentar,3,4,-1,-1,-1,0,0
obtener,6,7,-1,-1,-1,0,0
ocupar,6,9,-3,-1,-1,0,0
haciér,1,11,-10,-1,-1,-1,0
violar,16,3,-13,-1,1,0,0
tener,2,3,-1,-1,-1,0,0
abrir,1,15,-14,-1,-1,0,0
venerar,2,6,-4,-1,-1,0,0
despreciar,4,3,1,1,-1,0,0
ejecutado,3,6,-3,-1,-1,0,0
llevar,1,2,1,1,1,0,0
registrar,18,2,-16,-1,1,0,0
repetir,5,6,-1,-1,-1,0,0
recibiér,1,3,-2,-1,-1,-1,0
apoyar,3,7,-4,-1,-1,0,0
emitir,11,32,-21,-1,-1,0,0
interpretar,3,4,-1,-1,-1,0,0
comenzar,2,4,-2,-1,-1,0,0
organizar,3,17,-14,-1,-1,0,0
renuevo,5,15,-10,-1,-1,0,0
lanzar,3,4,-1,-1,-1,0,0
tener,5,3,2,1,-1,0,0
perder,2,10,-8,-1,-1,0,0
dejar,2,8,-6,-1,-1,0,0
impacta,19,2,-17,-1,1,0,0
compartir,1,9,-8,-1,-1,0,0
formar,2,7,-5,-1,-1,0,0
reparar,4,4,0,0,-1,0,0
reclutado,2,5,-3,-1,-1,0,0
conseguir,5,2,-3,-1,1,0,0
requerir,2,9,-7,-1,-1,0,0
poseer,6,5,1,1,-1,0,0
lográr,1,21,-20,-1,-1,-1,0
recomendar,2,3,-1,-1,-1,0,0
existir,3,10,-7,-1,-1,0,0
transformar,2,5,-3,-1,-1,0,0
hacer,3,5,-2,-1,-1,0,0
dejar,4,3,1,1,-1,0,0
ganar,1,15,-14,-1,-1,0,0
construir,2,10,-8,-1,-1,0,0
describir,3,3,0,0,-1,0,0
cursar,11,4,7,1,-1,0,0
tener,3,5,-2,-1,-1,0,0
tener,3,7,-4,-1,-1,0,0
expresar,8,3,-5,-1,1,0,0
sufrir,9,3,-6,-1,1,0,0
tener,3,2,-1,-1,1,0,0
arrojar,5,3,-2,-1,1,0,0
meter,4,2,-2,-1,1,0,0
causar,2,3,-1,-1,-1,0,0
reclutar,1,3,-2,-1,-1,-1,0
tener,2,4,-2,-1,-1,0,0
hacer,3,3,0,0,-1,0,0
tener,8,2,-6,-1,1,0,0
reemplazar,1,5,-4,-1,-1,-1,0
compartir,5,2,-3,-1,1,-1,0
coordinar,2,6,-4,-1,-1,0,0
proporcionar,2,2,0,0,1,0,0
conseguir,1,6,-5,-1,-1,0,0
reducir,22,6,-16,-1,1,0,0
hacer,2,39,-37,-1,-1,0,0
proclamar,2,3,-1,-1,-1,0,0
considerar,3,4,-1,-1,-1,0,0
visitar,5,2,3,1,-1,0,0
colocar,4,3,1,1,-1,0,0
traer,4,7,-3,-1,-1,0,0
aprobar,30,2,-28,-1,1,0,0
obtener,7,4,3,1,-1,0,0
separar,2,3,-1,-1,-1,0,0
comenzar,23,3,-20,-1,1,0,0
hacer,7,4,-3,-1,1,0,0
admitir,5,3,2,1,-1,0,0
resister,4,7,-3,-1,-1,0,0
tener,6,3,-3,-1,1,0,0
estropeo,3,5,-2,-1,-1,0,0
adaptándo,1,7,-6,-1,-1,-1,0
hacer,1,3,-2,-1,-1,0,0
provocar,1,22,-21,-1,-1,0,0
liderar,5,10,-5,-1,-1,0,0
describir,6,3,-3,-1,1,0,0
transportar,3,3,0,0,-1,0,0
haber,3,3,0,0,-1,0,0
dar,16,2,-14,-1,1,0,0
compusar,2,15,-13,-1,-1,0,0
modificar,22,22,0,0,-1,1,0
destruir,2,3,-1,-1,-1,0,0
ver,19,7,-12,-1,1,0,0
vender,5,5,0,0,1,0,0
echar,1,3,-2,-1,-1,-1,0
lanzar,4,17,-13,-1,-1,0,0
descargar,15,12,3,1,-1,0,0
dejar,4,4,0,0,-1,0,0
ser,27,3,-24,-1,1,0,0
firmar,2,3,-1,-1,-1,0,0
organizar,7,4,3,1,-1,0,0
montar,16,3,-13,-1,1,1,0
enfrentar,1,5,-4,-1,-1,0,0
poseer,7,5,2,1,-1,0,0
sofocado,2,16,-14,-1,-1,0,0
fabricaban,1,7,-6,-1,-1,0,0
honrar,4,15,-11,-1,-1,0,0
ejercer,2,6,-4,-1,-1,0,0
interpretar,3,3,0,0,-1,0,0
disputado,1,10,-9,-1,-1,0,0
asegurar,3,5,-2,-1,-1,0,0
firmar,8,40,-32,-1,-1,0,0
asistir,3,7,-4,-1,-1,0,0
tener,5,10,-5,-1,-1,0,0
intercambir,2,5,-3,-1,-1,0,0
estudir,1,7,-6,-1,-1,0,0
idear,3,3,0,0,1,0,0
recibir,2,4,-2,-1,-1,0,0
representar,6,5,1,1,-1,0,0
haber,2,3,-1,-1,-1,0,0
unir,4,8,-4,-1,-1,0,0
seguir,2,4,-2,-1,-1,0,0
obtener,7,6,1,1,-1,0,0
crear,3,7,-4,-1,-1,0,0
traspasar,17,4,-13,-1,1,0,0
tener,1,6,-5,-1,-1,0,0
recibir,2,3,-1,-1,-1,0,0
superar,3,3,0,0,-1,0,0
inhibir,4,3,1,1,-1,0,0
entablar,1,4,-3,-1,-1,0,0
añadir,6,27,-21,-1,-1,0,0
tardar,2,9,-7,-1,-1,0,0
realizado,3,7,-4,-1,-1,0,0
poner,6,6,0,0,-1,0,0
inyectar,9,3,-6,-1,1,0,0
hacer,2,3,-1,-1,-1,0,0
improvisar,2,3,-1,-1,-1,0,0
estudiar,2,8,-6,-1,-1,0,0
crear,7,3,-4,-1,1,0,0
reducir,15,3,-12,-1,1,0,0
perder,2,7,-5,-1,-1,0,0
acompañar,2,2,0,0,-1,0,0
presentar,2,6,-4,-1,-1,0,0
mostrar,2,3,-1,-1,-1,0,0
publicar,7,2,-5,-1,1,0,0
poner,1,5,-4,-1,-1,0,0
sacar,1,3,-2,-1,-1,-1,0
hacer,2,2,0,0,-1,0,0
compara,3,3,0,0,-1,0,0
tener,1,7,-6,-1,-1,0,0
desarrollar,3,19,-16,-1,-1,0,0
conformar,3,7,-4,-1,-1,0,0
poner,2,2,0,0,1,0,0
protagonizar,1,3,-2,-1,-1,0,0
mantener,2,5,-3,-1,-1,0,0
usar,2,2,0,0,-1,0,0
hacer,4,6,2,1,1,0,0
defender,10,10,0,0,1,0,0
firmar,7,20,-13,-1,-1,1,0
desbordar,6,2,-4,-1,1,0,0
haber,7,7,0,0,-1,0,0
administrar,2,6,-4,-1,-1,0,0
lanzar,12,11,1,1,-1,0,0
trasladado,9,2,-7,-1,1,0,0
recibir,2,5,-3,-1,-1,0,0
trasladar,7,6,1,1,-1,0,0
combinar,5,7,-2,-1,-1,0,0
tener,21,4,-17,-1,1,0,0
dar,5,3,2,1,-1,0,0
utilizar,2,3,-1,-1,-1,0,0
necesitar,1,5,-4,-1,-1,0,0
designar,2,4,-2,-1,-1,0,0
designar,8,4,4,1,-1,0,0
fundar,6,3,-3,-1,1,0,0
mostrar,4,4,0,0,-1,0,0
haber,3,4,-1,-1,-1,0,0
compartir,4,9,-5,-1,-1,0,0
ver,2,6,-4,-1,-1,0,0
hacer,1,3,-2,-1,-1,0,0
encontrar,3,9,-6,-1,-1,0,0
adquirir,2,2,0,0,-1,0,0
poner,2,2,0,0,1,0,0
describir,1,7,-6,-1,-1,0,0
destituir,1,2,-1,-1,-1,-1,0
realizar,2,4,-2,-1,-1,0,0
finalizar,2,15,-13,-1,-1,0,0
establecer,10,5,-5,-1,1,0,0
declarar,15,4,-11,-1,1,0,0
imponer,2,14,-12,-1,-1,0,0
construir,5,12,-7,-1,-1,0,0
tener,9,4,5,1,-1,0,0
saludar,1,3,-2,-1,-1,-1,0
aplazar,2,2,0,0,-1,0,0
consultar,1,2,1,1,1,0,0
desarrollar,3,6,-3,-1,-1,0,0
jurar,2,4,-2,-1,-1,0,0
tener,2,10,-8,-1,-1,0,0
incluir,2,26,-24,-1,-1,0,0
atraer,10,2,-8,-1,1,0,0
lanzar,4,4,0,0,1,0,0
estudir,6,7,-1,-1,-1,0,0
resuelven,3,3,0,0,-1,0,0
mantener,7,4,3,1,-1,0,0
de,4,7,-3,-1,-1,0,0
unir,3,3,0,0,-1,0,0
recibir,2,4,-2,-1,-1,0,0
guardar,16,6,-10,-1,1,0,0
sufrir,2,5,-3,-1,-1,0,0
establecer,9,3,-6,-1,1,0,0
persiguer,3,2,-1,-1,1,0,0
reflejado,2,3,-1,-1,-1,0,0
traer,4,2,-2,-1,1,0,0
tener,1,4,-3,-1,-1,0,0
reanudar,24,8,16,1,-1,0,0
mantener,6,3,3,1,-1,0,0
interactuar,2,5,-3,-1,-1,0,0
traer,5,7,-2,-1,-1,0,0
generar,5,19,-14,-1,-1,0,0
eliminar,4,7,-3,-1,-1,0,0
seguir,5,11,-6,-1,-1,0,0
recibir,3,21,-18,-1,-1,0,0
tener,2,2,0,0,-1,0,0
mantener,5,4,1,1,-1,0,0
dejar,3,2,1,1,-1,0,0
ganar,2,2,0,0,-1,0,0
enfrentar,3,3,0,0,-1,0,0
tener,5,3,-2,-1,1,0,0
completar,9,2,7,1,-1,0,0
hacer,3,6,-3,-1,-1,0,0
convertir,15,4,11,1,-1,0,0
ganar,2,6,-4,-1,-1,0,0
plantar,7,3,4,1,-1,0,0
recibir,3,3,0,0,-1,0,0
tener,4,8,-4,-1,-1,0,0
detener,9,29,-20,-1,-1,0,0
titulado,3,11,-8,-1,-1,0,0
tener,1,4,-3,-1,-1,0,0
promocionar,3,4,-1,-1,-1,0,0
denunciar,10,11,1,1,1,0,0
dejar,2,3,-1,-1,-1,0,0
conocer,5,2,-3,-1,1,0,0
tener,2,3,-1,-1,-1,0,0
conseguir,3,2,1,1,-1,0,0
rotar,2,2,0,0,-1,0,0
transmitir,8,4,4,1,-1,0,0
tener,2,7,-5,-1,-1,0,0
devaluar,2,4,-2,-1,-1,0,0
cosechar,2,2,0,0,-1,0,0
disparar,1,2,-1,-1,-1,0,0
reúne,5,4,-1,-1,1,0,0
inscribir,2,3,1,1,1,0,0
incluir,3,4,-1,-1,-1,0,0
encontrar,12,2,-10,-1,1,0,0
destacar,22,4,-18,-1,1,0,0
introducir,7,9,-2,-1,-1,0,0
fundar,2,2,0,0,-1,0,0
garantizar,9,3,-6,-1,1,0,0
alcanzar,5,6,-1,-1,-1,0,0
permitir,3,6,-3,-1,-1,0,0
mejorar,5,2,3,1,-1,0,0
declarar,5,2,3,1,-1,0,0
tener,2,4,-2,-1,-1,0,0
formar,7,5,2,1,-1,0,0
inducir,2,7,-5,-1,-1,0,0
invertir,3,3,0,0,-1,0,0
limitar,2,7,-5,-1,-1,0,0
recibir,2,16,-14,-1,-1,0,0
establecer,7,4,-3,-1,1,0,0
poner,14,2,-12,-1,1,0,0
operar,17,2,-15,-1,1,-1,0
tener,3,6,-3,-1,-1,0,0
iluminar,2,6,-4,-1,-1,0,0
haber,8,3,-5,-1,1,0,0
convertir,2,4,-2,-1,-1,0,0
pagar,5,4,-1,-1,1,0,0
aplicar,3,7,-4,-1,-1,0,0
conseguir,3,9,-6,-1,-1,0,0
abrir,1,3,-2,-1,-1,0,0
iniciar,3,9,-6,-1,-1,0,0
dividir,3,25,-22,-1,-1,0,0
tener,2,4,-2,-1,-1,0,0
utilizar,2,6,-4,-1,-1,0,0
llevar,4,3,-1,-1,1,0,0
afectar,7,13,-6,-1,-1,0,0
marca,2,5,-3,-1,-1,0,0
pedir,1,6,-5,-1,-1,0,0
dejar,3,3,0,0,-1,0,0
obtener,3,26,-23,-1,-1,0,0
volver,2,6,-4,-1,-1,0,0
ver,1,2,-1,-1,-1,0,0
alcanzar,2,4,-2,-1,-1,0,0
distribuir,2,8,-6,-1,-1,0,0
proporcionar,4,4,0,0,-1,0,0
lograr,11,3,-8,-1,1,0,0
apoyar,4,3,1,1,-1,0,0
mandar,3,2,1,1,-1,1,0
tener,12,2,-10,-1,1,0,0
considerar,7,8,-1,-1,-1,0,0
derrocar,5,3,-2,-1,1,0,0
tener,3,3,0,0,-1,0,0
ganar,1,7,-6,-1,-1,0,0
comenzar,2,8,-6,-1,-1,0,0
obligar,2,26,-24,-1,-1,0,0
mostrar,2,45,-43,-1,-1,0,0
reducir,4,14,-10,-1,-1,0,0
hacer,1,36,-35,-1,-1,0,0
llenar,2,7,-5,-1,-1,0,0
perder,2,6,-4,-1,-1,0,0
transportar,2,12,-10,-1,-1,0,0
hacer,2,5,-3,-1,-1,0,0
tomar,2,3,-1,-1,-1,0,0
unir,1,2,-1,-1,-1,0,0
convertir,2,2,0,0,-1,0,0
convocar,6,7,-1,-1,-1,0,0
rescatar,8,20,-12,-1,-1,0,0
reemplazar,3,11,-8,-1,-1,0,0
generar,5,3,2,1,-1,0,0
dejar,8,7,-1,-1,1,0,0
guio,6,8,-2,-1,-1,0,0
bloquear,2,3,-1,-1,-1,0,0
atajar,7,5,2,1,-1,0,0
unir,4,25,-21,-1,-1,0,0
haber,3,5,-2,-1,-1,0,0
dejar,2,3,-1,-1,-1,0,0
lavar,2,9,-7,-1,-1,0,0
ocupar,9,10,-1,-1,-1,0,0
informar,2,4,-2,-1,-1,0,0
divulgar,5,3,2,1,-1,0,0
haber,5,2,3,1,-1,0,0
poner,8,5,-3,-1,1,0,0
investigar,3,5,-2,-1,-1,0,0
cerrar,2,6,-4,-1,-1,0,0
aprender,4,3,-1,-1,1,0,0
pagar,2,8,-6,-1,-1,0,0
estudiar,1,8,-7,-1,-1,0,0
lanzar,7,3,-4,-1,1,0,0
atacar,10,4,6,1,-1,0,0
poner,17,6,-11,-1,1,-1,0
determinar,2,4,-2,-1,-1,0,0
suponer,8,12,-4,-1,-1,0,0
servir,3,2,-1,-1,1,0,0
haber,1,7,-6,-1,-1,0,0
manejar,21,5,16,1,-1,0,0
dividir,2,3,-1,-1,-1,0,0
llevar,3,5,-2,-1,-1,0,0
encontrar,12,3,-9,-1,1,0,0
defender,5,4,1,1,-1,0,0
cursar,2,5,-3,-1,-1,0,0
ayudar,3,4,1,1,1,0,0
hacer,1,3,-2,-1,-1,0,0
sentir,2,6,-4,-1,-1,1,0
estudir,1,6,-5,-1,-1,0,0
poner,2,3,-1,-1,-1,0,0
realizar,3,5,-2,-1,-1,0,0
tener,13,3,-10,-1,1,0,0
incluir,2,5,-3,-1,-1,0,0
conservar,1,2,-1,-1,-1,-1,0
suponer,2,4,-2,-1,-1,0,0
jalar,2,2,0,0,-1,0,0
cumplir,3,3,0,0,-1,0,0
utilizar,3,3,0,0,-1,0,0
acompañar,2,3,-1,-1,-1,0,0
disputar,4,3,-1,-1,1,0,0
lanzar,1,4,-3,-1,-1,0,0
tener,5,3,2,1,-1,0,0
mover,4,5,-1,-1,-1,0,0
reproducir,11,4,7,1,-1,0,0
asumir,2,2,0,0,-1,0,0
mantener,2,6,-4,-1,-1,0,0
asociar,6,5,1,1,-1,0,0
llevar,1,2,-1,-1,-1,-1,0
tener,1,3,-2,-1,-1,0,0
ganar,9,2,-7,-1,1,0,0
terminar,1,2,-1,-1,-1,0,0
recibir,4,6,-2,-1,-1,0,0
adquirir,11,3,-8,-1,1,0,0
sustituir,18,4,14,1,-1,0,0
realizar,4,6,-2,-1,-1,0,0
tener,9,22,-13,-1,-1,0,0
asignar,13,4,9,1,-1,0,0
vender,4,3,1,1,-1,0,0
ganado,2,13,-11,-1,-1,0,0
finalizar,4,2,2,1,-1,0,0
hacer,1,2,-1,-1,-1,0,0
sufrir,11,16,-5,-1,-1,0,0
aprender,2,15,-13,-1,-1,0,0
dejar,3,3,0,0,1,0,0
activar,3,4,-1,-1,-1,0,0
acercar,3,3,0,0,-1,0,0
dar,2,4,-2,-1,-1,0,0
buscar,4,13,-9,-1,-1,0,0
echar,2,5,-3,-1,-1,0,0
devolver,2,4,-2,-1,-1,0,0
querer,4,4,0,0,-1,0,0
llevar,2,8,-6,-1,-1,0,0
demorar,2,2,0,0,-1,0,0
corresponder,14,3,-11,-1,1,0,0
poner,5,15,-10,-1,-1,0,0
realizar,2,12,-10,-1,-1,0,0
tener,1,4,-3,-1,-1,0,0
recibir,11,2,-9,-1,1,-1,0
ir,2,3,-1,-1,-1,0,0
ampliar,6,3,3,1,-1,0,0
cerrar,6,57,-51,-1,-1,0,0
visitar,2,5,-3,-1,-1,0,0
requerir,3,4,-1,-1,-1,0,0
reservar,2,12,-10,-1,-1,0,0
hacer,2,3,-1,-1,-1,0,0
estrenar,2,4,-2,-1,-1,0,0
lanzar,6,2,-4,-1,1,0,0
prestar,1,9,-8,-1,-1,0,0
poner,4,6,2,1,1,0,0
establecer,2,6,-4,-1,-1,0,0
renunciar,11,3,-8,-1,1,0,0
adoptar,2,2,0,0,1,0,0
uner,11,14,-3,-1,-1,0,0
comprar,6,3,3,1,-1,0,0
recibir,11,27,-16,-1,-1,0,0
criptoanalizar,2,10,-8,-1,-1,0,0
impulsar,6,6,0,0,-1,0,0
combinar,6,7,-1,-1,-1,0,0
hacer,9,5,-4,-1,1,0,0
desarrollar,2,5,-3,-1,-1,0,0
ganar,2,10,-8,-1,-1,0,0
salvar,1,3,-2,-1,-1,0,0
estimular,3,7,-4,-1,-1,0,0
mover,8,4,4,1,-1,0,0
distinguir,1,13,-12,-1,-1,-1,0
ganar,2,13,-11,-1,-1,0,0
incluir,22,12,10,1,-1,0,0
superar,3,4,-1,-1,-1,0,0
conservar,2,2,0,0,-1,0,0
teniar,1,2,-1,-1,-1,0,0
finalizar,3,2,1,1,-1,0,0
obtener,9,7,2,1,-1,0,0
encontrar,1,3,-2,-1,-1,0,0
recibir,6,4,2,1,-1,0,0
integro,3,2,-1,-1,1,0,0
confirmar,5,12,-7,-1,-1,0,0
llevar,2,4,-2,-1,-1,0,0
obtener,2,5,-3,-1,-1,0,0
registrar,2,4,-2,-1,-1,0,0
promover,5,11,6,1,1,0,0
completar,2,2,0,0,-1,0,0
hacer,4,12,-8,-1,-1,0,0
provocar,21,3,-18,-1,1,0,0
tener,1,6,-5,-1,-1,0,0
tomar,3,2,-1,-1,1,0,0
lucir,2,3,-1,-1,-1,0,0
grabar,3,4,-1,-1,-1,0,0
palpa,4,2,-2,-1,1,0,0
iniciar,3,7,-4,-1,-1,0,0
equiparar,3,13,-10,-1,-1,0,0
levantar,3,7,-4,-1,-1,0,0
poner,3,2,-1,-1,1,0,0
dejar,3,3,0,0,-1,0,0
prver,2,38,-36,-1,-1,0,0
lanzar,2,2,0,0,-1,0,0
introducir,7,7,0,0,-1,0,0
poner,3,3,0,0,1,1,0
situar,2,2,0,0,-1,1,0
caer,4,3,1,1,-1,0,0
dar,2,15,-13,-1,-1,0,0
excavo,7,3,-4,-1,1,0,0
pronunciar,4,7,-3,-1,-1,0,0
poner,4,6,-2,-1,-1,0,0
cursar,9,3,6,1,-1,0,0
comprender,18,9,9,1,-1,0,0
suponer,3,3,0,0,-1,0,0
probar,1,4,-3,-1,-1,-1,0
realizar,1,3,-2,-1,-1,0,0
cursar,3,22,-19,-1,-1,0,0
integrar,6,6,0,0,-1,0,0
concibir,4,10,-6,-1,-1,0,0
organizar,10,3,-7,-1,1,0,0
narrar,2,14,-12,-1,-1,0,0
soportar,9,3,-6,-1,1,0,0
tener,2,24,-22,-1,-1,0,0
liberar,1,4,-3,-1,-1,0,0
tener,2,3,-1,-1,-1,0,0
narrar,19,2,-17,-1,1,0,0
cerrase,2,3,-1,-1,-1,1,0
comandar,10,9,1,1,-1,0,0
tomar,1,8,-7,-1,-1,0,0
desarrollar,2,4,-2,-1,-1,0,0
erigir,10,5,5,1,-1,0,0
eliminar,8,3,5,1,-1,0,0
destacar,1,10,-9,-1,-1,-1,0
propuesto,7,10,3,1,1,0,0
alzar,6,4,2,1,-1,0,0
poner,17,2,-15,-1,1,0,0
inaugurar,6,3,3,1,-1,0,0
informar,1,15,-14,-1,-1,-1,0
causar,1,11,-10,-1,-1,0,0
tomar,7,5,2,1,-1,0,0
votar,3,5,-2,-1,-1,0,0
incluir,17,2,-15,-1,1,0,0
multiplicar,3,2,-1,-1,1,-1,0
asesinar,6,2,4,1,-1,0,0
observar,2,4,-2,-1,-1,0,0
considerar,3,3,0,0,-1,0,0
ver,4,3,-1,-1,1,0,0
usar,3,3,0,0,-1,0,0
convertir,3,23,-20,-1,-1,0,0
haber,3,5,-2,-1,-1,0,0
abrir,1,5,-4,-1,-1,0,0
tener,3,2,-1,-1,1,0,0
estudiar,3,3,0,0,-1,0,0
realizar,2,2,0,0,-1,0,0
colocar,5,7,-2,-1,-1,0,0
tomar,1,4,-3,-1,-1,0,0
entrenar,3,18,-15,-1,-1,0,0
superar,2,11,-9,-1,-1,0,0
iniciar,5,13,-8,-1,-1,0,0
tener,1,2,-1,-1,-1,0,0
convertir,1,2,-1,-1,-1,-1,0
decidir,2,4,-2,-1,-1,0,0
dar,4,4,0,0,1,0,0
usar,6,6,0,0,-1,0,0
dejar,5,11,-6,-1,-1,0,0
marcar,5,4,1,1,-1,0,0
jugar,2,3,-1,-1,-1,0,0
constituir,6,18,-12,-1,-1,0,0
tener,3,2,1,1,-1,0,0
preferir,2,2,0,0,-1,0,0
visitar,1,3,-2,-1,-1,0,0
preferir,2,4,-2,-1,-1,0,0
adquirir,4,5,-1,-1,-1,-1,0
obtener,2,4,-2,-1,-1,0,0
fusionar,8,6,2,1,-1,0,0
escribir,10,7,3,1,-1,0,0
criticar,2,8,-6,-1,-1,0,0
poner,2,15,-13,-1,-1,0,0
seguir,5,2,3,1,-1,0,0
tener,5,2,-3,-1,1,0,0
descubrir,2,3,-1,-1,-1,0,0
aislar,1,3,-2,-1,-1,-1,0
pasar,3,10,-7,-1,-1,0,0
leido,16,2,-14,-1,1,0,0
dar,2,8,-6,-1,-1,0,0
iniciar,2,58,-56,-1,-1,0,0
tener,1,3,-2,-1,-1,0,0
sufrir,24,4,-20,-1,1,0,0
usar,2,6,-4,-1,-1,0,0
reducir,4,2,2,1,-1,0,0
provocar,2,28,-26,-1,-1,0,0
plantar,1,19,-18,-1,-1,0,0
haber,1,3,-2,-1,-1,0,0
dejar,2,5,-3,-1,-1,0,0
formar,1,9,-8,-1,-1,0,0
tener,6,2,4,1,-1,0,0
empujar,9,3,-6,-1,1,0,0
desencadenar,5,3,2,1,-1,0,0
hacer,2,2,0,0,-1,0,0
utilizar,2,3,-1,-1,-1,0,0
tocar,2,3,1,1,1,0,0
causar,1,12,-11,-1,-1,0,0
criar,1,8,-7,-1,-1,-1,0
lograr,3,4,-1,-1,-1,0,0
conectar,1,39,-38,-1,-1,0,0
salvar,2,5,-3,-1,-1,0,0
anotar,4,16,-12,-1,-1,0,0
declarado,5,2,-3,-1,1,0,0
confirmar,17,6,-11,-1,1,0,0
identificar,7,2,5,1,-1,0,0
conocer,9,10,-1,-1,-1,0,0
encontrar,18,3,15,1,-1,0,0
integrar,3,3,0,0,-1,0,0
viajar,3,7,-4,-1,-1,0,0
colgar,2,2,0,0,1,0,0
obtener,3,2,-1,-1,1,-1,0
ejerciar,2,5,-3,-1,-1,0,0
liderar,6,10,-4,-1,-1,0,0
abrir,2,15,-13,-1,-1,0,0
ganar,8,6,2,1,-1,0,0
producir,3,4,-1,-1,-1,0,0
comprar,3,3,0,0,-1,0,0
constituir,3,4,-1,-1,-1,0,0
reconocer,4,11,-7,-1,-1,0,0
traer,28,3,-25,-1,1,0,0
convirtiér,1,8,-7,-1,-1,-1,0
redactar,6,35,-29,-1,-1,0,0
concluir,2,4,-2,-1,-1,0,0
sacrificar,3,11,-8,-1,-1,0,0
cometer,4,7,-3,-1,-1,0,0
costar,5,3,-2,-1,1,0,0
escribir,2,2,0,0,-1,0,0
jugar,2,2,0,0,-1,0,0
introducir,7,2,-5,-1,1,-1,0
preparar,1,11,-10,-1,-1,-1,0
incluir,18,3,15,1,-1,0,0
emula,7,4,-3,-1,1,0,0
enviar,3,2,1,1,-1,0,0
ganar,2,3,-1,-1,-1,0,0
utilizar,2,5,-3,-1,-1,0,0
escuchán,1,2,-1,-1,-1,-1,0
realizar,2,2,0,0,-1,0,0
postular,7,23,-16,-1,-1,0,0
sentir,1,3,-2,-1,-1,-1,0
acumular,3,3,0,0,1,0,0
correspondiéndo,1,6,-5,-1,-1,-1,0
contratar,2,2,0,0,-1,1,0
repetir,4,5,-1,-1,-1,0,0
perder,2,8,-6,-1,-1,0,0
realizar,3,3,0,0,-1,0,0
renovar,17,3,-14,-1,1,0,0
recibir,4,2,2,1,-1,0,0
rescatar,2,6,-4,-1,-1,0,0
maredir,3,7,-4,-1,-1,0,0
tener,2,6,-4,-1,-1,0,0
ganar,2,7,-5,-1,-1,0,0
elegir,2,3,1,1,1,0,0
haber,2,3,-1,-1,-1,0,0
fortalecer,4,3,1,1,-1,0,0
ganar,4,8,-4,-1,-1,0,0
jugar,3,3,0,0,-1,0,0
tener,2,5,-3,-1,-1,0,0
denunciar,3,3,0,0,-1,1,0
representar,5,4,1,1,-1,0,0
tener,1,10,-9,-1,-1,0,0
invadir,1,2,-1,-1,-1,0,0
añadir,4,3,-1,-1,1,0,0
cambiar,2,7,-5,-1,-1,0,0
comunicar,18,2,-16,-1,1,0,0
ocupar,2,4,-2,-1,-1,0,0
lograr,5,14,-9,-1,-1,0,0
sufrir,4,11,-7,-1,-1,0,0
enfocar,2,7,-5,-1,-1,0,0
contemplar,4,2,-2,-1,1,0,0
tocar,2,11,-9,-1,-1,0,0
informar,1,6,-5,-1,-1,-1,0
solicitar,2,4,-2,-1,-1,0,0
cursar,2,16,-14,-1,-1,0,0
tratar,3,2,1,1,-1,0,0
balancear,2,3,-1,-1,-1,0,0
escoger,1,3,-2,-1,-1,0,0
marcar,5,6,-1,-1,-1,0,0
recibir,15,2,-13,-1,1,0,0
perder,2,3,1,1,1,0,0
tratar,4,2,2,1,-1,0,0
contraer,1,6,-5,-1,-1,0,0
tener,2,2,0,0,1,0,0
evitar,3,2,1,1,-1,0,0
desarrollar,5,10,-5,-1,-1,0,0
haber,1,3,-2,-1,-1,0,0
incluir,14,2,-12,-1,1,-1,0
tener,13,2,-11,-1,1,0,0
enterrar,2,9,-7,-1,-1,1,0
prar,3,3,0,0,-1,0,0
proclamar,17,5,-12,-1,1,0,0
contrajr,1,4,-3,-1,-1,0,0
gastar,3,3,0,0,-1,0,0
véa,2,9,-7,-1,-1,0,0
adaptar,1,10,-9,-1,-1,-1,0
establecer,3,14,-11,-1,-1,0,0
dejar,2,3,1,1,1,0,0
tener,2,17,-15,-1,-1,0,0
utilizar,2,2,0,0,-1,0,0
transformar,2,16,-14,-1,-1,0,0
llevar,1,3,-2,-1,-1,0,0
excavar,2,12,-10,-1,-1,0,0
complementar,2,17,-15,-1,-1,0,0
mantener,3,8,-5,-1,-1,0,0
reconvertir,1,4,-3,-1,-1,-1,0
tener,14,2,-12,-1,1,0,0
tener,3,7,-4,-1,-1,0,0
gastar,2,4,-2,-1,-1,0,0
salir,1,3,-2,-1,-1,0,0
permitir,3,5,-2,-1,-1,0,0
estudiar,1,2,-1,-1,-1,-1,0
tener,16,4,-12,-1,1,0,0
hacer,2,9,-7,-1,-1,0,0
colgar,1,10,-9,-1,-1,0,0
transferir,2,4,-2,-1,-1,0,0
calificar,2,10,-8,-1,-1,0,0
tener,1,3,-2,-1,-1,0,0
hacer,2,19,-17,-1,-1,0,0
continuar,4,3,-1,-1,1,0,0
cazar,1,7,-6,-1,-1,0,0
haber,4,3,1,1,-1,0,0
alcanzar,8,2,6,1,-1,0,0
tomar,1,13,-12,-1,-1,0,0
representar,6,3,3,1,-1,0,0
poner,2,13,-11,-1,-1,0,0
organizar,4,5,-1,-1,-1,0,0
presentar,38,5,-33,-1,1,0,0
reservir,4,3,1,1,-1,0,0
paliar,3,9,-6,-1,-1,0,0
ofrecer,3,2,1,1,-1,0,0
ostentar,3,5,-2,-1,-1,0,0
incluir,30,2,-28,-1,1,0,0
promediar,13,3,10,1,-1,0,0
lograr,10,7,-3,-1,1,0,0
traído,2,5,-3,-1,-1,0,0
tener,2,2,0,0,-1,0,0
declarado,4,5,-1,-1,-1,0,0
hundir,3,5,-2,-1,-1,0,0
identificar,2,4,-2,-1,-1,0,0
comenzar,2,3,-1,-1,-1,0,0
analizar,2,6,-4,-1,-1,0,0
cantar,7,2,-5,-1,1,0,0
interpretar,2,20,-18,-1,-1,0,0
exhibir,2,6,-4,-1,-1,0,0
alternar,3,5,-2,-1,-1,0,0
recibir,6,2,4,1,-1,0,0
asegurar,2,4,-2,-1,-1,0,0
haber,2,3,-1,-1,-1,0,0
practicar,1,2,-1,-1,-1,0,0
señalar,3,2,1,1,-1,0,0
utilizar,2,3,-1,-1,-1,0,0
realizar,20,6,14,1,-1,0,0
hacer,4,3,-1,-1,1,0,0
trasmitir,2,2,0,0,-1,0,0
cambiar,2,2,0,0,-1,0,0
realizar,11,4,7,1,-1,-1,0
comparar,5,7,-2,-1,-1,0,0
acreditándo,1,10,-9,-1,-1,-1,0
llevar,30,2,-28,-1,1,0,0
realizar,4,2,-2,-1,1,0,0
ocasionar,1,3,-2,-1,-1,0,0
tomar,12,2,-10,-1,1,0,0
ver,2,3,1,1,1,0,0
convertir,3,2,1,1,-1,0,0
aplicado,2,24,-22,-1,-1,0,0
decretar,4,7,-3,-1,-1,0,0
llevar,1,3,-2,-1,-1,-1,0
reconocer,2,5,-3,-1,-1,0,0
compartir,21,5,-16,-1,1,-1,0
ver,4,5,-1,-1,-1,0,0
dirigir,5,14,-9,-1,-1,0,0
utilizar,3,8,-5,-1,-1,0,0
iniciar,7,20,-13,-1,-1,0,0
haber,3,7,-4,-1,-1,0,0
transformar,3,3,0,0,-1,0,0
tocar,2,2,0,0,-1,0,0
incluir,1,6,-5,-1,-1,-1,0
dejar,2,11,-9,-1,-1,0,0
configurar,2,3,-1,-1,-1,0,0
encontrar,5,2,-3,-1,1,0,0
separar,4,7,-3,-1,-1,0,0
tener,26,2,-24,-1,1,0,0
mostrar,9,4,-5,-1,1,0,0
desaparecer,2,4,-2,-1,-1,0,0
formar,16,4,-12,-1,1,0,0
publicar,3,4,-1,-1,-1,0,0
editar,1,2,-1,-1,-1,0,0
establecer,4,10,-6,-1,-1,0,0
derrotar,7,4,3,1,-1,0,0
extender,2,3,-1,-1,-1,0,0
construir,2,16,-14,-1,-1,0,0
estudiar,3,6,-3,-1,-1,0,0
establecer,11,6,-5,-1,1,0,0
cerrar,4,5,-1,-1,-1,0,0
aliviar,2,4,-2,-1,-1,0,0
ver,1,4,-3,-1,-1,-1,0
terminar,6,2,-4,-1,1,0,0
estudir,1,2,-1,-1,-1,0,0
integrar,10,9,1,1,-1,1,0
considerar,6,21,-15,-1,-1,0,0
abanicar,3,5,-2,-1,-1,0,0
hacer,2,4,-2,-1,-1,0,0
reunir,10,2,-8,-1,1,0,0
obtener,3,16,-13,-1,-1,0,0
enriquecer,4,3,1,1,-1,0,0
entregár,1,14,-13,-1,-1,-1,0
mantener,3,2,1,1,-1,0,0
comprender,3,4,-1,-1,-1,0,0
tomar,2,3,-1,-1,-1,0,0
rociar,3,2,1,1,-1,0,0
mostrar,2,3,-1,-1,-1,0,0
alcanzar,3,7,-4,-1,-1,0,0
forma,1,6,-5,-1,-1,0,0
firmar,2,6,-4,-1,-1,0,0
tener,3,3,0,0,-1,0,0
ordenar,6,4,2,1,-1,0,0
conceder,7,4,-3,-1,1,0,0
pasar,2,10,-8,-1,-1,0,0
vendar,4,9,-5,-1,-1,0,0
establecer,2,4,-2,-1,-1,0,0
trasladar,2,2,0,0,-1,0,0
dejar,3,9,-6,-1,-1,0,0
comprar,1,9,-8,-1,-1,0,0
hacer,2,2,0,0,-1,0,0
grabar,2,20,-18,-1,-1,0,0
dejar,20,4,-16,-1,1,0,0
apoyar,5,13,-8,-1,-1,0,0
perder,2,6,-4,-1,-1,0,0
convirtiéndo,1,2,-1,-1,-1,-1,0
tener,2,31,-29,-1,-1,0,0
comenzar,4,2,2,1,-1,0,0
ganar,3,12,-9,-1,-1,0,0
rezar,1,3,-2,-1,-1,0,0
dirigir,7,5,2,1,-1,0,0
dirigir,2,11,-9,-1,-1,0,0
significar,2,10,-8,-1,-1,0,0
tener,15,2,-13,-1,1,0,0
mirar,17,2,-15,-1,1,0,0
fundar,2,7,-5,-1,-1,0,0
ver,2,3,-1,-1,-1,0,0
interpretar,6,26,-20,-1,-1,0,0
tomar,3,8,-5,-1,-1,0,0
avisar,1,3,-2,-1,-1,-1,0
traer,1,2,-1,-1,-1,-1,0
dividir,8,5,3,1,-1,0,0
combinar,2,3,-1,-1,-1,0,0
curar,2,3,1,1,1,0,0
aparecer,13,2,11,1,-1,1,0
tener,14,2,-12,-1,1,0,0
unir,4,3,1,1,-1,0,0
tomar,7,3,-4,-1,1,0,0
dar,1,6,-5,-1,-1,0,0
denominar,3,4,-1,-1,-1,0,0
firmar,4,2,2,1,-1,0,0
recibir,4,2,2,1,-1,0,0
encontrar,1,3,-2,-1,-1,0,0
colocar,22,6,-16,-1,1,0,0
destacar,9,3,-6,-1,1,0,0
desempeñar,2,4,-2,-1,-1,0,0
ofrecer,6,24,-18,-1,-1,0,0
considerar,4,3,1,1,-1,0,0
iniciar,2,16,-14,-1,-1,0,0
investigar,3,3,0,0,-1,0,0
retomar,2,4,-2,-1,-1,0,0
pasar,6,3,-3,-1,1,0,0
mostrar,3,9,-6,-1,-1,0,0
cobrar,2,2,0,0,-1,0,0
lograr,2,2,0,0,-1,0,0
suponer,5,19,-14,-1,-1,0,0
transferir,4,3,1,1,-1,0,0
compartir,8,6,-2,-1,1,0,0
tener,3,21,-18,-1,-1,0,0
gestionar,7,11,-4,-1,-1,0,0
llevar,4,4,0,0,-1,0,0
ofrecer,2,7,-5,-1,-1,0,0
retirar,2,7,-5,-1,-1,0,0
repeler,3,3,0,0,-1,0,0
unir,2,2,0,0,-1,0,0
celebrar,6,4,2,1,-1,0,0
envolver,2,18,-16,-1,-1,0,0
traer,11,2,-9,-1,1,0,0
mandar,3,3,0,0,1,0,0
provocar,2,4,-2,-1,-1,0,0
proteger,4,4,0,0,-1,0,0
provocar,4,6,-2,-1,-1,0,0
dar,1,14,-13,-1,-1,0,0
recordar,2,3,-1,-1,-1,0,0
dejar,4,5,-1,-1,-1,0,0
recibir,5,2,-3,-1,1,0,0
hacer,3,2,-1,-1,1,-1,0
inaugurar,3,7,-4,-1,-1,0,0
trasladar,4,10,-6,-1,-1,0,0
disputar,2,3,-1,-1,-1,0,0
concretar,2,4,-2,-1,-1,0,0
meter,2,7,-5,-1,-1,0,0
entender,2,3,-1,-1,-1,0,0
suscribir,4,11,-7,-1,-1,0,0
acoger,7,3,-4,-1,1,0,0
hacer,1,5,-4,-1,-1,0,0
alcanzar,2,12,-10,-1,-1,0,0
usar,1,2,-1,-1,-1,0,0
suspender,2,2,0,0,-1,0,0
designar,4,2,2,1,-1,0,0
hacéis,5,2,3,1,-1,1,0
detectar,3,5,-2,-1,-1,0,0
hacer,1,3,-2,-1,-1,0,0
aprovechándo,2,5,-3,-1,-1,0,0
juntar,2,5,-3,-1,-1,0,0
poner,14,2,-12,-1,1,0,0
quemar,2,5,-3,-1,-1,0,0
conquistar,6,2,4,1,-1,0,0
mantener,46,3,-43,-1,1,0,0
asumir,5,5,0,0,-1,0,0
ganar,2,2,0,0,-1,0,0
comprar,3,5,-2,-1,-1,0,0
vender,1,2,-1,-1,-1,-1,0
arranco,2,16,-14,-1,-1,0,0
convertir,2,9,-7,-1,-1,0,0
traer,24,2,-22,-1,1,0,0
llevar,2,13,-11,-1,-1,0,0
tener,1,7,-6,-1,-1,0,0
tener,1,4,-3,-1,-1,1,0
potenciar,19,3,-16,-1,1,0,0
tener,2,12,-10,-1,-1,0,0
compartir,4,9,-5,-1,-1,1,0
reconocer,6,3,-3,-1,1,0,0
ganar,2,8,-6,-1,-1,0,0
tendrar,2,20,-18,-1,-1,0,0
erigir,4,2,2,1,-1,0,0
frustrar,2,4,-2,-1,-1,0,0
tener,1,34,-33,-1,-1,0,0
obtener,1,4,-3,-1,-1,0,0
dar,2,10,-8,-1,-1,0,0
estudiar,1,8,-7,-1,-1,0,0
formar,2,24,-22,-1,-1,0,0
ganado,31,2,-29,-1,1,-1,0
entablar,3,6,-3,-1,-1,0,0
ver,2,3,-1,-1,-1,0,0
llevar,2,3,-1,-1,-1,0,0
separar,2,13,-11,-1,-1,0,0
superar,3,2,1,1,-1,0,0
pegar,4,3,1,1,-1,0,0
firmar,3,2,1,1,-1,0,0
gestionar,7,4,3,1,-1,0,0
dar,2,6,-4,-1,-1,0,0
suceder,4,46,-42,-1,-1,0,0
realizar,9,2,7,1,-1,0,0
rodar,3,3,0,0,-1,0,0
recibir,8,15,7,1,1,0,0
invocar,1,3,-2,-1,-1,-1,0
realizar,5,18,-13,-1,-1,0,0
llevar,3,7,4,1,1,0,0
pasar,3,3,0,0,1,0,0
cumplir,8,3,-5,-1,1,0,0
pasar,3,7,-4,-1,-1,0,0
destruir,12,6,-6,-1,1,1,0
actualizar,4,3,-1,-1,1,0,0
tener,1,3,-2,-1,-1,0,0
golpear,19,3,-16,-1,1,0,0
combatir,3,5,-2,-1,-1,0,0
visitar,9,4,5,1,-1,0,0
iniciar,13,2,-11,-1,1,0,0
señalar,1,2,-1,-1,-1,-1,0
ganar,5,2,3,1,-1,0,0
registrar,3,7,-4,-1,-1,0,0
haber,2,9,-7,-1,-1,0,0
dejar,1,3,-2,-1,-1,0,0
cerrar,2,7,-5,-1,-1,0,0
limitar,3,5,-2,-1,-1,0,0
tener,14,2,-12,-1,1,0,0
ofrecer,2,20,-18,-1,-1,0,0
tener,2,9,-7,-1,-1,0,0
obsequia,3,9,-6,-1,-1,0,0
dar,1,6,-5,-1,-1,0,0
inscribir,3,6,-3,-1,-1,0,0
proteger,3,3,0,0,-1,1,0
derivar,2,28,-26,-1,-1,0,0
eligir,12,3,-9,-1,1,0,0
salvar,2,4,-2,-1,-1,0,0
lograr,7,3,4,1,-1,0,0
contener,15,2,-13,-1,1,0,0
convertir,2,4,-2,-1,-1,0,0
hablar,1,3,-2,-1,-1,0,0
conquistar,1,3,-2,-1,-1,0,0
organizar,3,9,-6,-1,-1,0,0
dar,1,12,-11,-1,-1,-1,0
vender,4,3,1,1,-1,0,0
comparar,4,13,-9,-1,-1,0,0
poner,3,2,-1,-1,1,0,0
incluir,1,14,-13,-1,-1,0,0
puso,4,25,-21,-1,-1,0,0
ver,1,12,-11,-1,-1,-1,0
guardar,1,4,-3,-1,-1,-1,0
ampliar,2,8,-6,-1,-1,0,0
iniciar,3,6,-3,-1,-1,0,0
certificar,3,3,0,0,-1,0,0
sufiar,8,8,0,0,-1,0,0
renovar,2,2,0,0,-1,0,0
anclar,4,13,-9,-1,-1,0,0
enviar,3,3,0,0,-1,0,0
llevar,12,2,-10,-1,1,0,0
aumentar,3,5,-2,-1,-1,0,0
arrebatar,5,4,-1,-1,1,0,0
ensuciar,3,6,-3,-1,-1,0,0
conocer,8,2,-6,-1,1,0,0
destruir,2,13,-11,-1,-1,0,0
disfrutar,1,10,-9,-1,-1,-1,0
haber,4,7,-3,-1,-1,0,0
conseguir,4,3,1,1,-1,0,0
vencer,2,4,-2,-1,-1,0,0
exponer,2,6,-4,-1,-1,0,0
realizar,10,6,4,1,-1,0,0
fijar,2,3,-1,-1,-1,0,0
recibir,8,2,-6,-1,1,0,0
vendiér,1,3,-2,-1,-1,-1,0
interpretar,5,7,-2,-1,-1,0,0
conseguir,1,6,-5,-1,-1,0,0
pagar,4,4,0,0,1,0,0
tener,5,4,1,1,-1,0,0
protagonizar,24,2,-22,-1,1,0,0
repartir,4,3,1,1,-1,0,0
abonar,5,24,-19,-1,-1,0,0
aplicar,3,7,-4,-1,-1,0,0
colocar,2,3,-1,-1,-1,0,0
estudiar,2,4,-2,-1,-1,0,0
hacer,11,3,-8,-1,1,0,0
pertenecer,4,13,-9,-1,-1,0,0
calificar,3,12,-9,-1,-1,0,0
conocer,6,2,-4,-1,1,1,0
encontrar,6,14,8,1,1,0,0
unir,3,6,-3,-1,-1,0,0
estudiar,2,4,-2,-1,-1,0,0
dirigir,15,6,9,1,-1,0,0
descubrir,2,5,-3,-1,-1,0,0
vender,17,3,-14,-1,1,0,0
derrotar,4,4,0,0,-1,0,0
vender,2,2,0,0,-1,0,0
buscar,11,2,9,1,-1,0,0
definir,9,6,3,1,-1,0,0
controlar,3,7,-4,-1,-1,0,0
ocupar,4,7,-3,-1,-1,0,0
copiar,11,3,8,1,-1,0,0
realizar,2,3,-1,-1,-1,0,0
hacer,1,13,-12,-1,-1,0,0
utilizar,6,2,4,1,-1,0,0
recibir,2,9,-7,-1,-1,0,0
ametrallar,5,7,-2,-1,-1,0,0
jugar,3,8,-5,-1,-1,0,0
constituir,3,6,3,1,1,0,0
cambiar,3,4,-1,-1,-1,0,0
convirtiér,1,18,-17,-1,-1,-1,0
hacer,1,7,-6,-1,-1,0,0
ofrecer,27,2,-25,-1,1,0,0
dejar,2,3,-1,-1,-1,0,0
convertir,1,5,-4,-1,-1,-1,0
cambiar,2,11,-9,-1,-1,0,0
pegar,3,4,-1,-1,-1,0,0
evitar,2,3,1,1,1,0,0
encarnar,3,17,-14,-1,-1,0,0
definir,1,29,-28,-1,-1,-1,0
crear,2,2,0,0,-1,0,0
comer,2,5,-3,-1,-1,0,0
distinguir,3,7,-4,-1,-1,0,0
lograr,10,6,4,1,-1,0,0
ganar,4,16,-12,-1,-1,0,0
desempeñar,3,3,0,0,-1,0,0
otorgar,7,3,-4,-1,1,0,0
dar,3,4,-1,-1,-1,0,0
convertir,1,2,-1,-1,-1,-1,0
realizar,3,4,-1,-1,-1,0,0
demostrar,6,8,-2,-1,-1,0,0
dar,1,4,-3,-1,-1,0,0
interpretar,2,3,1,1,1,0,0
incrementar,5,9,-4,-1,-1,0,0
ver,2,5,-3,-1,-1,0,0
incluir,4,44,-40,-1,-1,0,0
contraer,1,4,-3,-1,-1,0,0
sembrar,2,4,-2,-1,-1,0,0
probar,1,4,-3,-1,-1,0,0
denunciar,2,4,-2,-1,-1,0,0
poseer,17,3,14,1,-1,0,0
acoger,2,7,-5,-1,-1,0,0
formar,1,4,-3,-1,-1,0,0
ficha,7,2,5,1,-1,0,0
dejar,2,5,-3,-1,-1,0,0
escribir,1,9,-8,-1,-1,0,0
haber,11,10,-1,-1,1,0,0
concibir,2,7,-5,-1,-1,0,0
llevar,2,7,-5,-1,-1,0,0
traer,2,6,-4,-1,-1,0,0
realizar,3,20,-17,-1,-1,0,0
hacer,5,27,-22,-1,-1,0,0
guardar,1,3,-2,-1,-1,-1,0
interpretar,6,7,-1,-1,-1,0,0
tener,1,3,-2,-1,-1,0,0
dejar,4,4,0,0,-1,0,0
dar,11,4,-7,-1,1,0,0
presentar,2,23,-21,-1,-1,0,0
hacer,1,4,-3,-1,-1,0,0
tener,2,3,1,1,1,0,0
conocí,5,7,-2,-1,-1,0,0
decir,2,3,-1,-1,-1,0,0
realizar,3,4,-1,-1,-1,0,0
poner,12,3,-9,-1,1,0,0
tener,6,3,-3,-1,1,0,0
obstaculizar,2,3,-1,-1,-1,0,0
beneficiar,6,20,-14,-1,-1,0,0
alcanzar,2,14,-12,-1,-1,0,0
tener,7,3,4,1,-1,0,0
datar,2,6,-4,-1,-1,0,0
hacer,9,5,-4,-1,1,1,0
usar,2,34,-32,-1,-1,0,0
poseer,3,13,-10,-1,-1,0,0
cambiar,5,4,1,1,-1,0,0
dar,7,2,-5,-1,1,0,0
presentar,2,3,-1,-1,-1,0,0
inducir,2,13,-11,-1,-1,0,0
cubre,2,6,-4,-1,-1,0,0
formar,9,6,-3,-1,1,1,0
aventajar,2,3,1,1,1,0,0
probar,1,23,-22,-1,-1,0,0
hacer,1,15,-14,-1,-1,0,0
conseguir,1,5,-4,-1,-1,0,0
tener,1,13,-12,-1,-1,1,0
guardar,2,7,-5,-1,-1,0,0
vencer,8,4,-4,-1,1,0,0
tener,3,2,1,1,-1,0,0
tener,2,4,-2,-1,-1,0,0
llevar,50,3,-47,-1,1,0,0
dejar,4,2,2,1,-1,0,0
contrajerar,1,8,-7,-1,-1,0,0
dar,2,10,-8,-1,-1,0,0
jugar,2,3,-1,-1,-1,0,0
jugar,2,3,-1,-1,-1,0,0
motivo,18,2,16,1,-1,0,0
mejorar,7,3,4,1,-1,0,0
tener,2,5,-3,-1,-1,0,0
establecer,5,11,-6,-1,-1,0,0
escribir,2,4,-2,-1,-1,0,0
preferir,2,3,-1,-1,-1,0,0
cambiar,3,11,-8,-1,-1,0,0
atacar,3,4,-1,-1,-1,0,0
brindar,3,13,-10,-1,-1,0,0
reavivar,2,24,-22,-1,-1,0,0
tener,4,3,1,1,-1,0,0
fundar,2,6,-4,-1,-1,0,0
buscar,3,10,-7,-1,-1,0,0
alcanzar,3,6,-3,-1,-1,0,0
sondear,1,4,-3,-1,-1,0,0
tener,4,3,1,1,-1,0,0
determinar,6,11,-5,-1,-1,0,0
seguir,2,7,-5,-1,-1,0,0
tener,21,2,-19,-1,1,0,0
inaugurar,8,2,-6,-1,1,0,0
conocer,2,2,0,0,-1,0,0
abrar,2,3,-1,-1,-1,0,0
ocupar,2,8,-6,-1,-1,0,0
dar,10,10,0,0,-1,0,0
reconstituir,4,7,-3,-1,-1,0,0
fundar,8,3,-5,-1,1,0,0
perennizar,6,4,-2,-1,1,0,0
tener,1,7,-6,-1,-1,0,0
conectar,2,6,-4,-1,-1,0,0
llevar,4,3,1,1,-1,0,0
provocar,15,4,-11,-1,1,0,0
dilatar,2,4,2,1,1,0,0
hacer,1,7,-6,-1,-1,0,0
servir,10,2,-8,-1,1,0,0
ver,6,4,2,1,-1,0,0
curar,2,3,-1,-1,-1,0,0
dejar,2,3,-1,-1,-1,0,0
jugar,3,6,-3,-1,-1,0,0
usar,1,10,-9,-1,-1,-1,0
sufrir,7,5,2,1,-1,0,0
dirigir,12,3,9,1,-1,-1,0
liderar,3,8,-5,-1,-1,0,0
posicionar,3,6,-3,-1,-1,0,0
fusiona,2,16,-14,-1,-1,0,0
hacer,1,2,-1,-1,-1,0,0
comprar,1,7,-6,-1,-1,-1,0
dar,13,2,-11,-1,1,0,0
establecer,2,3,-1,-1,-1,0,0
derrotar,4,4,0,0,1,0,0
proyectar,7,3,-4,-1,1,-1,0
estudir,3,6,-3,-1,-1,0,0
dejar,13,10,3,1,-1,0,0
compaginar,2,7,-5,-1,-1,0,0
ocupar,2,7,-5,-1,-1,0,0
acompañar,1,3,-2,-1,-1,-1,0
dejar,14,2,-12,-1,1,0,0
estudiar,2,5,-3,-1,-1,0,0
traducir,21,3,-18,-1,1,1,0
atraer,11,3,-8,-1,1,0,0
tener,22,2,-20,-1,1,0,0
dejar,2,2,0,0,1,0,0
costeándo,1,4,-3,-1,-1,-1,0
tallar,2,4,-2,-1,-1,0,0
dejar,5,3,-2,-1,1,0,0
recibir,2,4,-2,-1,-1,0,0
existir,27,3,-24,-1,1,0,0
encontrar,3,5,-2,-1,-1,-1,0
perseguir,3,3,0,0,-1,0,0
reconocer,2,5,-3,-1,-1,0,0
tener,2,3,-1,-1,-1,0,0
marcar,11,12,-1,-1,-1,0,0
contraer,1,8,-7,-1,-1,0,0
tener,7,3,-4,-1,1,0,0
enfatizar,2,13,-11,-1,-1,0,0
terminar,5,14,-9,-1,-1,0,0
diferir,2,4,-2,-1,-1,0,0
destinar,1,7,-6,-1,-1,0,0
necesitar,12,2,-10,-1,1,0,0
querer,3,3,0,0,-1,0,0
poblar,2,10,-8,-1,-1,0,0
haber,2,9,-7,-1,-1,0,0
sustituir,16,12,4,1,-1,0,0
repetir,2,3,-1,-1,-1,0,0
dejar,13,3,-10,-1,1,0,0
ganar,9,4,5,1,-1,0,0
perder,5,6,-1,-1,-1,0,0
impartir,9,2,-7,-1,1,0,0
seguir,2,7,-5,-1,-1,0,0
tener,4,5,-1,-1,-1,0,0
hacer,4,3,-1,-1,1,1,0
lograr,2,13,-11,-1,-1,0,0
identificar,3,2,1,1,-1,0,0
realizar,5,3,2,1,-1,0,0
poner,2,2,0,0,-1,0,0
obsequiar,6,9,-3,-1,-1,0,0
recorrer,2,3,-1,-1,-1,0,0
formar,4,6,-2,-1,-1,0,0
proveer,3,2,1,1,-1,0,0
llevar,2,2,0,0,1,0,0
poner,2,2,0,0,-1,0,0
mostrar,3,2,1,1,-1,0,0
perpetuar,8,5,3,1,-1,0,0
encontrar,2,3,-1,-1,-1,0,0
proponer,10,12,-2,-1,-1,0,0
compartir,2,3,-1,-1,-1,0,0
ganar,5,25,-20,-1,-1,0,0
llegar,17,6,11,1,-1,0,0
poner,14,6,-8,-1,1,0,0
disponiéndo,1,6,-5,-1,-1,-1,0
ganar,4,7,-3,-1,-1,0,0
hacer,13,5,8,1,-1,0,0
empapar,3,3,0,0,1,0,0
tener,1,6,-5,-1,-1,0,0
tener,3,12,-9,-1,-1,0,0
prestar,1,11,-10,-1,-1,0,0
defender,6,3,3,1,-1,0,0
violar,3,2,-1,-1,1,-1,0
hacer,10,35,25,1,1,0,0
reproducir,1,4,-3,-1,-1,-1,0
tener,2,2,0,0,-1,0,0
evacuar,3,2,1,1,-1,0,0
extender,2,3,-1,-1,-1,0,0
anotar,2,3,-1,-1,-1,0,0
prestir,1,5,-4,-1,-1,0,0
resguardándo,1,3,-2,-1,-1,-1,0
aprobar,3,8,-5,-1,-1,0,0
jugar,5,3,2,1,-1,0,0
tener,2,6,-4,-1,-1,0,0
tener,1,4,-3,-1,-1,0,0
dejar,7,2,-5,-1,1,0,0
dar,2,2,0,0,-1,0,0
saludar,1,14,-13,-1,-1,-1,0
ofrecer,4,3,1,1,-1,0,0
instalar,3,25,-22,-1,-1,0,0
faltar,2,11,-9,-1,-1,0,0
obtener,6,4,2,1,-1,0,0
cumplimentar,20,10,10,1,-1,0,0
protagonizar,5,8,-3,-1,-1,0,0
convertir,9,2,-7,-1,1,0,0
bloqueándo,1,3,-2,-1,-1,-1,0
ocupar,4,25,-21,-1,-1,0,0
comprar,1,3,-2,-1,-1,0,0
abandonar,2,5,-3,-1,-1,0,0
cubrir,3,4,1,1,1,0,0
valorar,2,9,-7,-1,-1,0,0
tener,1,4,-3,-1,-1,0,0
secuestrar,3,10,-7,-1,-1,0,0
atraviesar,4,6,-2,-1,-1,0,0
anunciar,2,4,-2,-1,-1,0,0
trasladar,3,9,-6,-1,-1,0,0
asociado,26,3,-23,-1,1,0,0
incluir,3,15,-12,-1,-1,0,0
diferenciar,9,13,-4,-1,-1,0,0
cubrir,5,2,3,1,-1,0,0
evitar,1,17,-16,-1,-1,0,0
aparecer,2,3,-1,-1,-1,0,0
tener,1,6,-5,-1,-1,0,0
firmar,2,4,-2,-1,-1,0,0
dejar,2,4,-2,-1,-1,0,0
valorar,4,2,-2,-1,1,-1,0
derrocar,4,5,-1,-1,-1,0,0
asumir,2,10,-8,-1,-1,0,0
contener,7,2,5,1,-1,0,0
transcurrir,3,3,0,0,-1,0,0
evitar,1,3,-2,-1,-1,0,0
conocer,3,5,-2,-1,-1,0,0
sacudir,2,6,-4,-1,-1,0,0
editar,4,4,0,0,-1,0,0
tomar,4,2,-2,-1,1,0,0
tener,1,4,-3,-1,-1,0,0
crear,2,10,-8,-1,-1,0,0
aumentar,7,3,4,1,-1,0,0
representar,3,20,-17,-1,-1,0,0
ganar,1,3,-2,-1,-1,-1,0
comenzar,3,3,0,0,-1,0,0
cambiar,6,4,2,1,-1,0,0
pensar,2,3,-1,-1,-1,1,0
fabricar,3,2,1,1,-1,0,0
centralizar,2,11,-9,-1,-1,0,0
realizar,2,4,-2,-1,-1,0,0
introducir,33,2,-31,-1,1,0,0
pasear,2,5,-3,-1,-1,0,0
perder,2,2,0,0,-1,0,0
realizar,2,7,-5,-1,-1,0,0
jugar,17,2,-15,-1,1,-1,0
convertir,1,3,-2,-1,-1,-1,0
pasar,6,8,-2,-1,-1,0,0
convertir,3,3,0,0,-1,0,0
arrestar,6,3,-3,-1,1,0,0
dejar,2,4,-2,-1,-1,0,0
denotar,4,3,1,1,-1,0,0
tildar,2,8,-6,-1,-1,0,0
reiniciar,1,2,-1,-1,-1,-1,0
captura,2,6,-4,-1,-1,0,0
introducir,1,3,-2,-1,-1,0,0
hacer,2,3,-1,-1,-1,0,0
percibir,2,7,-5,-1,-1,0,0
responsabilizar,3,6,-3,-1,-1,0,0
identificar,3,6,-3,-1,-1,0,0
fundir,5,7,-2,-1,-1,0,0
desviar,21,7,14,1,-1,-1,0
lleno,5,2,-3,-1,1,0,0
desfragmentar,2,3,-1,-1,-1,0,0
colocar,3,6,-3,-1,-1,0,0
mantener,6,8,-2,-1,-1,1,0
tener,5,4,1,1,-1,0,0
incorporar,5,12,-7,-1,-1,0,0
implicar,10,6,4,1,-1,0,0
provocar,1,7,-6,-1,-1,0,0
añadir,5,3,2,1,-1,0,0
introducir,2,3,-1,-1,-1,0,0
